,transaction_id,ip,device_id,device_type,tran_code,mcc,client_id,card_type,pin_inc_count,card_status,expiration_date,datetime,sum,oper_type,balance
45847,5381100,128.0.24.15,880.0,cash_in,25,5870,316136270,DEBIT,0,act,2026-03-06,2023-03-25 18:07:55,384.1,country_transfer,279702.46
45848,5388343,128.0.24.15,880.0,cash_in,451,2219,316136270,DEBIT,0,act,2026-03-06,2023-03-27 05:53:30,384.24,payment,279318.22
45849,5571939,46.0.188.150,1239.0,cash_in,25,9181,316136270,DEBIT,0,act,2026-03-06,2023-05-02 02:32:24,383.78,country_transfer,278934.44
45850,5625254,188.0.0.90,1212.0,atm,10,5870,316136270,DEBIT,0,act,2026-03-06,2023-05-09 11:20:50,383.75,add_on_acc,279318.19
45851,5686804,128.0.82.90,618.0,pos trm,-1,1150,316136270,DEBIT,1,act,2026-03-06,2023-07-09 00:43:12,383.91,err_code,279318.19
45852,5768381,128.0.82.90,618.0,pos trm,451,5870,316136270,DEBIT,0,act,2026-03-06,2023-07-15 22:15:54,384.04,payment,278934.15
45853,5933927,128.0.24.15,880.0,cash_in,451,3016,316136270,DEBIT,0,act,2026-03-06,2023-07-20 11:49:40,384.18,payment,278549.97
45854,5955384,46.0.188.30,1228.0,Portable term,451,3462,316136270,DEBIT,0,act,2026-03-06,2023-08-20 11:51:18,383.97,payment,278166.0
45855,6144057,46.0.188.30,1228.0,Portable term,451,9529,316136270,DEBIT,0,act,2026-03-06,2023-09-04 20:30:15,383.9,payment,277782.1
45856,6332659,188.0.169.195,482.0,cash_in,10,2900,316136270,DEBIT,0,act,2026-03-06,2023-09-28 19:52:42,384.04,in,278166.14
45857,6373176,194.87.0.15,567.0,cash_in,10,5533,316136270,DEBIT,0,act,2026-03-06,2023-12-15 19:52:03,383.86,in_acc,278550.0
45858,6386568,95.167.0.105,208.0,atm,451,5533,316136270,DEBIT,0,act,2026-03-06,2023-12-18 19:11:15,384.01,payment,278165.99
45859,6519347,217.26.0.60,678.0,prtbl trm,25,3462,316136270,DEBIT,0,act,2026-03-06,2023-12-23 22:54:10,383.73,diff_cntry,277782.26
45860,6538937,46.0.188.150,1239.0,cash_in,30,8608,316136270,DEBIT,0,act,2026-03-06,2024-01-05 09:44:43,383.83,transfer,277398.43
45861,6793500,128.0.24.165,895.0,ATM,20,8626,316136270,DEBIT,0,act,2026-03-06,2024-01-17 22:17:03,383.82,decrease_on_acc,277014.61
45862,7089412,128.0.82.90,618.0,pos trm,-1,2918,316136270,DEBIT,1,act,2026-03-06,2024-02-03 11:27:41,383.85,err_code,277014.61
45863,7474663,195.161.0.105,1170.0,atm,10,8608,316136270,DEBIT,0,act,2026-03-06,2024-02-18 08:35:15,384.21,in,277398.82
45864,7740006,95.167.0.240,219.0,ATM,10,5533,316136270,DEBIT,0,act,2026-03-06,2024-02-20 00:09:25,384.28,in,277783.1
45865,7837148,217.26.0.60,678.0,prtbl trm,-1,3016,316136270,DEBIT,1,act,2026-03-06,2024-04-17 07:45:34,383.94,bad,277783.1
45866,7838887,86.111.0.150,1354.0,ATM,10,3462,316136270,DEBIT,0,act,2026-03-06,2024-04-28 19:09:10,383.86,in_acc,278166.96
45867,8099539,46.0.188.150,1239.0,cash_in,30,9181,316136270,DEBIT,0,act,2026-03-06,2024-06-04 05:17:13,384.09,transfer,277782.87
45868,8209888,46.0.188.150,1239.0,cash_in,-1,5870,316136270,DEBIT,1,act,2026-03-06,2024-06-09 23:02:45,384.17,bad,277782.87
45869,8254226,46.0.143.30,812.0,atm,10,1982,316136270,DEBIT,0,act,2026-03-06,2024-06-14 01:05:03,383.69,add_on_acc,278166.56
45870,8543419,95.167.0.180,215.0,ATM,20,1150,316136270,DEBIT,0,act,2026-03-06,2024-06-14 23:43:17,384.09,from_acc,277782.47
45871,8546069,46.0.188.150,1239.0,cash_in,451,8626,316136270,DEBIT,0,act,2026-03-06,2024-06-25 22:16:23,384.02,payment,277398.45
45872,8763583,128.0.82.90,618.0,pos trm,30,9529,316136270,DEBIT,0,act,2026-03-06,2024-06-28 15:14:39,384.11,transfer,277014.34
45873,8878737,217.26.0.60,678.0,prtbl trm,451,3462,316136270,DEBIT,0,act,2026-03-06,2024-07-30 07:11:53,383.86,payment,276630.48
45874,9095454,128.0.82.90,618.0,pos trm,25,2918,316136270,DEBIT,0,act,2026-03-06,2024-08-03 19:17:15,383.95,diff_cntry,276246.53
45875,9178104,46.0.188.30,1228.0,Portable term,25,1150,316136270,DEBIT,0,act,2026-03-06,2024-08-12 20:29:35,384.08,diff_cntry,275862.45
45876,9472498,128.0.24.15,880.0,cash_in,451,2219,316136270,DEBIT,0,act,2026-03-06,2024-09-09 15:46:46,384.01,payment,275478.44
45877,9782919,46.0.188.30,1228.0,Portable term,25,3016,316136270,DEBIT,0,act,2026-03-06,2024-09-15 12:45:48,383.96,country_transfer,275094.48
45878,9785521,77.242.0.45,274.0,cash_in,30,1150,316136270,DEBIT,0,act,2026-03-06,2024-09-17 02:24:47,384.12,transfer,274710.36
45879,9812744,128.0.82.90,618.0,pos trm,25,1150,316136270,DEBIT,0,act,2026-03-06,2024-10-03 22:36:38,383.84,diff_cntry,274326.52
45880,9819769,95.167.0.105,208.0,atm,451,1982,316136270,DEBIT,0,act,2026-03-06,2024-10-09 11:55:09,383.94,payment,273942.58
45881,1025545,46.0.0.105,662.0,cash_in,25,9284,475293055,CREDIT,0,active,2029-05-01,2022-01-09 15:56:38,793.13,diff_cntry,973562.87
45882,1239670,37.0.127.75,1027.0,ATM,20,3417,475293055,CREDIT,0,active,2029-05-01,2022-02-20 06:03:12,793.01,from_acc,972769.86
45883,1247992,46.0.0.105,662.0,cash_in,-1,9032,475293055,CREDIT,1,active,2029-05-01,2022-02-21 02:04:04,793.35,bad,972769.86
45884,1427908,86.111.0.90,1350.0,port_trm,30,3376,475293055,CREDIT,0,active,2029-05-01,2022-03-11 14:02:01,793.24,transfer,971976.62
45885,2139294,88.210.0.120,350.0,atm,451,2963,475293055,CREDIT,0,active,2029-05-01,2022-03-15 22:34:26,793.19,payment,971183.43
45886,2458119,217.112.0.165,1485.0,ATM,10,7540,475293055,CREDIT,0,active,2029-05-01,2022-03-28 07:21:37,793.0,in_acc,971976.43
45887,2528042,193.31.0.195,605.0,atm,10,2963,475293055,CREDIT,0,active,2029-05-01,2022-03-29 18:26:13,793.24,in,972769.67
45888,2550591,86.111.0.90,1350.0,port_trm,30,4147,475293055,CREDIT,0,active,2029-05-01,2022-04-25 05:56:28,792.98,transfer,971976.69
45889,2939799,37.0.123.105,328.0,ATM,30,4323,475293055,CREDIT,0,active,2029-05-01,2022-05-02 10:48:45,792.72,transfer,971183.97
45890,3153437,188.191.0.210,1156.0,cash_in,10,7125,475293055,CREDIT,0,active,2029-05-01,2022-06-11 05:23:26,793.0,add_on_acc,971976.97
45891,3313516,194.87.0.240,585.0,cash_out,20,9032,475293055,CREDIT,0,active,2029-05-01,2022-07-17 09:35:00,793.19,decrease_on_acc,971183.78
45892,3666487,151.0.38.90,394.0,ATM,10,7833,475293055,CREDIT,0,active,2029-05-01,2022-07-27 09:09:08,792.89,in,971976.67
45893,3669497,46.0.0.105,662.0,cash_in,451,3376,475293055,CREDIT,0,active,2029-05-01,2022-08-01 23:53:31,792.74,payment,971183.93
45894,3991350,86.111.0.90,1350.0,port_trm,25,5015,475293055,CREDIT,0,active,2029-05-01,2022-08-16 23:17:57,792.9,country_transfer,970391.03
45895,4068196,91.107.0.75,980.0,cash_in,10,2616,475293055,CREDIT,0,active,2029-05-01,2022-08-22 00:16:45,792.97,in,971184.0
45896,4130769,86.111.0.90,1350.0,port_trm,451,2963,475293055,CREDIT,0,active,2029-05-01,2022-09-06 12:23:00,793.27,payment,970390.73
45897,4207854,88.210.0.120,350.0,atm,-1,2616,475293055,CREDIT,1,active,2029-05-01,2022-10-26 19:16:40,793.0,bad,970390.73
45898,4284209,86.111.0.90,1350.0,port_trm,30,5015,475293055,CREDIT,0,active,2029-05-01,2022-12-06 00:22:37,793.19,transfer,969597.54
45899,4391394,134.0.98.180,804.0,atm,20,1111,475293055,CREDIT,0,active,2029-05-01,2022-12-11 20:31:44,793.01,decrease_on_acc,968804.53
45900,4550489,188.191.0.120,1148.0,prtbl trm,30,3417,475293055,CREDIT,0,active,2029-05-01,2022-12-24 03:15:31,793.0,transfer,968011.53
45901,4851962,37.0.123.105,328.0,ATM,451,9032,475293055,CREDIT,0,active,2029-05-01,2022-12-30 18:39:50,792.97,payment,967218.56
45902,5041776,46.0.0.105,662.0,cash_in,10,2963,475293055,CREDIT,0,active,2029-05-01,2023-01-09 16:27:46,793.02,in_acc,968011.58
45903,5105474,134.0.98.195,806.0,cash_in,10,7833,475293055,CREDIT,0,active,2029-05-01,2023-01-18 09:48:10,793.1,in,968804.68
45904,5113880,46.0.0.105,662.0,cash_in,-1,5015,475293055,CREDIT,1,active,2029-05-01,2023-02-26 17:11:49,792.85,err,968804.68
45905,5399449,37.0.124.195,734.0,ATM,10,7125,475293055,CREDIT,0,active,2029-05-01,2023-03-28 16:05:25,792.95,in,969597.63
45906,5577038,45.154.0.195,312.0,atm,10,7540,475293055,CREDIT,0,active,2029-05-01,2023-04-01 02:26:37,793.06,in,970390.69
45907,5735717,37.0.123.105,328.0,ATM,451,5015,475293055,CREDIT,0,active,2029-05-01,2023-04-09 05:06:43,792.71,payment,969597.98
45908,5740882,128.0.82.165,627.0,atm,20,3417,475293055,CREDIT,0,active,2029-05-01,2023-04-18 10:33:53,792.95,decrease_on_acc,968805.03
45909,5958546,86.111.0.90,1350.0,port_trm,25,3417,475293055,CREDIT,0,active,2029-05-01,2023-04-28 18:09:43,792.75,country_transfer,968012.28
45910,6056230,37.0.123.105,328.0,ATM,451,7568,475293055,CREDIT,0,active,2029-05-01,2023-05-22 06:20:19,792.98,payment,967219.3
45911,6370167,128.0.94.180,1111.0,ATM,10,7568,475293055,CREDIT,0,active,2029-05-01,2023-08-17 20:06:00,793.08,in,968012.38
45912,6412797,128.0.24.0,879.0,cash_in,10,4882,475293055,CREDIT,0,active,2029-05-01,2023-09-21 11:18:04,793.01,in_acc,968805.39
45913,6619161,188.191.0.120,1148.0,prtbl trm,451,7125,475293055,CREDIT,0,active,2029-05-01,2023-10-23 20:04:32,793.15,payment,968012.24
45914,6820251,188.191.0.120,1148.0,prtbl trm,451,7540,475293055,CREDIT,0,active,2029-05-01,2023-11-10 12:09:57,793.0,payment,967219.24
45915,7026652,88.210.0.120,350.0,atm,451,2616,475293055,CREDIT,0,active,2029-05-01,2023-11-28 06:26:32,793.19,payment,966426.05
45916,7070725,88.210.0.75,346.0,atm,10,3417,475293055,CREDIT,0,active,2029-05-01,2023-12-04 18:36:47,793.07,in,967219.12
45917,7070803,88.210.0.120,350.0,atm,451,3376,475293055,CREDIT,0,active,2029-05-01,2024-02-05 18:31:10,793.18,payment,966425.94
45918,7475938,46.0.0.105,662.0,cash_in,451,7568,475293055,CREDIT,0,active,2029-05-01,2024-03-03 14:00:10,792.92,payment,965633.02
45919,7547538,88.210.0.120,350.0,atm,30,7540,475293055,CREDIT,0,active,2029-05-01,2024-03-26 10:26:46,793.15,transfer,964839.87
45920,7698392,188.0.166.75,1304.0,atm,20,4882,475293055,CREDIT,0,active,2029-05-01,2024-04-05 10:17:38,792.8,out,964047.07
45921,7714748,88.210.0.120,350.0,atm,25,6465,475293055,CREDIT,0,active,2029-05-01,2024-05-02 07:11:18,793.08,diff_cntry,963253.99
45922,8042710,188.191.0.120,1148.0,prtbl trm,451,3417,475293055,CREDIT,0,active,2029-05-01,2024-05-03 18:33:34,793.06,payment,962460.93
45923,8173742,86.111.0.90,1350.0,port_trm,30,3417,475293055,CREDIT,0,active,2029-05-01,2024-05-12 01:09:23,792.93,transfer,961668.0
45924,8356607,88.210.0.120,350.0,atm,25,7540,475293055,CREDIT,0,active,2029-05-01,2024-05-14 08:35:11,793.17,country_transfer,960874.83
45925,8816721,86.111.0.90,1350.0,port_trm,25,7125,475293055,CREDIT,0,active,2029-05-01,2024-06-16 04:47:59,793.4,diff_cntry,960081.43
45926,8868413,88.210.0.120,350.0,atm,451,8770,475293055,CREDIT,0,active,2029-05-01,2024-08-01 18:29:48,792.96,payment,959288.47
45927,9207098,88.210.0.120,350.0,atm,451,9284,475293055,CREDIT,0,active,2029-05-01,2024-09-03 14:11:43,792.97,payment,958495.5
45928,9231685,46.0.0.105,662.0,cash_in,451,7540,475293055,CREDIT,0,active,2029-05-01,2024-09-23 23:58:22,793.02,payment,957702.48
45929,9252247,188.191.0.120,1148.0,prtbl trm,25,8770,475293055,CREDIT,0,active,2029-05-01,2024-10-19 16:22:08,793.06,diff_cntry,956909.42
45930,9415093,37.0.123.105,328.0,ATM,30,6465,475293055,CREDIT,0,active,2029-05-01,2024-10-25 01:13:42,792.87,transfer,956116.55
45931,9457755,188.191.0.120,1148.0,prtbl trm,451,7540,475293055,CREDIT,0,active,2029-05-01,2024-10-30 13:31:34,792.96,payment,955323.59
45932,9883320,46.0.0.105,662.0,cash_in,-1,7568,475293055,CREDIT,1,active,2029-05-01,2024-11-16 01:47:30,793.24,err_code,955323.59
45933,1013517,188.43.0.30,1406.0,atm,30,4168,760774347,CREDIT,0,active,2025-07-25,2022-01-12 19:51:23,893.77,transfer,674210.23
45934,1350606,193.31.0.60,591.0,atm,451,8695,760774347,CREDIT,0,active,2025-07-25,2022-01-23 16:00:38,893.92,payment,673316.31
45935,1354910,193.31.0.60,591.0,atm,451,7933,760774347,CREDIT,0,active,2025-07-25,2022-02-09 23:30:46,893.89,payment,672422.42
45936,1415430,95.106.0.0,540.0,Portable term,25,8695,760774347,CREDIT,0,active,2025-07-25,2022-04-04 04:07:22,893.72,country_transfer,671528.7
45937,1668815,46.0.188.15,1227.0,atm,10,8366,760774347,CREDIT,0,active,2025-07-25,2022-04-22 23:47:41,894.07,add_on_acc,672422.77
45938,1707863,213.151.0.195,1015.0,atm,10,7933,760774347,CREDIT,0,active,2025-07-25,2022-04-30 22:57:24,893.98,add_on_acc,673316.75
45939,1935474,193.31.0.60,591.0,atm,-1,9293,760774347,CREDIT,1,active,2025-07-25,2022-05-08 21:53:00,893.99,err_code,673316.75
45940,2229795,188.43.0.30,1406.0,atm,451,4160,760774347,CREDIT,0,active,2025-07-25,2022-07-05 18:00:27,893.86,payment,672422.89
45941,2414074,193.31.0.60,591.0,atm,25,8366,760774347,CREDIT,0,active,2025-07-25,2022-07-07 03:50:53,894.13,diff_cntry,671528.76
45942,2607266,188.0.166.45,1300.0,port_trm,-1,1268,760774347,CREDIT,1,active,2025-07-25,2022-07-20 06:48:10,894.14,err_code,671528.76
45943,2833172,95.106.0.0,540.0,Portable term,30,7757,760774347,CREDIT,0,active,2025-07-25,2022-08-25 19:49:59,893.74,transfer,670635.02
45944,3159411,188.0.166.165,1311.0,cash_out,20,8871,760774347,CREDIT,0,active,2025-07-25,2022-09-16 15:01:19,894.05,out,669740.97
45945,3452035,37.0.127.165,1034.0,cash_in,10,5840,760774347,CREDIT,0,active,2025-07-25,2022-10-02 09:44:10,894.07,add_on_acc,670635.04
45946,3460930,185.17.0.60,1047.0,pos trm,25,9290,760774347,CREDIT,0,active,2025-07-25,2022-10-07 17:39:40,893.89,country_transfer,669741.15
45947,3544804,193.31.0.60,591.0,atm,451,9293,760774347,CREDIT,0,active,2025-07-25,2022-10-11 17:55:54,894.29,payment,668846.86
45948,3683741,128.0.24.0,879.0,cash_in,10,2579,760774347,CREDIT,0,active,2025-07-25,2022-10-20 03:16:50,894.14,in,669741.0
45949,3709925,188.0.166.45,1300.0,port_trm,-1,8734,760774347,CREDIT,1,active,2025-07-25,2022-10-22 22:33:43,894.29,err,669741.0
45950,3710069,193.31.0.60,591.0,atm,451,7933,760774347,CREDIT,0,active,2025-07-25,2022-11-21 17:04:53,894.03,payment,668846.97
45951,3759829,46.0.9.75,1322.0,cash_out,20,8871,760774347,CREDIT,0,active,2025-07-25,2022-12-08 18:57:32,893.75,out,667953.22
45952,3823404,185.17.0.60,1047.0,pos trm,451,7933,760774347,CREDIT,0,active,2025-07-25,2022-12-15 03:55:47,893.87,payment,667059.35
45953,4035090,185.17.0.60,1047.0,pos trm,-1,8734,760774347,CREDIT,1,active,2025-07-25,2022-12-25 06:25:37,893.96,err_code,667059.35
45954,4121130,95.106.0.0,540.0,Portable term,25,8534,760774347,CREDIT,0,active,2025-07-25,2023-02-01 18:23:32,893.85,diff_cntry,666165.5
45955,4167762,95.106.0.0,540.0,Portable term,451,6454,760774347,CREDIT,0,active,2025-07-25,2023-03-11 02:27:48,894.15,payment,665271.35
45956,4368392,188.43.0.30,1406.0,atm,-1,8734,760774347,CREDIT,1,active,2025-07-25,2023-04-05 10:19:55,893.99,err_code,665271.35
45957,4432654,185.17.0.60,1047.0,pos trm,451,6454,760774347,CREDIT,0,active,2025-07-25,2023-04-26 13:35:28,894.27,payment,664377.08
45958,4605324,188.0.166.45,1300.0,port_trm,-1,5840,760774347,CREDIT,1,active,2025-07-25,2023-06-27 09:38:40,893.64,err,664377.08
45959,4888609,193.31.0.60,591.0,atm,451,7933,760774347,CREDIT,0,active,2025-07-25,2023-06-29 07:45:35,893.85,payment,663483.23
45960,5002745,188.0.166.90,1305.0,cash_out,20,7757,760774347,CREDIT,0,active,2025-07-25,2023-06-30 11:46:29,893.85,out,662589.38
45961,5496612,185.17.0.60,1047.0,pos trm,451,8871,760774347,CREDIT,0,active,2025-07-25,2023-07-01 22:40:47,893.82,payment,661695.56
45962,5521135,37.0.127.75,1027.0,ATM,20,7742,760774347,CREDIT,0,active,2025-07-25,2023-07-13 18:48:27,894.01,decrease_on_acc,660801.55
45963,5582729,185.17.0.60,1047.0,pos trm,30,7453,760774347,CREDIT,0,active,2025-07-25,2023-08-07 15:19:33,894.02,transfer,659907.53
45964,5684953,95.106.0.0,540.0,Portable term,451,5840,760774347,CREDIT,0,active,2025-07-25,2023-10-08 09:09:23,893.92,payment,659013.61
45965,5823651,193.31.0.60,591.0,atm,30,7933,760774347,CREDIT,0,active,2025-07-25,2023-11-29 11:48:31,893.81,transfer,658119.8
45966,6303548,185.17.0.60,1047.0,pos trm,451,7757,760774347,CREDIT,0,active,2025-07-25,2023-12-14 15:40:45,894.04,payment,657225.76
45967,6408010,188.0.166.45,1300.0,port_trm,451,8366,760774347,CREDIT,0,active,2025-07-25,2023-12-21 18:53:21,893.99,payment,656331.77
45968,6712869,188.43.0.30,1406.0,atm,451,9293,760774347,CREDIT,0,active,2025-07-25,2024-01-15 12:49:33,894.02,payment,655437.75
45969,6930448,188.0.0.165,1217.0,ATM,10,8672,760774347,CREDIT,0,active,2025-07-25,2024-01-26 06:47:33,894.14,in_acc,656331.89
45970,6962093,188.43.0.30,1406.0,atm,25,7757,760774347,CREDIT,0,active,2025-07-25,2024-02-25 17:32:11,893.89,diff_cntry,655438.0
45971,7068738,46.0.123.45,913.0,atm,20,1268,760774347,CREDIT,0,active,2025-07-25,2024-04-11 04:03:57,894.02,decrease_on_acc,654543.98
45972,7116744,193.31.0.60,591.0,atm,25,1268,760774347,CREDIT,0,active,2025-07-25,2024-04-14 11:44:05,893.96,country_transfer,653650.02
45973,7204937,37.0.123.195,334.0,ATM,10,1321,760774347,CREDIT,0,active,2025-07-25,2024-04-25 13:28:35,894.13,in,654544.15
45974,7233585,188.0.166.45,1300.0,port_trm,25,2579,760774347,CREDIT,0,active,2025-07-25,2024-04-27 18:04:54,894.14,country_transfer,653650.01
45975,7301847,188.0.166.45,1300.0,port_trm,30,7933,760774347,CREDIT,0,active,2025-07-25,2024-06-04 11:30:59,894.0,transfer,652756.01
45976,7788089,85.140.0.240,1271.0,ATM,20,6454,760774347,CREDIT,0,active,2025-07-25,2024-06-09 00:48:13,894.06,decrease_on_acc,651861.95
45977,8072982,193.31.0.60,591.0,atm,30,1321,760774347,CREDIT,0,active,2025-07-25,2024-06-19 19:44:08,894.03,transfer,650967.92
45978,8293903,193.31.0.60,591.0,atm,451,5893,760774347,CREDIT,0,active,2025-07-25,2024-06-28 09:05:16,894.27,payment,650073.65
45979,8344147,185.17.0.60,1047.0,pos trm,451,1321,760774347,CREDIT,0,active,2025-07-25,2024-07-02 07:56:32,893.96,payment,649179.69
45980,8892104,188.0.166.45,1300.0,port_trm,25,7933,760774347,CREDIT,0,active,2025-07-25,2024-07-19 19:35:04,893.9,country_transfer,648285.79
45981,8905403,188.43.0.30,1406.0,atm,-1,5893,760774347,CREDIT,1,active,2025-07-25,2024-07-27 07:52:14,893.93,err_code,648285.79
45982,8945530,46.0.176.165,129.0,ATM,10,8734,760774347,CREDIT,0,active,2025-07-25,2024-08-04 04:54:14,893.95,in,649179.74
45983,9208178,188.0.166.45,1300.0,port_trm,30,8366,760774347,CREDIT,0,active,2025-07-25,2024-08-28 02:26:58,893.83,transfer,648285.91
45984,9379382,95.106.0.0,540.0,Portable term,451,7742,760774347,CREDIT,0,active,2025-07-25,2024-09-01 08:13:48,894.17,payment,647391.74
45985,9611002,188.0.166.45,1300.0,port_trm,-1,8672,760774347,CREDIT,1,active,2025-07-25,2024-11-16 20:03:39,893.85,bad,647391.74
45986,9860847,193.31.0.60,591.0,atm,451,7933,760774347,CREDIT,0,active,2025-07-25,2024-11-17 08:02:07,893.85,payment,646497.89
45987,9869511,185.17.0.60,1047.0,pos trm,30,8672,760774347,CREDIT,0,active,2025-07-25,2024-11-18 12:06:58,893.97,transfer,645603.92
45988,1150181,5.189.0.180,871.0,ATM,30,3716,668775790,CREDIT,0,active,2025-02-07,2022-01-03 11:12:27,807.31,transfer,100296.69
45989,1433297,46.0.2.120,190.0,prtbl trm,451,2332,668775790,CREDIT,0,active,2025-02-07,2022-01-12 19:06:01,806.92,payment,99489.77
45990,1596188,188.244.0.135,1461.0,atm,451,7089,668775790,CREDIT,0,active,2025-02-07,2022-05-18 02:29:49,806.9,payment,98682.87
45991,1793787,46.0.9.135,1326.0,pos trm,-1,1616,668775790,CREDIT,1,active,2025-02-07,2022-06-17 10:19:23,806.96,err_code,98682.87
45992,1844261,46.0.2.120,190.0,prtbl trm,451,7089,668775790,CREDIT,0,active,2025-02-07,2022-07-16 06:17:16,807.21,payment,97875.66
45993,2710012,5.189.0.180,871.0,ATM,451,2446,668775790,CREDIT,0,active,2025-02-07,2022-07-17 16:40:46,806.98,payment,97068.68
45994,2844454,193.31.0.15,587.0,cash_out,-1,6652,668775790,CREDIT,1,active,2025-02-07,2022-07-24 20:51:21,807.29,err,97068.68
45995,3358462,5.189.0.180,871.0,ATM,25,5728,668775790,CREDIT,0,active,2025-02-07,2022-08-08 11:47:50,807.0,country_transfer,96261.68
45996,3384950,194.87.0.180,579.0,atm,20,5943,668775790,CREDIT,0,active,2025-02-07,2022-08-10 05:49:45,807.16,from_acc,95454.52
45997,3404719,188.191.0.105,1146.0,cash_out,25,8929,668775790,CREDIT,0,active,2025-02-07,2022-09-13 06:11:45,807.15,diff_cntry,94647.37
45998,3596523,188.244.0.135,1461.0,atm,30,3132,668775790,CREDIT,0,active,2025-02-07,2022-09-27 09:16:06,807.02,transfer,93840.35
45999,3714871,193.31.0.15,587.0,cash_out,451,6652,668775790,CREDIT,0,active,2025-02-07,2022-10-28 14:03:06,806.94,payment,93033.41
46000,3862090,37.0.123.30,320.0,cash_in,10,6842,668775790,CREDIT,0,active,2025-02-07,2022-11-13 23:10:05,806.93,in,93840.34
46001,3897893,5.189.0.180,871.0,ATM,-1,1616,668775790,CREDIT,1,active,2025-02-07,2022-11-21 14:30:53,806.88,err,93840.34
46002,4023644,188.0.189.90,838.0,Portable term,-1,2744,668775790,CREDIT,2,active,2025-02-07,2022-11-26 11:27:33,807.05,err,93840.34
46003,4162350,46.0.9.135,1326.0,pos trm,451,3132,668775790,CREDIT,0,active,2025-02-07,2022-12-11 17:57:43,807.19,payment,93033.15
46004,4387087,188.244.0.135,1461.0,atm,30,7089,668775790,CREDIT,0,active,2025-02-07,2023-01-14 15:49:32,807.07,transfer,92226.08
46005,4846513,194.156.0.105,29.0,ATM,20,2744,668775790,CREDIT,0,active,2025-02-07,2023-01-23 06:49:12,806.85,decrease_on_acc,91419.23
46006,5016005,46.0.9.135,1326.0,pos trm,-1,9270,668775790,CREDIT,1,active,2025-02-07,2023-04-06 08:00:05,806.92,bad,91419.23
46007,5360991,188.191.0.105,1146.0,cash_out,-1,8303,668775790,CREDIT,2,active,2025-02-07,2023-04-16 08:36:02,806.98,err_code,91419.23
46008,5361618,194.0.144.105,168.0,ATM,20,8303,668775790,CREDIT,0,active,2025-02-07,2023-04-22 20:31:49,807.04,from_acc,90612.19
46009,5909704,46.0.2.120,190.0,prtbl trm,451,6435,668775790,CREDIT,0,active,2025-02-07,2023-04-25 02:53:19,806.87,payment,89805.32
46010,6048009,188.191.0.105,1146.0,cash_out,451,8303,668775790,CREDIT,0,active,2025-02-07,2023-04-30 02:34:20,807.01,payment,88998.31
46011,6184809,95.106.0.210,562.0,cash_in,451,2332,668775790,CREDIT,0,active,2025-02-07,2023-05-09 20:38:11,806.83,payment,88191.48
46012,6198454,194.0.144.75,166.0,Portable term,451,5181,668775790,CREDIT,0,active,2025-02-07,2023-06-11 07:08:49,807.15,payment,87384.33
46013,6251308,5.189.0.180,871.0,ATM,-1,2446,668775790,CREDIT,1,active,2025-02-07,2023-06-28 09:30:59,806.99,err_code,87384.33
46014,6334053,46.0.54.225,1092.0,cash_in,10,6435,668775790,CREDIT,0,active,2025-02-07,2023-07-16 19:32:35,807.15,in_acc,88191.48
46015,6546961,194.0.144.75,166.0,Portable term,30,8929,668775790,CREDIT,0,active,2025-02-07,2023-09-21 12:53:27,807.13,transfer,87384.35
46016,6658729,5.189.0.180,871.0,ATM,30,6435,668775790,CREDIT,0,active,2025-02-07,2023-09-26 00:17:15,806.97,transfer,86577.38
46017,6860779,194.156.0.90,28.0,cash_in,10,5181,668775790,CREDIT,0,active,2025-02-07,2023-09-27 21:20:52,806.93,add_on_acc,87384.31
46018,7082275,188.244.0.135,1461.0,atm,451,6719,668775790,CREDIT,0,active,2025-02-07,2023-10-18 06:58:04,806.89,payment,86577.42
46019,7191489,31.134.0.165,1127.0,atm,10,3716,668775790,CREDIT,0,active,2025-02-07,2023-10-25 23:01:38,806.86,in_acc,87384.28
46020,7208926,62.118.0.30,522.0,ATM,10,9628,668775790,CREDIT,0,active,2025-02-07,2023-11-13 00:52:52,806.82,add_on_acc,88191.1
46021,7301804,5.189.0.180,871.0,ATM,451,2744,668775790,CREDIT,0,active,2025-02-07,2023-11-13 18:13:00,806.95,payment,87384.15
46022,7454692,46.0.8.135,147.0,atm,20,7089,668775790,CREDIT,0,active,2025-02-07,2023-11-28 16:01:11,807.12,out,86577.03
46023,7587248,46.0.9.240,1339.0,cash_out,20,6435,668775790,CREDIT,0,active,2025-02-07,2023-12-01 01:09:04,807.08,decrease_on_acc,85769.95
46024,7648945,194.87.0.120,574.0,cash_out,20,6652,668775790,CREDIT,0,active,2025-02-07,2023-12-19 02:43:21,806.98,out,84962.97
46025,7764318,95.106.0.210,562.0,cash_in,25,2566,668775790,CREDIT,0,active,2025-02-07,2023-12-22 15:00:32,806.82,diff_cntry,84156.15
46026,7776287,5.189.0.135,866.0,ATM,10,1616,668775790,CREDIT,0,active,2025-02-07,2024-01-23 08:20:48,807.08,in,84963.23
46027,7794684,46.0.9.135,1326.0,pos trm,451,6719,668775790,CREDIT,0,active,2025-02-07,2024-03-01 01:50:07,807.18,payment,84156.05
46028,7926542,95.106.0.210,562.0,cash_in,451,9417,668775790,CREDIT,0,active,2025-02-07,2024-03-11 22:00:26,806.82,payment,83349.23
46029,8206085,194.0.144.105,168.0,ATM,10,5728,668775790,CREDIT,0,active,2025-02-07,2024-03-26 10:50:26,806.9,in,84156.13
46030,8326405,188.191.0.105,1146.0,cash_out,30,3825,668775790,CREDIT,0,active,2025-02-07,2024-05-07 19:04:27,807.05,transfer,83349.08
46031,8332458,95.106.0.210,562.0,cash_in,25,8303,668775790,CREDIT,0,active,2025-02-07,2024-05-23 14:37:48,807.02,country_transfer,82542.06
46032,8532991,194.0.144.75,166.0,Portable term,451,2744,668775790,CREDIT,0,active,2025-02-07,2024-05-27 04:39:47,807.0,payment,81735.06
46033,8696168,45.154.0.120,304.0,ATM,20,6652,668775790,CREDIT,0,active,2025-02-07,2024-06-26 03:25:20,806.94,from_acc,80928.12
46034,8709652,37.0.123.195,334.0,ATM,20,8303,668775790,CREDIT,0,active,2025-02-07,2024-06-30 21:30:44,806.82,from_acc,80121.3
46035,8798664,194.156.0.90,28.0,cash_in,10,1359,668775790,CREDIT,0,active,2025-02-07,2024-07-01 14:51:26,807.05,in,80928.35
46036,8905853,188.0.189.90,838.0,Portable term,451,5181,668775790,CREDIT,0,active,2025-02-07,2024-07-02 17:20:08,806.43,payment,80121.92
46037,9054576,5.189.0.180,871.0,ATM,451,2566,668775790,CREDIT,0,active,2025-02-07,2024-08-07 23:40:04,807.0,payment,79314.92
46038,9083616,217.26.0.120,687.0,atm,10,3825,668775790,CREDIT,0,active,2025-02-07,2024-08-09 15:36:01,807.03,in_acc,80121.95
46039,9205723,151.0.38.120,398.0,ATM,20,9628,668775790,CREDIT,0,active,2025-02-07,2024-08-16 23:00:20,807.05,decrease_on_acc,79314.9
46040,9212361,95.167.0.135,211.0,ATM,10,2566,668775790,CREDIT,0,active,2025-02-07,2024-08-28 17:06:45,806.81,in,80121.71
46041,9410007,188.0.189.90,838.0,Portable term,451,6652,668775790,CREDIT,0,active,2025-02-07,2024-09-01 00:49:25,806.88,payment,79314.83
46042,9745965,188.244.0.135,1461.0,atm,30,7089,668775790,CREDIT,0,active,2025-02-07,2024-09-11 09:23:06,806.97,transfer,78507.86
46043,9822534,5.189.0.180,871.0,ATM,25,5181,668775790,CREDIT,0,active,2025-02-07,2024-09-29 04:13:57,806.93,diff_cntry,77700.93
46044,9914082,95.106.0.210,562.0,cash_in,30,2446,668775790,CREDIT,0,active,2025-02-07,2024-10-06 19:31:04,806.9,transfer,76894.03
46045,9918632,188.0.189.90,838.0,Portable term,451,8671,668775790,CREDIT,0,active,2025-02-07,2024-10-08 08:28:59,807.23,payment,76086.8
46046,9975241,194.0.144.75,166.0,Portable term,-1,3132,668775790,CREDIT,1,active,2025-02-07,2024-10-31 12:48:50,807.44,err_code,76086.8
46047,1147925,46.0.54.135,1084.0,port_trm,451,7973,704648707,DEBIT,0,active,2027-02-06,2022-01-04 20:30:30,987.83,payment,930846.17
46048,1283843,37.0.124.15,720.0,prtbl trm,30,8072,704648707,DEBIT,0,active,2027-02-06,2022-01-30 21:16:59,988.1,transfer,929858.07
46049,1359210,193.0.151.210,72.0,Portable term,-1,4389,704648707,DEBIT,1,active,2027-02-06,2022-02-20 12:32:57,988.09,bad,929858.07
46050,1436418,77.242.0.0,268.0,cash_out,20,8072,704648707,DEBIT,0,active,2027-02-06,2022-02-28 01:12:39,988.36,from_acc,928869.71
46051,1673842,37.0.124.15,720.0,prtbl trm,451,1136,704648707,DEBIT,0,active,2027-02-06,2022-03-03 19:42:16,988.03,payment,927881.68
46052,1696275,188.244.0.240,1470.0,port_trm,451,3514,704648707,DEBIT,0,active,2027-02-06,2022-03-07 23:09:13,988.2,payment,926893.48
46053,1791244,188.244.0.240,1470.0,port_trm,-1,8153,704648707,DEBIT,1,active,2027-02-06,2022-04-15 14:47:16,988.33,err_code,926893.48
46054,2351968,193.0.151.210,72.0,Portable term,30,1439,704648707,DEBIT,0,active,2027-02-06,2022-04-17 02:23:40,987.9,transfer,925905.58
46055,2399849,128.0.94.195,1112.0,cash_in,-1,8072,704648707,DEBIT,1,active,2027-02-06,2022-05-19 03:52:09,988.16,err,925905.58
46056,2485043,188.244.0.240,1470.0,port_trm,-1,7973,704648707,DEBIT,2,active,2027-02-06,2022-06-08 09:07:08,987.94,bad,925905.58
46057,2938303,46.0.143.150,823.0,prtbl trm,451,8153,704648707,DEBIT,0,active,2027-02-06,2022-07-29 15:21:15,987.87,payment,924917.71
46058,3042030,188.244.0.240,1470.0,port_trm,30,9387,704648707,DEBIT,0,active,2027-02-06,2022-08-03 03:12:47,988.26,transfer,923929.45
46059,3052658,185.17.0.195,1064.0,ATM,10,9862,704648707,DEBIT,0,active,2027-02-06,2022-09-02 19:54:55,987.87,in_acc,924917.32
46060,3310284,188.0.166.135,1308.0,pos trm,25,8153,704648707,DEBIT,0,active,2027-02-06,2022-09-26 15:17:22,987.96,country_transfer,923929.36
46061,3662533,37.0.124.15,720.0,prtbl trm,451,7973,704648707,DEBIT,0,active,2027-02-06,2022-10-12 14:20:18,987.98,payment,922941.38
46062,3835247,128.0.94.195,1112.0,cash_in,451,1136,704648707,DEBIT,0,active,2027-02-06,2022-11-02 08:37:00,987.8,payment,921953.58
46063,4151396,188.244.0.240,1470.0,port_trm,-1,1439,704648707,DEBIT,1,active,2027-02-06,2023-01-19 02:06:08,988.14,err,921953.58
46064,4228963,193.0.151.210,72.0,Portable term,30,8072,704648707,DEBIT,0,active,2027-02-06,2023-02-17 07:13:36,987.86,transfer,920965.72
46065,4323576,46.0.2.225,198.0,ATM,20,6655,704648707,DEBIT,0,active,2027-02-06,2023-02-26 06:14:07,988.18,out,919977.54
46066,4580869,188.128.16.181,1198.0,prtbl trm,30,6699,704648707,DEBIT,0,active,2027-02-06,2023-03-01 16:18:23,988.03,transfer,918989.51
46067,4686855,46.0.54.240,1093.0,atm,10,5450,704648707,DEBIT,0,active,2027-02-06,2023-03-18 23:57:49,987.98,in_acc,919977.49
46068,4689725,46.0.0.90,661.0,prtbl trm,-1,3337,704648707,DEBIT,1,active,2027-02-06,2023-04-04 20:06:52,988.0,bad,919977.49
46069,4803629,37.0.124.15,720.0,prtbl trm,-1,1889,704648707,DEBIT,2,active,2027-02-06,2023-04-09 19:37:55,988.08,bad,919977.49
46070,5289776,217.112.0.0,1471.0,ATM,20,5450,704648707,DEBIT,0,active,2027-02-06,2023-04-30 14:58:29,987.74,from_acc,918989.75
46071,5403619,217.26.0.135,688.0,ATM,20,5121,704648707,DEBIT,0,active,2027-02-06,2023-06-14 13:06:22,987.78,from_acc,918001.97
46072,5425136,217.26.0.210,695.0,cash_out,20,4887,704648707,DEBIT,0,active,2027-02-06,2023-06-19 10:26:37,987.96,from_acc,917014.01
46073,5606341,193.0.151.210,72.0,Portable term,-1,2568,704648707,DEBIT,1,active,2027-02-06,2023-08-24 06:12:39,987.9,err_code,917014.01
46074,5673012,46.0.0.90,661.0,prtbl trm,30,6699,704648707,DEBIT,0,active,2027-02-06,2023-08-25 17:31:49,987.94,transfer,916026.07
46075,6142194,128.0.94.195,1112.0,cash_in,25,1439,704648707,DEBIT,0,active,2027-02-06,2023-09-06 11:49:09,987.88,country_transfer,915038.19
46076,6148260,95.167.0.135,211.0,ATM,10,3337,704648707,DEBIT,0,active,2027-02-06,2023-09-22 07:00:58,988.14,in_acc,916026.33
46077,6487373,128.0.94.195,1112.0,cash_in,25,8072,704648707,DEBIT,0,active,2027-02-06,2023-09-23 04:50:14,987.76,diff_cntry,915038.57
46078,6547490,46.0.54.135,1084.0,port_trm,451,1889,704648707,DEBIT,0,active,2027-02-06,2023-09-24 03:48:32,988.15,payment,914050.42
46079,6558765,31.134.0.0,1116.0,atm,20,6655,704648707,DEBIT,0,active,2027-02-06,2023-09-27 10:49:16,988.18,out,913062.24
46080,6715684,37.0.124.15,720.0,prtbl trm,30,6699,704648707,DEBIT,0,active,2027-02-06,2023-10-25 05:41:23,988.07,transfer,912074.17
46081,6840210,188.0.166.135,1308.0,pos trm,451,6655,704648707,DEBIT,0,active,2027-02-06,2023-11-03 00:09:45,988.17,payment,911086.0
46082,7303426,46.0.54.135,1084.0,port_trm,451,8072,704648707,DEBIT,0,active,2027-02-06,2024-01-24 16:02:36,987.85,payment,910098.15
46083,7705679,46.0.143.150,823.0,prtbl trm,30,1136,704648707,DEBIT,0,active,2027-02-06,2024-01-26 06:33:10,988.1,transfer,909110.05
46084,7830176,46.0.143.150,823.0,prtbl trm,25,5317,704648707,DEBIT,0,active,2027-02-06,2024-02-02 17:16:57,987.96,country_transfer,908122.09
46085,7855325,188.128.16.181,1198.0,prtbl trm,451,9862,704648707,DEBIT,0,active,2027-02-06,2024-02-16 16:27:21,987.99,payment,907134.1
46086,8069661,188.244.0.240,1470.0,port_trm,451,7973,704648707,DEBIT,0,active,2027-02-06,2024-03-10 08:55:07,988.17,payment,906145.93
46087,8345740,88.210.0.15,341.0,atm,20,6699,704648707,DEBIT,0,active,2027-02-06,2024-03-25 07:53:56,987.69,decrease_on_acc,905158.24
46088,8902008,188.0.166.135,1308.0,pos trm,30,3514,704648707,DEBIT,0,active,2027-02-06,2024-03-26 23:20:06,988.15,transfer,904170.09
46089,9247170,88.210.0.135,353.0,cash_in,10,5317,704648707,DEBIT,0,active,2027-02-06,2024-04-26 07:53:30,988.11,in_acc,905158.2
46090,9369329,95.167.0.0,200.0,ATM,20,5121,704648707,DEBIT,0,active,2027-02-06,2024-05-31 21:28:13,987.89,out,904170.31
46091,9462959,86.111.0.180,1356.0,cash_out,20,6699,704648707,DEBIT,0,active,2027-02-06,2024-06-23 15:01:49,987.94,out,903182.37
46092,9494064,188.244.0.240,1470.0,port_trm,451,6910,704648707,DEBIT,0,active,2027-02-06,2024-06-27 16:21:30,987.95,payment,902194.42
46093,9832755,46.0.143.150,823.0,prtbl trm,25,8153,704648707,DEBIT,0,active,2027-02-06,2024-07-24 04:49:13,988.12,country_transfer,901206.3
46094,9870881,62.118.0.210,537.0,ATM,10,9862,704648707,DEBIT,0,active,2027-02-06,2024-08-17 04:33:02,987.72,add_on_acc,902194.02
46095,9951620,46.0.143.150,823.0,prtbl trm,451,8072,704648707,DEBIT,0,active,2027-02-06,2024-09-23 09:57:17,988.16,payment,901205.86
46096,9969432,46.0.54.135,1084.0,port_trm,30,1889,704648707,DEBIT,0,active,2027-02-06,2024-09-25 03:34:47,987.93,transfer,900217.93
46097,9991785,46.0.54.135,1084.0,port_trm,30,4887,704648707,DEBIT,0,active,2027-02-06,2024-11-14 03:52:47,987.98,transfer,899229.95
46098,1144599,46.173.0.105,502.0,atm,-1,6004,883176016,CREDIT,1,act,2028-08-18,2022-01-04 09:04:54,122.28,err,679719.0
46099,1196634,46.173.0.105,502.0,atm,25,5812,883176016,CREDIT,0,act,2028-08-18,2022-01-18 21:40:49,122.11,diff_cntry,679596.89
46100,1269358,128.0.94.195,1112.0,cash_in,-1,6313,883176016,CREDIT,1,act,2028-08-18,2022-01-29 18:16:54,122.13,err,679596.89
46101,1307987,188.0.166.30,1298.0,ATM,20,5749,883176016,CREDIT,0,act,2028-08-18,2022-02-21 21:33:16,122.13,decrease_on_acc,679474.76
46102,1503810,46.173.0.105,502.0,atm,25,3753,883176016,CREDIT,0,act,2028-08-18,2022-03-05 15:14:08,122.11,diff_cntry,679352.65
46103,1750701,79.104.0.90,642.0,ATM,20,3434,883176016,CREDIT,0,act,2028-08-18,2022-03-11 06:14:23,122.04,from_acc,679230.61
46104,2025706,95.106.0.0,540.0,Portable term,-1,1845,883176016,CREDIT,1,act,2028-08-18,2022-05-30 23:05:19,121.9,bad,679230.61
46105,2194211,128.0.94.195,1112.0,cash_in,451,5812,883176016,CREDIT,0,act,2028-08-18,2022-06-23 12:19:03,121.91,payment,679108.7
46106,2255511,151.0.38.120,398.0,ATM,25,5036,883176016,CREDIT,0,act,2028-08-18,2022-06-30 03:10:46,122.02,diff_cntry,678986.68
46107,2374377,46.8.0.240,787.0,ATM,10,9027,883176016,CREDIT,0,act,2028-08-18,2022-07-02 15:09:33,121.82,in_acc,679108.5
46108,2540988,46.0.9.30,1319.0,cash_in,10,6004,883176016,CREDIT,0,act,2028-08-18,2022-08-04 04:58:35,122.06,in,679230.56
46109,2817006,85.140.0.30,1249.0,cash_out,30,2304,883176016,CREDIT,0,act,2028-08-18,2022-08-06 18:23:21,121.75,transfer,679108.81
46110,3163939,151.0.38.120,398.0,ATM,451,3753,883176016,CREDIT,0,act,2028-08-18,2022-09-02 00:48:19,122.07,payment,678986.74
46111,3439744,95.106.0.0,540.0,Portable term,30,6004,883176016,CREDIT,0,act,2028-08-18,2022-10-03 23:22:20,121.9,transfer,678864.84
46112,3772468,195.58.0.60,1429.0,ATM,20,7970,883176016,CREDIT,0,act,2028-08-18,2022-10-17 12:26:29,121.98,from_acc,678742.86
46113,4005375,78.24.158.159,944.0,cash_out,20,3434,883176016,CREDIT,0,act,2028-08-18,2022-10-22 14:46:41,121.86,out,678621.0
46114,4136117,151.0.38.120,398.0,ATM,451,7970,883176016,CREDIT,0,act,2028-08-18,2022-12-20 14:22:04,121.9,payment,678499.1
46115,4346113,95.106.0.0,540.0,Portable term,-1,6004,883176016,CREDIT,1,act,2028-08-18,2023-01-05 16:40:45,122.08,err,678499.1
46116,4484489,128.0.94.195,1112.0,cash_in,25,8622,883176016,CREDIT,0,act,2028-08-18,2023-02-05 11:53:33,121.72,diff_cntry,678377.38
46117,4545647,194.0.144.105,168.0,ATM,20,1845,883176016,CREDIT,0,act,2028-08-18,2023-02-11 16:45:08,122.19,from_acc,678255.19
46118,4916980,46.173.0.105,502.0,atm,25,1845,883176016,CREDIT,0,act,2028-08-18,2023-02-20 18:16:10,121.99,diff_cntry,678133.2
46119,5024295,85.140.0.30,1249.0,cash_out,-1,2304,883176016,CREDIT,1,act,2028-08-18,2023-02-26 11:36:51,121.95,err_code,678133.2
46120,5031076,95.106.0.0,540.0,Portable term,30,7970,883176016,CREDIT,0,act,2028-08-18,2023-03-13 11:37:02,121.79,transfer,678011.41
46121,5292057,128.0.94.195,1112.0,cash_in,451,3753,883176016,CREDIT,0,act,2028-08-18,2023-04-25 07:43:10,122.09,payment,677889.32
46122,5510607,151.0.38.120,398.0,ATM,451,8622,883176016,CREDIT,0,act,2028-08-18,2023-05-04 14:07:48,121.82,payment,677767.5
46123,5564058,95.106.0.0,540.0,Portable term,451,8622,883176016,CREDIT,0,act,2028-08-18,2023-07-24 09:32:47,122.0,payment,677645.5
46124,5640516,85.140.0.30,1249.0,cash_out,25,1859,883176016,CREDIT,0,act,2028-08-18,2023-08-22 18:30:01,122.13,diff_cntry,677523.37
46125,5677119,46.173.0.105,502.0,atm,25,7970,883176016,CREDIT,0,act,2028-08-18,2023-09-11 06:26:58,122.09,diff_cntry,677401.28
46126,6078541,128.0.94.195,1112.0,cash_in,25,3434,883176016,CREDIT,0,act,2028-08-18,2023-09-23 10:51:38,122.24,diff_cntry,677279.04
46127,6117263,85.140.0.30,1249.0,cash_out,25,3753,883176016,CREDIT,0,act,2028-08-18,2023-10-20 21:12:46,122.06,country_transfer,677156.98
46128,6532390,95.106.0.0,540.0,Portable term,25,4877,883176016,CREDIT,0,act,2028-08-18,2023-10-30 12:07:21,122.03,diff_cntry,677034.95
46129,6578907,85.140.0.30,1249.0,cash_out,25,4877,883176016,CREDIT,0,act,2028-08-18,2023-11-05 21:27:23,121.77,diff_cntry,676913.18
46130,6605379,46.173.0.105,502.0,atm,-1,5223,883176016,CREDIT,1,act,2028-08-18,2023-11-08 22:51:19,121.89,err_code,676913.18
46131,6929985,151.0.38.120,398.0,ATM,451,6313,883176016,CREDIT,0,act,2028-08-18,2023-11-24 13:28:21,121.9,payment,676791.28
46132,6955155,77.242.0.0,268.0,cash_out,20,7970,883176016,CREDIT,0,act,2028-08-18,2023-12-31 06:26:36,122.05,decrease_on_acc,676669.23
46133,7026375,95.106.0.0,540.0,Portable term,25,1859,883176016,CREDIT,0,act,2028-08-18,2024-01-07 16:11:42,121.96,country_transfer,676547.27
46134,7231677,95.106.0.0,540.0,Portable term,451,1845,883176016,CREDIT,0,act,2028-08-18,2024-02-07 09:49:51,122.01,payment,676425.26
46135,7267162,151.0.38.120,398.0,ATM,451,7970,883176016,CREDIT,0,act,2028-08-18,2024-02-23 14:23:39,121.72,payment,676303.54
46136,7277360,46.173.0.105,502.0,atm,451,5223,883176016,CREDIT,0,act,2028-08-18,2024-03-09 18:37:16,122.12,payment,676181.42
46137,7374916,85.140.0.30,1249.0,cash_out,25,3434,883176016,CREDIT,0,act,2028-08-18,2024-03-17 09:32:49,122.29,country_transfer,676059.13
46138,7393933,128.0.94.195,1112.0,cash_in,451,3753,883176016,CREDIT,0,act,2028-08-18,2024-05-01 04:34:11,122.09,payment,675937.04
46139,7743654,151.0.38.120,398.0,ATM,30,6313,883176016,CREDIT,0,act,2028-08-18,2024-05-06 17:11:22,122.0,transfer,675815.04
46140,7864246,46.173.0.105,502.0,atm,451,1845,883176016,CREDIT,0,act,2028-08-18,2024-06-22 15:37:50,122.0,payment,675693.04
46141,7914056,85.140.0.30,1249.0,cash_out,30,5036,883176016,CREDIT,0,act,2028-08-18,2024-07-05 13:21:54,121.96,transfer,675571.08
46142,8205226,188.191.0.165,1152.0,atm,20,3753,883176016,CREDIT,0,act,2028-08-18,2024-07-20 11:57:21,121.8,decrease_on_acc,675449.28
46143,8224553,151.0.38.120,398.0,ATM,-1,1845,883176016,CREDIT,1,act,2028-08-18,2024-07-23 08:34:52,122.09,bad,675449.28
46144,8394858,188.18.0.30,223.0,cash_out,20,5749,883176016,CREDIT,0,act,2028-08-18,2024-07-30 15:59:10,121.89,from_acc,675327.39
46145,8610354,95.106.0.0,540.0,Portable term,451,5036,883176016,CREDIT,0,act,2028-08-18,2024-08-03 20:42:45,122.21,payment,675205.18
46146,8665763,46.0.123.225,929.0,ATM,20,8622,883176016,CREDIT,0,act,2028-08-18,2024-08-18 18:11:06,122.2,from_acc,675082.98
46147,8970971,195.58.0.30,1426.0,cash_in,10,5036,883176016,CREDIT,0,act,2028-08-18,2024-08-23 14:46:05,122.06,add_on_acc,675205.04
46148,9148588,95.106.0.0,540.0,Portable term,25,8622,883176016,CREDIT,0,act,2028-08-18,2024-09-09 07:35:55,122.21,country_transfer,675082.83
46149,9391164,194.87.0.60,570.0,cash_out,20,3434,883176016,CREDIT,0,act,2028-08-18,2024-10-05 22:07:20,121.95,decrease_on_acc,674960.88
46150,9606291,46.173.0.105,502.0,atm,451,2304,883176016,CREDIT,0,act,2028-08-18,2024-10-10 10:06:59,121.86,payment,674839.02
46151,9674020,85.140.0.210,1267.0,cash_out,20,6313,883176016,CREDIT,0,act,2028-08-18,2024-10-31 04:56:39,121.99,from_acc,674717.03
46152,9915465,95.106.0.0,540.0,Portable term,30,1845,883176016,CREDIT,0,act,2028-08-18,2024-11-01 12:17:43,121.81,transfer,674595.22
46153,1092459,193.31.0.75,592.0,prtbl trm,451,4272,981768769,CREDIT,0,active,2027-10-19,2022-01-07 11:45:32,126.3,payment,350974.7
46154,1535557,188.128.16.241,1205.0,atm,10,9054,981768769,CREDIT,0,active,2027-10-19,2022-01-25 09:08:07,126.01,in_acc,351100.71
46155,1916558,188.244.0.30,1450.0,port_trm,30,3763,981768769,CREDIT,0,active,2027-10-19,2022-02-17 20:54:53,126.23,transfer,350974.48
46156,2085306,46.0.123.15,910.0,ATM,10,7347,981768769,CREDIT,0,active,2027-10-19,2022-03-15 07:54:11,126.17,in,351100.65
46157,2444684,188.244.0.30,1450.0,port_trm,451,7279,981768769,CREDIT,0,active,2027-10-19,2022-04-03 20:05:16,126.12,payment,350974.53
46158,2464283,213.151.0.210,1017.0,cash_out,20,9108,981768769,CREDIT,0,active,2027-10-19,2022-04-06 01:31:40,126.12,from_acc,350848.41
46159,2716708,37.0.124.45,723.0,cash_in,-1,7571,981768769,CREDIT,1,active,2027-10-19,2022-04-14 12:47:38,126.01,err_code,350848.41
46160,2752063,188.0.0.0,1206.0,atm,20,3821,981768769,CREDIT,0,active,2027-10-19,2022-04-15 15:37:17,126.06,decrease_on_acc,350722.35
46161,2788857,193.31.0.210,607.0,cash_out,-1,7869,981768769,CREDIT,1,active,2027-10-19,2022-05-30 09:22:27,126.24,err,350722.35
46162,2979231,46.0.176.240,135.0,cash_out,20,4240,981768769,CREDIT,0,active,2027-10-19,2022-06-04 09:17:31,125.89,decrease_on_acc,350596.46
46163,3487824,128.0.94.210,1113.0,cash_in,-1,7279,981768769,CREDIT,1,active,2027-10-19,2022-06-04 21:42:07,126.17,err_code,350596.46
46164,3771663,128.0.94.210,1113.0,cash_in,-1,9108,981768769,CREDIT,2,active,2027-10-19,2022-06-05 22:02:43,126.02,bad,350596.46
46165,3771670,151.0.38.180,403.0,atm,20,3821,981768769,CREDIT,0,active,2027-10-19,2022-06-17 19:20:33,125.99,decrease_on_acc,350470.47
46166,3959715,128.0.94.210,1113.0,cash_in,-1,9752,981768769,CREDIT,1,active,2027-10-19,2022-09-18 14:52:21,125.8,err_code,350470.47
46167,4667057,128.0.94.210,1113.0,cash_in,451,4240,981768769,CREDIT,0,active,2027-10-19,2022-10-02 13:44:10,125.95,payment,350344.52
46168,4774766,46.0.8.135,147.0,atm,10,2090,981768769,CREDIT,0,active,2027-10-19,2022-11-10 04:15:11,126.03,in_acc,350470.55
46169,4965205,45.154.0.120,304.0,ATM,10,9788,981768769,CREDIT,0,active,2027-10-19,2022-11-10 21:23:22,126.06,in_acc,350596.61
46170,5001952,128.0.94.210,1113.0,cash_in,30,7347,981768769,CREDIT,0,active,2027-10-19,2022-12-01 14:31:47,126.18,transfer,350470.43
46171,5115569,128.0.94.210,1113.0,cash_in,30,4272,981768769,CREDIT,0,active,2027-10-19,2022-12-29 14:18:32,125.86,transfer,350344.57
46172,5188816,188.244.0.30,1450.0,port_trm,451,9108,981768769,CREDIT,0,active,2027-10-19,2023-01-08 07:08:59,126.12,payment,350218.45
46173,5204006,185.173.0.45,1276.0,port_trm,451,9788,981768769,CREDIT,0,active,2027-10-19,2023-01-21 13:06:41,126.13,payment,350092.32
46174,5426540,134.0.98.0,790.0,atm,20,5532,981768769,CREDIT,0,active,2027-10-19,2023-02-10 12:23:05,125.92,decrease_on_acc,349966.4
46175,5620773,188.0.166.120,1307.0,ATM,10,7347,981768769,CREDIT,0,active,2027-10-19,2023-03-22 18:58:26,126.07,in_acc,350092.47
46176,5683889,193.31.0.210,607.0,cash_out,25,5590,981768769,CREDIT,0,active,2027-10-19,2023-04-04 09:45:38,126.13,diff_cntry,349966.34
46177,5942752,128.0.94.210,1113.0,cash_in,25,1759,981768769,CREDIT,0,active,2027-10-19,2023-05-09 18:38:45,125.9,country_transfer,349840.44
46178,6125906,185.173.0.45,1276.0,port_trm,451,3763,981768769,CREDIT,0,active,2027-10-19,2023-06-09 22:50:35,126.22,payment,349714.22
46179,6138434,188.0.189.45,834.0,ATM,451,2090,981768769,CREDIT,0,active,2027-10-19,2023-06-11 04:38:44,125.97,payment,349588.25
46180,6194930,188.244.0.30,1450.0,port_trm,30,7869,981768769,CREDIT,0,active,2027-10-19,2023-06-16 20:45:04,126.0,transfer,349462.25
46181,6297326,217.112.0.195,1488.0,atm,20,7347,981768769,CREDIT,0,active,2027-10-19,2023-06-25 11:32:07,125.77,decrease_on_acc,349336.48
46182,6375121,37.0.124.45,723.0,cash_in,-1,9054,981768769,CREDIT,1,active,2027-10-19,2023-09-09 08:51:23,126.07,bad,349336.48
46183,6384338,62.118.0.165,533.0,cash_out,20,5590,981768769,CREDIT,0,active,2027-10-19,2023-09-09 22:27:20,125.94,out,349210.54
46184,6399947,37.0.124.45,723.0,cash_in,-1,2076,981768769,CREDIT,1,active,2027-10-19,2023-10-30 06:50:22,126.02,err,349210.54
46185,6473194,188.0.189.45,834.0,ATM,25,2090,981768769,CREDIT,0,active,2027-10-19,2023-11-11 16:38:12,126.1,country_transfer,349084.44
46186,6569126,188.0.166.120,1307.0,ATM,20,4240,981768769,CREDIT,0,active,2027-10-19,2023-11-22 13:19:51,125.8,from_acc,348958.64
46187,6923369,188.244.0.105,1459.0,cash_in,10,2090,981768769,CREDIT,0,active,2027-10-19,2023-12-18 07:19:56,126.08,in_acc,349084.72
46188,7056566,45.154.0.120,304.0,ATM,451,3763,981768769,CREDIT,0,active,2027-10-19,2023-12-31 03:17:59,125.93,payment,348958.79
46189,7579333,185.173.0.45,1276.0,port_trm,451,7869,981768769,CREDIT,0,active,2027-10-19,2024-04-13 17:17:25,125.91,payment,348832.88
46190,7604963,193.31.0.210,607.0,cash_out,30,3821,981768769,CREDIT,0,active,2027-10-19,2024-04-25 01:50:03,125.77,transfer,348707.11
46191,7624432,37.0.124.210,735.0,cash_in,10,2076,981768769,CREDIT,0,active,2027-10-19,2024-06-08 02:47:32,125.91,in,348833.02
46192,7850164,188.0.189.45,834.0,ATM,30,4272,981768769,CREDIT,0,active,2027-10-19,2024-06-09 10:05:10,126.21,transfer,348706.81
46193,8061835,37.0.124.45,723.0,cash_in,451,2090,981768769,CREDIT,0,active,2027-10-19,2024-07-04 09:57:56,126.1,payment,348580.71
46194,8585228,185.173.0.45,1276.0,port_trm,25,5590,981768769,CREDIT,0,active,2027-10-19,2024-07-17 15:52:04,126.06,diff_cntry,348454.65
46195,8958820,37.0.124.45,723.0,cash_in,30,9752,981768769,CREDIT,0,active,2027-10-19,2024-07-19 07:35:39,126.12,transfer,348328.53
46196,9017830,88.210.0.90,348.0,atm,20,9752,981768769,CREDIT,0,active,2027-10-19,2024-07-23 08:54:08,125.96,decrease_on_acc,348202.57
46197,9075119,188.0.189.45,834.0,ATM,30,4240,981768769,CREDIT,0,active,2027-10-19,2024-07-28 23:31:33,125.79,transfer,348076.78
46198,9295528,217.112.0.60,1476.0,atm,10,9108,981768769,CREDIT,0,active,2027-10-19,2024-08-10 01:40:58,126.16,in,348202.94
46199,9413061,45.154.0.120,304.0,ATM,25,7869,981768769,CREDIT,0,active,2027-10-19,2024-08-27 05:28:52,125.91,diff_cntry,348077.03
46200,9450625,185.173.0.45,1276.0,port_trm,25,3763,981768769,CREDIT,0,active,2027-10-19,2024-09-19 04:40:11,126.06,country_transfer,347950.97
46201,9619328,46.0.176.165,129.0,ATM,10,9054,981768769,CREDIT,0,active,2027-10-19,2024-09-25 13:30:14,125.97,add_on_acc,348076.94
46202,9685148,193.31.0.75,592.0,prtbl trm,-1,5532,981768769,CREDIT,1,active,2027-10-19,2024-11-09 16:48:08,126.27,err_code,348076.94
46203,9801780,188.0.189.45,834.0,ATM,451,9054,981768769,CREDIT,0,active,2027-10-19,2024-11-18 14:58:31,126.06,payment,347950.88
46204,9816525,80.234.0.240,428.0,ATM,20,1759,981768769,CREDIT,0,active,2027-10-19,2024-11-28 00:33:51,126.04,decrease_on_acc,347824.84
46205,1050223,85.140.0.225,1270.0,cash_in,451,6362,512331465,CREDIT,0,act,2028-05-23,2022-02-08 13:37:30,906.99,payment,367705.01
46206,1134086,85.140.0.210,1267.0,cash_out,20,1992,512331465,CREDIT,0,act,2028-05-23,2022-02-16 15:45:36,906.93,from_acc,366798.08
46207,1171529,85.140.0.225,1270.0,cash_in,25,9307,512331465,CREDIT,0,act,2028-05-23,2022-03-20 15:26:05,906.82,country_transfer,365891.26
46208,1174376,46.0.188.240,1245.0,cash_in,25,9984,512331465,CREDIT,0,act,2028-05-23,2022-03-28 22:24:33,907.0,country_transfer,364984.26
46209,1592798,46.173.0.225,514.0,port_trm,-1,1744,512331465,CREDIT,1,act,2028-05-23,2022-03-31 07:48:33,906.69,err_code,364984.26
46210,1678545,128.0.24.90,889.0,ATM,20,3313,512331465,CREDIT,0,act,2028-05-23,2022-04-01 14:13:23,907.06,decrease_on_acc,364077.2
46211,1772730,46.0.9.225,1338.0,ATM,20,6168,512331465,CREDIT,0,act,2028-05-23,2022-04-03 05:45:46,907.03,from_acc,363170.17
46212,1891352,85.140.0.225,1270.0,cash_in,30,1988,512331465,CREDIT,0,act,2028-05-23,2022-04-10 19:44:07,906.88,transfer,362263.29
46213,2009201,46.0.188.240,1245.0,cash_in,30,1988,512331465,CREDIT,0,act,2028-05-23,2022-04-14 23:41:37,907.01,transfer,361356.28
46214,2111780,128.0.82.165,627.0,atm,10,3146,512331465,CREDIT,0,act,2028-05-23,2022-05-24 03:05:43,907.12,add_on_acc,362263.4
46215,2284580,46.173.0.225,514.0,port_trm,30,9747,512331465,CREDIT,0,act,2028-05-23,2022-05-24 11:06:01,907.1,transfer,361356.3
46216,2579192,31.134.0.90,1122.0,cash_in,10,9705,512331465,CREDIT,0,act,2028-05-23,2022-05-31 19:19:13,906.97,in_acc,362263.27
46217,2721459,188.43.0.210,1421.0,ATM,30,2048,512331465,CREDIT,0,act,2028-05-23,2022-07-05 23:52:50,906.85,transfer,361356.42
46218,2769035,37.0.124.165,732.0,ATM,20,1992,512331465,CREDIT,0,act,2028-05-23,2022-07-15 23:16:34,907.09,out,360449.33
46219,3403276,46.0.188.240,1245.0,cash_in,-1,8249,512331465,CREDIT,1,act,2028-05-23,2022-07-20 23:14:17,907.05,err_code,360449.33
46220,3509986,79.104.60.180,440.0,Portable term,451,8526,512331465,CREDIT,0,act,2028-05-23,2022-08-28 05:31:41,906.85,payment,359542.48
46221,3663988,77.242.0.0,268.0,cash_out,20,7219,512331465,CREDIT,0,act,2028-05-23,2022-09-28 20:24:22,907.1,from_acc,358635.38
46222,3910641,79.104.60.180,440.0,Portable term,25,8249,512331465,CREDIT,0,act,2028-05-23,2022-11-15 04:27:09,906.76,diff_cntry,357728.62
46223,3993551,46.173.0.225,514.0,port_trm,30,7452,512331465,CREDIT,0,act,2028-05-23,2022-12-28 06:22:12,906.8,transfer,356821.82
46224,4205984,188.0.0.90,1212.0,atm,10,8625,512331465,CREDIT,0,act,2028-05-23,2023-01-18 14:29:34,907.16,in_acc,357728.98
46225,4379164,85.140.0.225,1270.0,cash_in,451,7232,512331465,CREDIT,0,act,2028-05-23,2023-01-24 04:55:14,907.07,payment,356821.91
46226,4569166,46.173.0.225,514.0,port_trm,30,6168,512331465,CREDIT,0,act,2028-05-23,2023-02-27 11:01:33,906.78,transfer,355915.13
46227,4818812,46.173.0.225,514.0,port_trm,25,3038,512331465,CREDIT,0,act,2028-05-23,2023-03-03 08:38:49,906.98,country_transfer,355008.15
46228,4894590,85.140.0.225,1270.0,cash_in,451,5703,512331465,CREDIT,0,act,2028-05-23,2023-03-17 17:43:15,906.87,payment,354101.28
46229,4899051,46.173.0.225,514.0,port_trm,-1,3038,512331465,CREDIT,1,act,2028-05-23,2023-03-27 17:02:04,907.1,err,354101.28
46230,5216010,151.0.38.90,394.0,ATM,20,1988,512331465,CREDIT,0,act,2028-05-23,2023-04-11 20:09:42,906.98,out,353194.3
46231,5258412,46.0.188.240,1245.0,cash_in,451,8526,512331465,CREDIT,0,act,2028-05-23,2023-04-15 08:48:01,906.94,payment,352287.36
46232,5386738,188.43.0.210,1421.0,ATM,451,8249,512331465,CREDIT,0,act,2028-05-23,2023-06-08 16:51:08,907.02,payment,351380.34
46233,5400502,134.0.98.180,804.0,atm,10,1744,512331465,CREDIT,0,act,2028-05-23,2023-06-13 07:09:05,906.95,add_on_acc,352287.29
46234,5771527,85.140.0.225,1270.0,cash_in,451,5703,512331465,CREDIT,0,act,2028-05-23,2023-07-10 05:49:02,907.08,payment,351380.21
46235,5923763,188.43.0.210,1421.0,ATM,-1,6168,512331465,CREDIT,1,act,2028-05-23,2023-08-09 04:44:24,906.95,err,351380.21
46236,6142609,188.0.166.90,1305.0,cash_out,20,1992,512331465,CREDIT,0,act,2028-05-23,2023-08-18 03:04:28,906.91,decrease_on_acc,350473.3
46237,6307603,79.104.60.180,440.0,Portable term,451,9747,512331465,CREDIT,0,act,2028-05-23,2023-09-18 10:36:47,907.01,payment,349566.29
46238,6458319,85.140.0.225,1270.0,cash_in,25,1744,512331465,CREDIT,0,act,2028-05-23,2023-09-19 02:31:39,907.1,country_transfer,348659.19
46239,6534315,188.43.0.210,1421.0,ATM,30,6362,512331465,CREDIT,0,act,2028-05-23,2023-11-22 08:10:02,907.09,transfer,347752.1
46240,6652149,46.0.188.240,1245.0,cash_in,451,5703,512331465,CREDIT,0,act,2028-05-23,2023-12-07 21:32:00,907.1,payment,346845.0
46241,6806130,46.173.0.225,514.0,port_trm,30,7232,512331465,CREDIT,0,act,2028-05-23,2023-12-23 11:19:59,907.23,transfer,345937.77
46242,6892508,188.43.0.210,1421.0,ATM,-1,6362,512331465,CREDIT,1,act,2028-05-23,2023-12-23 16:22:15,907.01,bad,345937.77
46243,6903869,188.43.0.210,1421.0,ATM,30,5703,512331465,CREDIT,0,act,2028-05-23,2023-12-26 22:33:47,906.62,transfer,345031.15
46244,6983441,46.0.188.240,1245.0,cash_in,-1,9705,512331465,CREDIT,1,act,2028-05-23,2024-01-16 04:40:53,906.86,err,345031.15
46245,7441100,195.161.0.135,1173.0,cash_in,10,3819,512331465,CREDIT,0,act,2028-05-23,2024-02-23 04:21:27,906.99,add_on_acc,345938.14
46246,7554682,85.140.0.225,1270.0,cash_in,25,2073,512331465,CREDIT,0,act,2028-05-23,2024-02-27 13:53:50,907.29,country_transfer,345030.85
46247,7829933,79.104.60.180,440.0,Portable term,-1,3819,512331465,CREDIT,1,act,2028-05-23,2024-03-15 23:46:30,906.85,bad,345030.85
46248,8167711,85.140.0.225,1270.0,cash_in,30,9705,512331465,CREDIT,0,act,2028-05-23,2024-03-20 08:48:55,906.99,transfer,344123.86
46249,8273867,79.104.60.180,440.0,Portable term,-1,1992,512331465,CREDIT,1,act,2028-05-23,2024-04-11 09:26:52,907.13,err_code,344123.86
46250,8579790,79.104.60.180,440.0,Portable term,451,2273,512331465,CREDIT,0,act,2028-05-23,2024-04-15 13:41:22,906.62,payment,343217.24
46251,8801804,79.104.60.180,440.0,Portable term,451,8249,512331465,CREDIT,0,act,2028-05-23,2024-05-22 12:06:25,907.1,payment,342310.14
46252,9043745,85.140.0.225,1270.0,cash_in,-1,8625,512331465,CREDIT,1,act,2028-05-23,2024-06-04 08:11:16,907.3,bad,342310.14
46253,9065670,95.181.0.75,253.0,cash_out,20,4063,512331465,CREDIT,0,act,2028-05-23,2024-06-29 09:22:53,906.69,from_acc,341403.45
46254,9289696,78.24.158.114,940.0,cash_in,10,2159,512331465,CREDIT,0,act,2028-05-23,2024-07-23 14:48:19,907.06,in_acc,342310.51
46255,9405227,85.140.0.225,1270.0,cash_in,451,1992,512331465,CREDIT,0,act,2028-05-23,2024-07-28 09:17:17,906.81,payment,341403.7
46256,9411271,188.43.0.210,1421.0,ATM,30,5920,512331465,CREDIT,0,act,2028-05-23,2024-08-02 07:14:25,907.15,transfer,340496.55
46257,9659722,151.0.38.180,403.0,atm,20,3146,512331465,CREDIT,0,act,2028-05-23,2024-10-07 17:00:59,907.14,out,339589.41
46258,9705271,193.31.0.180,603.0,ATM,10,7219,512331465,CREDIT,0,act,2028-05-23,2024-10-26 10:55:20,906.82,in,340496.23
46259,9825839,46.0.54.90,1076.0,cash_in,10,7219,512331465,CREDIT,0,act,2028-05-23,2024-11-10 11:30:58,907.04,in,341403.27
46260,9973912,46.0.188.240,1245.0,cash_in,25,5920,512331465,CREDIT,0,act,2028-05-23,2024-11-23 02:51:06,906.97,diff_cntry,340496.3
46261,9978658,46.0.0.195,669.0,cash_out,20,2073,512331465,CREDIT,0,act,2028-05-23,2024-11-23 04:58:46,906.99,decrease_on_acc,339589.31
46262,1354719,37.0.127.30,1023.0,cash_out,25,3153,220432344,DEBIT,0,act,2029-03-29,2022-01-15 20:58:20,490.13,country_transfer,286080.87
46263,1721308,212.20.0.0,445.0,ATM,451,9591,220432344,DEBIT,0,act,2029-03-29,2022-01-19 12:50:04,489.72,payment,285591.15
46264,1843665,188.0.0.180,1218.0,port_trm,30,9985,220432344,DEBIT,0,act,2029-03-29,2022-01-22 06:31:27,490.01,transfer,285101.14
46265,2072633,217.26.0.45,677.0,ATM,20,7429,220432344,DEBIT,0,act,2029-03-29,2022-02-14 22:40:04,490.26,decrease_on_acc,284610.88
46266,2460476,5.189.0.165,869.0,cash_out,-1,2236,220432344,DEBIT,1,act,2029-03-29,2022-03-12 14:31:13,490.12,bad,284610.88
46267,2465662,188.0.169.165,480.0,atm,20,9799,220432344,DEBIT,0,act,2029-03-29,2022-03-17 07:56:21,489.95,from_acc,284120.93
46268,2606500,188.0.0.180,1218.0,port_trm,451,6529,220432344,DEBIT,0,act,2029-03-29,2022-04-27 05:23:43,489.98,payment,283630.95
46269,2631373,46.0.54.15,1069.0,cash_in,10,5607,220432344,DEBIT,0,act,2029-03-29,2022-06-05 09:37:52,489.77,add_on_acc,284120.72
46270,2761195,5.189.0.150,867.0,ATM,10,7429,220432344,DEBIT,0,act,2029-03-29,2022-06-09 00:28:46,490.04,add_on_acc,284610.76
46271,2814825,212.20.0.0,445.0,ATM,-1,3879,220432344,DEBIT,1,act,2029-03-29,2022-08-25 02:15:21,490.14,err,284610.76
46272,3224467,188.0.0.180,1218.0,port_trm,-1,2678,220432344,DEBIT,2,act,2029-03-29,2022-08-25 14:26:29,490.28,bad,284610.76
46273,3253801,193.0.151.180,68.0,atm,451,3845,220432344,DEBIT,0,act,2029-03-29,2022-08-29 00:08:07,489.96,payment,284120.8
46274,3422349,5.189.0.165,869.0,cash_out,25,6418,220432344,DEBIT,0,act,2029-03-29,2022-09-11 01:05:25,490.0,diff_cntry,283630.8
46275,3488495,46.173.0.105,502.0,atm,20,5089,220432344,DEBIT,0,act,2029-03-29,2022-09-19 00:07:46,489.97,decrease_on_acc,283140.83
46276,3615906,212.20.0.0,445.0,ATM,-1,5417,220432344,DEBIT,1,act,2029-03-29,2022-09-21 04:50:59,489.89,bad,283140.83
46277,4585926,188.162.0.0,952.0,atm,25,4894,220432344,DEBIT,0,act,2029-03-29,2022-09-28 16:07:15,489.95,diff_cntry,282650.88
46278,4678423,193.0.151.135,63.0,pos trm,30,9591,220432344,DEBIT,0,act,2029-03-29,2022-10-05 07:19:40,490.22,transfer,282160.66
46279,4760354,188.244.0.135,1461.0,atm,10,3436,220432344,DEBIT,0,act,2029-03-29,2022-10-21 14:49:06,489.88,in_acc,282650.54
46280,4849543,128.0.82.180,628.0,atm,10,4286,220432344,DEBIT,0,act,2029-03-29,2022-11-08 14:41:54,490.09,in,283140.63
46281,5015909,128.0.94.135,1108.0,cash_in,10,2678,220432344,DEBIT,0,act,2029-03-29,2022-11-25 18:54:36,489.89,in_acc,283630.52
46282,5110338,188.162.0.0,952.0,atm,30,5088,220432344,DEBIT,0,act,2029-03-29,2022-12-06 12:23:07,489.91,transfer,283140.61
46283,5144386,212.20.0.0,445.0,ATM,451,8809,220432344,DEBIT,0,act,2029-03-29,2023-01-09 13:39:59,489.88,payment,282650.73
46284,5264798,212.20.0.0,445.0,ATM,451,1280,220432344,DEBIT,0,act,2029-03-29,2023-01-24 04:17:29,489.79,payment,282160.94
46285,5284759,46.0.54.45,1072.0,atm,20,5749,220432344,DEBIT,0,act,2029-03-29,2023-01-24 12:55:04,490.25,from_acc,281670.69
46286,5297816,212.20.0.0,445.0,ATM,451,4286,220432344,DEBIT,0,act,2029-03-29,2023-01-26 10:17:14,490.19,payment,281180.5
46287,5333555,188.162.0.0,952.0,atm,30,9971,220432344,DEBIT,0,act,2029-03-29,2023-03-02 01:40:08,489.86,transfer,280690.64
46288,5708748,193.0.151.120,60.0,prtbl trm,30,3845,220432344,DEBIT,0,act,2029-03-29,2023-04-06 17:11:30,489.85,transfer,280200.79
46289,5765859,37.0.127.30,1023.0,cash_out,451,5749,220432344,DEBIT,0,act,2029-03-29,2023-05-07 12:19:05,489.86,payment,279710.93
46290,5821868,185.17.0.105,1053.0,cash_in,10,7429,220432344,DEBIT,0,act,2029-03-29,2023-05-13 04:59:08,490.12,in_acc,280201.05
46291,5832438,37.0.127.30,1023.0,cash_out,25,2124,220432344,DEBIT,0,act,2029-03-29,2023-07-21 09:44:05,489.88,diff_cntry,279711.17
46292,5859746,193.0.151.135,63.0,pos trm,451,3716,220432344,DEBIT,0,act,2029-03-29,2023-07-31 01:32:00,489.75,payment,279221.42
46293,5887649,188.162.0.0,952.0,atm,30,3845,220432344,DEBIT,0,act,2029-03-29,2023-09-20 21:39:17,490.11,transfer,278731.31
46294,5890251,78.24.158.99,939.0,atm,10,5089,220432344,DEBIT,0,act,2029-03-29,2023-10-12 12:13:13,489.73,add_on_acc,279221.04
46295,6024624,188.162.0.0,952.0,atm,30,3153,220432344,DEBIT,0,act,2029-03-29,2023-10-18 11:32:03,490.16,transfer,278730.88
46296,6163379,188.0.0.180,1218.0,port_trm,30,6529,220432344,DEBIT,0,act,2029-03-29,2023-11-17 12:09:40,489.94,transfer,278240.94
46297,6163439,188.162.0.0,952.0,atm,25,3436,220432344,DEBIT,0,act,2029-03-29,2023-11-23 12:30:24,490.06,country_transfer,277750.88
46298,6303925,37.0.127.30,1023.0,cash_out,30,6760,220432344,DEBIT,0,act,2029-03-29,2024-01-03 04:01:43,489.75,transfer,277261.13
46299,6576769,193.0.151.135,63.0,pos trm,-1,9985,220432344,DEBIT,1,act,2029-03-29,2024-01-04 05:39:09,490.07,err,277261.13
46300,6808838,212.20.0.0,445.0,ATM,25,9985,220432344,DEBIT,0,act,2029-03-29,2024-01-21 18:01:17,489.87,diff_cntry,276771.26
46301,6866361,195.161.0.210,1179.0,atm,25,9591,220432344,DEBIT,0,act,2029-03-29,2024-03-23 06:18:02,490.17,country_transfer,276281.09
46302,6927577,193.0.151.180,68.0,atm,451,3716,220432344,DEBIT,0,act,2029-03-29,2024-03-31 02:48:49,490.19,payment,275790.9
46303,6929407,193.0.151.180,68.0,atm,451,5417,220432344,DEBIT,0,act,2029-03-29,2024-04-03 10:00:53,489.93,payment,275300.97
46304,6993085,195.161.0.210,1179.0,atm,451,7429,220432344,DEBIT,0,act,2029-03-29,2024-04-05 12:36:23,490.14,payment,274810.83
46305,7156031,193.0.151.120,60.0,prtbl trm,451,7732,220432344,DEBIT,0,act,2029-03-29,2024-04-12 18:18:29,489.99,payment,274320.84
46306,7207667,188.0.0.180,1218.0,port_trm,25,3845,220432344,DEBIT,0,act,2029-03-29,2024-04-17 16:41:04,489.97,country_transfer,273830.87
46307,7463069,5.189.0.165,869.0,cash_out,30,9799,220432344,DEBIT,0,act,2029-03-29,2024-07-04 21:15:57,490.17,transfer,273340.7
46308,7511668,193.0.151.120,60.0,prtbl trm,-1,3845,220432344,DEBIT,1,act,2029-03-29,2024-07-29 19:00:22,490.07,err_code,273340.7
46309,7617090,37.0.127.30,1023.0,cash_out,30,5607,220432344,DEBIT,0,act,2029-03-29,2024-08-09 11:03:12,489.88,transfer,272850.82
46310,7798787,188.162.0.0,952.0,atm,10,3879,220432344,DEBIT,0,act,2029-03-29,2024-08-31 20:35:39,489.78,in,273340.6
46311,7972807,94.243.0.135,108.0,cash_out,20,3845,220432344,DEBIT,0,act,2029-03-29,2024-09-08 20:17:51,489.99,from_acc,272850.61
46312,8339295,188.162.0.0,952.0,atm,-1,3436,220432344,DEBIT,1,act,2029-03-29,2024-09-19 02:39:09,490.21,err_code,272850.61
46313,8358946,5.189.0.165,869.0,cash_out,30,3879,220432344,DEBIT,0,act,2029-03-29,2024-09-24 17:05:55,489.93,transfer,272360.68
46314,8512548,193.0.151.120,60.0,prtbl trm,30,9985,220432344,DEBIT,0,act,2029-03-29,2024-10-16 14:17:26,490.08,transfer,271870.6
46315,9068404,193.0.151.180,68.0,atm,30,5818,220432344,DEBIT,0,act,2029-03-29,2024-11-02 05:46:39,490.06,transfer,271380.54
46316,9230383,188.0.0.180,1218.0,port_trm,30,8041,220432344,DEBIT,0,act,2029-03-29,2024-11-07 21:39:58,489.96,transfer,270890.58
46317,9235124,31.134.0.0,1116.0,atm,10,2124,220432344,DEBIT,0,act,2029-03-29,2024-11-22 10:00:44,490.21,in,271380.79
46318,1108216,134.0.98.180,804.0,atm,10,7903,682986333,DEBIT,0,act,2025-05-19,2022-01-02 22:35:45,1084.12,in_acc,952784.12
46319,1155857,195.58.0.0,1424.0,port_trm,451,2651,682986333,DEBIT,0,act,2025-05-19,2022-01-12 09:01:37,1084.05,payment,951700.07
46320,1394039,86.111.0.165,1355.0,prtbl trm,451,7166,682986333,DEBIT,0,act,2025-05-19,2022-01-18 09:17:46,1084.26,payment,950615.81
46321,1486499,86.111.0.165,1355.0,prtbl trm,451,3090,682986333,DEBIT,0,act,2025-05-19,2022-02-11 02:30:58,1083.81,payment,949532.0
46322,1572740,185.173.0.15,1273.0,ATM,451,6428,682986333,DEBIT,0,act,2025-05-19,2022-02-12 03:57:42,1083.9,payment,948448.1
46323,1715968,46.0.176.210,132.0,cash_out,30,6123,682986333,DEBIT,0,act,2025-05-19,2022-02-19 22:12:43,1083.93,transfer,947364.17
46324,1731324,46.0.8.0,137.0,cash_out,451,2010,682986333,DEBIT,0,act,2025-05-19,2022-03-07 00:16:53,1084.03,payment,946280.14
46325,1838089,46.0.8.0,137.0,cash_out,30,5518,682986333,DEBIT,0,act,2025-05-19,2022-03-13 09:30:57,1084.08,transfer,945196.06
46326,1949492,86.111.0.165,1355.0,prtbl trm,451,5763,682986333,DEBIT,0,act,2025-05-19,2022-04-02 17:17:38,1083.78,payment,944112.28
46327,2270380,128.0.82.15,611.0,ATM,20,1671,682986333,DEBIT,0,act,2025-05-19,2022-04-12 21:43:40,1083.91,decrease_on_acc,943028.37
46328,2405743,46.0.176.210,132.0,cash_out,451,5682,682986333,DEBIT,0,act,2025-05-19,2022-06-17 04:11:47,1083.99,payment,941944.38
46329,2488147,195.58.0.0,1424.0,port_trm,25,2398,682986333,DEBIT,0,act,2025-05-19,2022-06-21 14:43:34,1083.88,diff_cntry,940860.5
46330,2582302,46.8.0.165,780.0,ATM,20,4308,682986333,DEBIT,0,act,2025-05-19,2022-07-19 11:03:31,1084.0,decrease_on_acc,939776.5
46331,2765061,95.167.0.45,203.0,atm,20,4625,682986333,DEBIT,0,act,2025-05-19,2022-09-30 11:31:49,1084.06,from_acc,938692.44
46332,2956105,46.0.8.0,137.0,cash_out,30,9695,682986333,DEBIT,0,act,2025-05-19,2022-10-17 00:29:12,1084.18,transfer,937608.26
46333,3548920,86.111.0.165,1355.0,prtbl trm,-1,9695,682986333,DEBIT,1,act,2025-05-19,2022-11-11 00:51:38,1083.75,err_code,937608.26
46334,3578406,37.0.123.120,329.0,cash_in,10,6825,682986333,DEBIT,0,act,2025-05-19,2022-11-24 11:42:16,1084.11,add_on_acc,938692.37
46335,4024788,46.0.8.0,137.0,cash_out,-1,6825,682986333,DEBIT,1,act,2025-05-19,2022-11-30 03:35:15,1083.88,bad,938692.37
46336,4073857,194.0.162.135,749.0,port_trm,451,6428,682986333,DEBIT,0,act,2025-05-19,2022-12-05 11:35:59,1084.0,payment,937608.37
46337,4176108,194.0.162.135,749.0,port_trm,451,6825,682986333,DEBIT,0,act,2025-05-19,2022-12-26 23:04:20,1083.97,payment,936524.4
46338,4906836,185.173.0.15,1273.0,ATM,451,6123,682986333,DEBIT,0,act,2025-05-19,2023-01-22 21:13:59,1084.17,payment,935440.23
46339,4922465,46.0.176.210,132.0,cash_out,25,8332,682986333,DEBIT,0,act,2025-05-19,2023-01-31 12:57:41,1084.02,diff_cntry,934356.21
46340,5082914,193.0.151.15,51.0,ATM,20,4308,682986333,DEBIT,0,act,2025-05-19,2023-02-03 02:10:11,1084.12,out,933272.09
46341,5095634,185.173.0.45,1276.0,port_trm,451,5908,682986333,DEBIT,0,act,2025-05-19,2023-04-03 03:26:27,1083.82,payment,932188.27
46342,5122650,185.173.0.15,1273.0,ATM,451,5682,682986333,DEBIT,0,act,2025-05-19,2023-04-18 03:07:42,1083.9,payment,931104.37
46343,5299132,185.173.0.15,1273.0,ATM,451,9695,682986333,DEBIT,0,act,2025-05-19,2023-05-18 14:10:36,1084.11,payment,930020.26
46344,5324343,185.173.0.45,1276.0,port_trm,25,7166,682986333,DEBIT,0,act,2025-05-19,2023-05-23 10:01:51,1084.13,diff_cntry,928936.13
46345,5427556,195.58.0.0,1424.0,port_trm,25,4308,682986333,DEBIT,0,act,2025-05-19,2023-06-20 11:31:07,1084.12,diff_cntry,927852.01
46346,5502728,46.0.176.210,132.0,cash_out,451,7903,682986333,DEBIT,0,act,2025-05-19,2023-07-04 07:08:04,1084.22,payment,926767.79
46347,5713039,185.173.0.15,1273.0,ATM,30,7903,682986333,DEBIT,0,act,2025-05-19,2023-08-06 06:19:20,1084.11,transfer,925683.68
46348,5758293,195.58.0.0,1424.0,port_trm,25,1210,682986333,DEBIT,0,act,2025-05-19,2023-09-08 05:36:21,1084.16,country_transfer,924599.52
46349,6034443,86.111.0.165,1355.0,prtbl trm,30,1671,682986333,DEBIT,0,act,2025-05-19,2023-09-13 05:14:56,1084.09,transfer,923515.43
46350,6067358,31.134.0.45,1119.0,atm,10,9695,682986333,DEBIT,0,act,2025-05-19,2023-10-06 13:38:46,1084.12,in,924599.55
46351,6173189,37.0.123.15,319.0,atm,20,4308,682986333,DEBIT,0,act,2025-05-19,2023-10-24 14:42:25,1084.04,decrease_on_acc,923515.51
46352,6413734,46.0.0.135,664.0,cash_out,20,4308,682986333,DEBIT,0,act,2025-05-19,2023-10-31 13:12:46,1083.91,out,922431.6
46353,6442222,185.173.0.45,1276.0,port_trm,-1,5745,682986333,DEBIT,1,act,2025-05-19,2023-11-23 00:14:03,1084.13,err,922431.6
46354,6544242,195.58.0.0,1424.0,port_trm,25,2651,682986333,DEBIT,0,act,2025-05-19,2024-01-15 19:54:39,1084.06,diff_cntry,921347.54
46355,6873411,46.0.176.210,132.0,cash_out,25,2398,682986333,DEBIT,0,act,2025-05-19,2024-01-18 01:05:10,1083.9,country_transfer,920263.64
46356,7018122,86.111.0.165,1355.0,prtbl trm,30,1210,682986333,DEBIT,0,act,2025-05-19,2024-01-22 18:45:37,1084.16,transfer,919179.48
46357,7859141,46.0.176.210,132.0,cash_out,451,3715,682986333,DEBIT,0,act,2025-05-19,2024-02-15 03:51:59,1083.88,payment,918095.6
46358,7999340,86.111.0.165,1355.0,prtbl trm,30,1671,682986333,DEBIT,0,act,2025-05-19,2024-02-28 06:06:20,1084.1,transfer,917011.5
46359,8008304,194.0.162.225,759.0,atm,20,7193,682986333,DEBIT,0,act,2025-05-19,2024-03-19 06:27:49,1083.96,from_acc,915927.54
46360,8065540,185.173.0.45,1276.0,port_trm,25,2651,682986333,DEBIT,0,act,2025-05-19,2024-03-27 00:42:22,1083.99,country_transfer,914843.55
46361,8131800,86.111.0.165,1355.0,prtbl trm,25,5518,682986333,DEBIT,0,act,2025-05-19,2024-04-25 01:06:58,1083.98,diff_cntry,913759.57
46362,8305213,194.0.162.135,749.0,port_trm,30,5682,682986333,DEBIT,0,act,2025-05-19,2024-05-18 12:13:10,1083.95,transfer,912675.62
46363,8501229,46.0.143.105,819.0,cash_out,20,9695,682986333,DEBIT,0,act,2025-05-19,2024-06-07 23:30:13,1083.82,decrease_on_acc,911591.8
46364,8719065,185.173.0.45,1276.0,port_trm,30,8332,682986333,DEBIT,0,act,2025-05-19,2024-06-10 17:26:34,1083.93,transfer,910507.87
46365,8896056,185.173.0.45,1276.0,port_trm,30,6825,682986333,DEBIT,0,act,2025-05-19,2024-06-26 20:12:13,1084.24,transfer,909423.63
46366,8952166,46.0.8.0,137.0,cash_out,451,2398,682986333,DEBIT,0,act,2025-05-19,2024-07-09 15:43:54,1083.87,payment,908339.76
46367,9008062,195.58.0.0,1424.0,port_trm,451,4625,682986333,DEBIT,0,act,2025-05-19,2024-07-10 11:39:27,1084.14,payment,907255.62
46368,9115093,46.0.8.0,137.0,cash_out,30,3715,682986333,DEBIT,0,act,2025-05-19,2024-07-22 09:23:53,1084.03,transfer,906171.59
46369,9380208,195.58.0.0,1424.0,port_trm,-1,8332,682986333,DEBIT,1,act,2025-05-19,2024-09-08 21:20:26,1083.81,err,906171.59
46370,9796978,194.0.162.135,749.0,port_trm,25,6825,682986333,DEBIT,0,act,2025-05-19,2024-09-18 10:50:02,1083.96,country_transfer,905087.63
46371,9898624,46.0.8.0,137.0,cash_out,25,1671,682986333,DEBIT,0,act,2025-05-19,2024-09-22 17:07:04,1083.99,diff_cntry,904003.64
46372,1245749,78.24.158.24,931.0,ATM,451,3897,538406799,DEBIT,0,active,2030-02-12,2022-02-09 01:12:28,394.15,payment,316159.85
46373,1309819,78.24.158.24,931.0,ATM,25,7723,538406799,DEBIT,0,active,2030-02-12,2022-03-14 17:55:37,394.19,country_transfer,315765.66
46374,1497705,188.18.0.90,227.0,port_trm,30,8404,538406799,DEBIT,0,active,2030-02-12,2022-03-16 15:55:54,394.08,transfer,315371.58
46375,1633794,188.43.0.180,1418.0,pos trm,451,7476,538406799,DEBIT,0,active,2030-02-12,2022-04-04 18:06:06,393.96,payment,314977.62
46376,1637489,37.0.124.45,723.0,cash_in,451,5932,538406799,DEBIT,0,active,2030-02-12,2022-05-16 13:13:46,393.79,payment,314583.83
46377,1674312,37.0.124.45,723.0,cash_in,30,7723,538406799,DEBIT,0,active,2030-02-12,2022-05-17 08:38:04,394.0,transfer,314189.83
46378,2205874,45.154.0.240,317.0,port_trm,451,5350,538406799,DEBIT,0,active,2030-02-12,2022-05-18 05:35:52,394.05,payment,313795.78
46379,2243778,91.107.0.0,974.0,pos trm,451,7677,538406799,DEBIT,0,active,2030-02-12,2022-05-22 10:49:30,394.16,payment,313401.62
46380,2372043,194.156.0.195,37.0,pos trm,451,7476,538406799,DEBIT,0,active,2030-02-12,2022-06-12 10:23:02,394.04,payment,313007.58
46381,2489877,37.0.127.75,1027.0,ATM,20,2848,538406799,DEBIT,0,active,2030-02-12,2022-06-19 00:16:31,393.82,decrease_on_acc,312613.76
46382,2577398,194.87.0.195,580.0,ATM,10,4173,538406799,DEBIT,0,active,2030-02-12,2022-06-22 22:48:54,393.91,in_acc,313007.67
46383,3145853,188.0.166.15,1297.0,ATM,20,4991,538406799,DEBIT,0,active,2030-02-12,2022-07-01 17:21:58,393.9,from_acc,312613.77
46384,3339026,188.43.0.210,1421.0,ATM,10,7476,538406799,DEBIT,0,active,2030-02-12,2022-07-17 21:01:59,393.81,in,313007.58
46385,3473447,46.0.123.0,909.0,cash_out,20,7044,538406799,DEBIT,0,active,2030-02-12,2022-07-20 18:08:39,393.97,from_acc,312613.61
46386,3666492,78.24.158.24,931.0,ATM,30,4991,538406799,DEBIT,0,active,2030-02-12,2022-08-19 22:06:06,394.05,transfer,312219.56
46387,3911824,95.106.0.90,550.0,atm,10,6521,538406799,DEBIT,0,active,2030-02-12,2022-10-12 18:20:53,393.89,add_on_acc,312613.45
46388,3916497,45.154.0.240,317.0,port_trm,25,7723,538406799,DEBIT,0,active,2030-02-12,2022-10-22 14:36:25,393.81,country_transfer,312219.64
46389,4093159,194.156.0.195,37.0,pos trm,30,1080,538406799,DEBIT,0,active,2030-02-12,2022-10-29 10:13:27,394.09,transfer,311825.55
46390,4556067,128.0.24.30,882.0,atm,20,1254,538406799,DEBIT,0,active,2030-02-12,2022-10-29 21:19:35,393.95,decrease_on_acc,311431.6
46391,4564721,37.0.124.45,723.0,cash_in,451,1328,538406799,DEBIT,0,active,2030-02-12,2022-11-20 23:27:35,393.96,payment,311037.64
46392,4667824,194.156.0.0,21.0,ATM,10,1080,538406799,DEBIT,0,active,2030-02-12,2023-01-10 19:47:50,393.96,in,311431.6
46393,4816983,188.18.0.90,227.0,port_trm,30,5350,538406799,DEBIT,0,active,2030-02-12,2023-01-22 13:46:39,394.22,transfer,311037.38
46394,5582117,91.107.0.0,974.0,pos trm,451,5350,538406799,DEBIT,0,active,2030-02-12,2023-02-14 02:32:12,394.19,payment,310643.19
46395,5654705,91.107.0.0,974.0,pos trm,-1,2848,538406799,DEBIT,1,active,2030-02-12,2023-02-18 03:53:19,393.8,err,310643.19
46396,5813270,46.0.8.165,149.0,cash_out,20,5932,538406799,DEBIT,0,active,2030-02-12,2023-03-04 18:39:03,394.15,decrease_on_acc,310249.04
46397,6045138,188.18.0.90,227.0,port_trm,451,5350,538406799,DEBIT,0,active,2030-02-12,2023-03-31 22:59:49,394.0,payment,309855.04
46398,6477572,81.17.0.210,1401.0,cash_in,10,1254,538406799,DEBIT,0,active,2030-02-12,2023-05-30 16:48:20,393.94,in,310248.98
46399,6596076,78.24.158.24,931.0,ATM,-1,7677,538406799,DEBIT,1,active,2030-02-12,2023-06-17 00:30:09,393.81,bad,310248.98
46400,6745206,37.0.124.45,723.0,cash_in,30,4173,538406799,DEBIT,0,active,2030-02-12,2023-06-25 15:35:48,394.01,transfer,309854.97
46401,7128633,194.156.0.195,37.0,pos trm,451,7723,538406799,DEBIT,0,active,2030-02-12,2023-07-21 08:16:22,394.13,payment,309460.84
46402,7350067,85.140.0.210,1267.0,cash_out,20,7476,538406799,DEBIT,0,active,2030-02-12,2023-07-23 16:22:27,393.91,from_acc,309066.93
46403,7392684,188.43.0.180,1418.0,pos trm,451,5298,538406799,DEBIT,0,active,2030-02-12,2023-07-27 03:14:52,394.22,payment,308672.71
46404,7442902,194.156.0.195,37.0,pos trm,25,7723,538406799,DEBIT,0,active,2030-02-12,2023-09-02 09:53:41,394.12,country_transfer,308278.59
46405,7572186,78.24.158.24,931.0,ATM,30,2848,538406799,DEBIT,0,active,2030-02-12,2023-09-19 10:21:32,393.96,transfer,307884.63
46406,7714467,46.8.0.210,783.0,atm,10,1254,538406799,DEBIT,0,active,2030-02-12,2023-11-05 21:26:31,394.02,in_acc,308278.65
46407,7775309,194.156.0.195,37.0,pos trm,451,5932,538406799,DEBIT,0,active,2030-02-12,2023-11-22 11:10:02,393.84,payment,307884.81
46408,7990194,194.87.0.15,567.0,cash_in,10,4173,538406799,DEBIT,0,active,2030-02-12,2023-12-19 05:45:23,393.78,add_on_acc,308278.59
46409,8007981,62.118.0.75,525.0,ATM,20,8830,538406799,DEBIT,0,active,2030-02-12,2024-01-01 14:19:40,393.99,from_acc,307884.6
46410,8049585,188.43.0.180,1418.0,pos trm,-1,5350,538406799,DEBIT,1,active,2030-02-12,2024-01-30 07:56:40,393.83,err_code,307884.6
46411,8256174,217.26.0.195,694.0,cash_out,20,7677,538406799,DEBIT,0,active,2030-02-12,2024-02-17 03:06:59,393.84,decrease_on_acc,307490.76
46412,8379345,188.244.0.195,1467.0,atm,20,8475,538406799,DEBIT,0,active,2030-02-12,2024-03-13 10:32:44,393.96,out,307096.8
46413,8447479,185.173.0.60,1277.0,cash_out,20,5932,538406799,DEBIT,0,active,2030-02-12,2024-05-12 11:51:49,393.78,out,306703.02
46414,8684695,134.0.98.45,794.0,cash_out,20,4991,538406799,DEBIT,0,active,2030-02-12,2024-05-24 00:39:09,393.89,out,306309.13
46415,8717421,78.24.158.24,931.0,ATM,451,2848,538406799,DEBIT,0,active,2030-02-12,2024-06-05 20:14:52,394.11,payment,305915.02
46416,9165639,45.154.0.240,317.0,port_trm,451,8404,538406799,DEBIT,0,active,2030-02-12,2024-06-15 02:17:00,393.89,payment,305521.13
46417,9230574,31.134.0.195,1132.0,atm,10,1328,538406799,DEBIT,0,active,2030-02-12,2024-07-03 16:33:53,393.85,in_acc,305914.98
46418,9241001,78.24.158.24,931.0,ATM,30,3843,538406799,DEBIT,0,active,2030-02-12,2024-07-18 09:15:36,394.14,transfer,305520.84
46419,9543552,194.156.0.195,37.0,pos trm,30,5350,538406799,DEBIT,0,active,2030-02-12,2024-08-16 08:53:04,393.92,transfer,305126.92
46420,9586228,78.24.158.24,931.0,ATM,30,1328,538406799,DEBIT,0,active,2030-02-12,2024-09-04 07:43:11,393.72,transfer,304733.2
46421,9723891,78.24.158.24,931.0,ATM,451,8830,538406799,DEBIT,0,active,2030-02-12,2024-10-05 11:40:21,394.2,payment,304339.0
46422,9882947,37.0.124.45,723.0,cash_in,-1,4173,538406799,DEBIT,1,active,2030-02-12,2024-11-15 03:27:28,393.9,err_code,304339.0
46423,9989002,195.143.0.195,1380.0,atm,20,7476,538406799,DEBIT,0,active,2030-02-12,2024-11-16 14:57:18,394.02,out,303944.98
46424,1283092,194.87.0.195,580.0,ATM,451,4314,964163162,CREDIT,0,act,2030-10-02,2022-02-26 22:23:16,304.2,payment,569002.8
46425,1622876,185.233.0.60,81.0,ATM,451,1913,964163162,CREDIT,0,act,2030-10-02,2022-02-27 08:33:15,304.17,payment,568698.63
46426,1634768,46.0.188.210,1243.0,cash_out,30,4876,964163162,CREDIT,0,act,2030-10-02,2022-03-03 10:57:05,304.04,transfer,568394.59
46427,2429288,45.154.0.105,303.0,ATM,20,4525,964163162,CREDIT,0,act,2030-10-02,2022-03-22 21:03:29,303.73,out,568090.86
46428,2685670,62.118.0.210,537.0,ATM,10,7459,964163162,CREDIT,0,act,2030-10-02,2022-04-08 14:04:43,304.07,add_on_acc,568394.93
46429,2924762,95.181.0.210,263.0,pos trm,451,8484,964163162,CREDIT,0,act,2030-10-02,2022-05-13 05:38:37,304.03,payment,568090.9
46430,3303564,45.154.0.210,314.0,atm,10,9571,964163162,CREDIT,0,act,2030-10-02,2022-07-15 00:16:34,304.18,in,568395.08
46431,3361510,109.126.0.210,381.0,port_trm,-1,4314,964163162,CREDIT,1,act,2030-10-02,2022-07-22 15:56:30,303.97,err_code,568395.08
46432,3441385,95.181.0.210,263.0,pos trm,451,1913,964163162,CREDIT,0,act,2030-10-02,2022-08-27 22:38:43,303.89,payment,568091.19
46433,3587718,185.233.0.60,81.0,ATM,25,1770,964163162,CREDIT,0,act,2030-10-02,2022-10-09 00:01:47,303.96,diff_cntry,567787.23
46434,4048762,109.126.0.60,369.0,cash_in,451,4525,964163162,CREDIT,0,act,2030-10-02,2022-10-10 20:50:36,304.25,payment,567482.98
46435,4106081,185.233.0.60,81.0,ATM,-1,7487,964163162,CREDIT,1,act,2030-10-02,2022-10-20 00:17:41,303.73,err,567482.98
46436,4130540,109.126.0.60,369.0,cash_in,30,7459,964163162,CREDIT,0,act,2030-10-02,2022-11-02 08:05:07,304.0,transfer,567178.98
46437,4168182,85.140.0.210,1267.0,cash_out,20,2908,964163162,CREDIT,0,act,2030-10-02,2022-11-23 19:24:13,304.12,out,566874.86
46438,4172732,46.0.188.210,1243.0,cash_out,451,8484,964163162,CREDIT,0,act,2030-10-02,2022-12-19 11:01:31,303.87,payment,566570.99
46439,4317672,109.126.0.60,369.0,cash_in,451,2908,964163162,CREDIT,0,act,2030-10-02,2022-12-25 11:41:27,303.89,payment,566267.1
46440,4664571,95.181.0.210,263.0,pos trm,25,9571,964163162,CREDIT,0,act,2030-10-02,2022-12-29 14:48:00,303.99,country_transfer,565963.11
46441,4818013,217.112.0.195,1488.0,atm,20,7618,964163162,CREDIT,0,act,2030-10-02,2023-01-01 20:29:37,304.01,from_acc,565659.1
46442,4965230,194.87.0.195,580.0,ATM,451,2908,964163162,CREDIT,0,act,2030-10-02,2023-01-12 18:45:26,303.89,payment,565355.21
46443,5143778,109.126.0.210,381.0,port_trm,-1,2849,964163162,CREDIT,1,act,2030-10-02,2023-01-14 19:33:27,303.95,err_code,565355.21
46444,5727553,95.181.0.210,263.0,pos trm,451,7618,964163162,CREDIT,0,act,2030-10-02,2023-01-25 23:18:58,303.93,payment,565051.28
46445,5801380,109.126.0.210,381.0,port_trm,30,7459,964163162,CREDIT,0,act,2030-10-02,2023-02-09 19:04:15,304.06,transfer,564747.22
46446,5973909,109.126.0.180,378.0,atm,10,8205,964163162,CREDIT,0,act,2030-10-02,2023-02-24 22:07:33,304.23,in_acc,565051.45
46447,6100536,95.181.0.210,263.0,pos trm,451,8020,964163162,CREDIT,0,act,2030-10-02,2023-03-01 16:03:51,304.07,payment,564747.38
46448,6396277,194.87.0.195,580.0,ATM,30,2849,964163162,CREDIT,0,act,2030-10-02,2023-03-07 22:05:10,303.8,transfer,564443.58
46449,6726656,109.126.0.210,381.0,port_trm,30,4876,964163162,CREDIT,0,act,2030-10-02,2023-03-13 05:38:20,303.93,transfer,564139.65
46450,6810245,46.0.128.30,701.0,cash_out,20,9571,964163162,CREDIT,0,act,2030-10-02,2023-03-28 15:39:34,303.95,out,563835.7
46451,6824039,194.87.0.195,580.0,ATM,25,8484,964163162,CREDIT,0,act,2030-10-02,2023-04-12 23:50:32,304.03,diff_cntry,563531.67
46452,7353527,95.181.0.210,263.0,pos trm,-1,4876,964163162,CREDIT,1,act,2030-10-02,2023-05-23 14:11:29,304.23,bad,563531.67
46453,7513327,151.0.0.30,14.0,cash_out,20,7487,964163162,CREDIT,0,act,2030-10-02,2023-07-30 12:09:26,303.82,decrease_on_acc,563227.85
46454,7537240,185.233.0.60,81.0,ATM,-1,7459,964163162,CREDIT,1,act,2030-10-02,2023-10-14 18:50:57,303.82,bad,563227.85
46455,7750030,194.87.0.195,580.0,ATM,30,8205,964163162,CREDIT,0,act,2030-10-02,2023-10-28 16:11:20,304.01,transfer,562923.84
46456,7782433,109.126.0.210,381.0,port_trm,25,7618,964163162,CREDIT,0,act,2030-10-02,2023-10-28 22:15:06,304.06,diff_cntry,562619.78
46457,7845322,109.126.0.210,381.0,port_trm,30,2849,964163162,CREDIT,0,act,2030-10-02,2023-11-19 19:02:55,304.09,transfer,562315.69
46458,7870253,95.181.0.210,263.0,pos trm,25,4314,964163162,CREDIT,0,act,2030-10-02,2023-12-23 21:40:41,303.81,country_transfer,562011.88
46459,7988780,217.112.0.195,1488.0,atm,10,4876,964163162,CREDIT,0,act,2030-10-02,2023-12-28 00:50:37,304.04,in_acc,562315.92
46460,8061742,109.126.0.210,381.0,port_trm,451,8484,964163162,CREDIT,0,act,2030-10-02,2023-12-28 14:26:18,304.09,payment,562011.83
46461,8248125,151.0.38.30,390.0,port_trm,-1,6996,964163162,CREDIT,1,act,2030-10-02,2023-12-31 16:09:36,303.84,err_code,562011.83
46462,8444955,212.20.0.120,457.0,ATM,10,7618,964163162,CREDIT,0,act,2030-10-02,2024-01-02 07:40:42,304.01,in,562315.84
46463,8609868,95.181.0.210,263.0,pos trm,451,7618,964163162,CREDIT,0,act,2030-10-02,2024-02-24 00:24:21,304.04,payment,562011.8
46464,8670243,46.0.188.210,1243.0,cash_out,25,1913,964163162,CREDIT,0,act,2030-10-02,2024-02-28 14:11:13,303.82,country_transfer,561707.98
46465,8872101,109.126.0.210,381.0,port_trm,30,4581,964163162,CREDIT,0,act,2030-10-02,2024-03-25 18:34:14,304.05,transfer,561403.93
46466,8904675,151.0.38.30,390.0,port_trm,451,4314,964163162,CREDIT,0,act,2030-10-02,2024-04-12 00:40:29,303.97,payment,561099.96
46467,9041535,213.151.0.105,1007.0,cash_out,20,8020,964163162,CREDIT,0,act,2030-10-02,2024-05-30 03:33:23,303.95,out,560796.01
46468,9401423,194.87.0.195,580.0,ATM,30,7618,964163162,CREDIT,0,act,2030-10-02,2024-08-06 20:57:47,303.84,transfer,560492.17
46469,9420170,46.0.188.210,1243.0,cash_out,25,4876,964163162,CREDIT,0,act,2030-10-02,2024-08-08 16:22:41,304.17,diff_cntry,560188.0
46470,9430376,185.233.0.60,81.0,ATM,25,2908,964163162,CREDIT,0,act,2030-10-02,2024-09-03 13:51:44,303.79,country_transfer,559884.21
46471,9536588,95.181.0.210,263.0,pos trm,30,7618,964163162,CREDIT,0,act,2030-10-02,2024-09-24 01:05:36,303.74,transfer,559580.47
46472,9645877,151.0.38.30,390.0,port_trm,25,1913,964163162,CREDIT,0,act,2030-10-02,2024-10-03 02:53:11,304.02,diff_cntry,559276.45
46473,9788547,194.87.0.195,580.0,ATM,30,7618,964163162,CREDIT,0,act,2030-10-02,2024-10-28 08:21:29,304.04,transfer,558972.41
46474,9930222,185.233.0.60,81.0,ATM,451,4876,964163162,CREDIT,0,act,2030-10-02,2024-11-17 07:15:48,303.85,payment,558668.56
46475,1238279,85.140.0.75,1254.0,prtbl trm,451,5959,778133517,CREDIT,0,active,2030-07-20,2022-01-12 00:31:00,623.95,payment,856052.05
46476,1564531,188.0.166.90,1305.0,cash_out,30,6514,778133517,CREDIT,0,active,2030-07-20,2022-01-22 00:53:37,623.74,transfer,855428.31
46477,1601452,46.0.188.60,1232.0,cash_in,-1,2136,778133517,CREDIT,1,active,2030-07-20,2022-03-16 16:37:40,624.21,err,855428.31
46478,1695331,188.0.166.90,1305.0,cash_out,451,7407,778133517,CREDIT,0,active,2030-07-20,2022-03-18 10:14:52,624.12,payment,854804.19
46479,2079223,188.0.166.90,1305.0,cash_out,451,5932,778133517,CREDIT,0,active,2030-07-20,2022-03-24 11:10:50,623.97,payment,854180.22
46480,2142431,46.0.128.15,699.0,port_trm,-1,5835,778133517,CREDIT,1,active,2030-07-20,2022-03-28 07:10:03,623.99,bad,854180.22
46481,2210059,46.0.123.90,917.0,atm,10,5835,778133517,CREDIT,0,active,2030-07-20,2022-04-04 17:49:14,624.2,in_acc,854804.42
46482,2548782,95.181.0.135,257.0,cash_in,10,8604,778133517,CREDIT,0,active,2030-07-20,2022-04-26 15:11:13,623.89,in,855428.31
46483,2549569,85.140.0.30,1249.0,cash_out,-1,7922,778133517,CREDIT,1,active,2030-07-20,2022-05-27 09:35:43,624.04,err_code,855428.31
46484,2654550,46.0.128.15,699.0,port_trm,30,3069,778133517,CREDIT,0,active,2030-07-20,2022-05-29 20:24:48,623.78,transfer,854804.53
46485,2783532,46.0.54.210,1090.0,atm,30,6514,778133517,CREDIT,0,active,2030-07-20,2022-06-04 23:40:26,624.07,transfer,854180.46
46486,3297716,46.0.128.15,699.0,port_trm,451,2702,778133517,CREDIT,0,active,2030-07-20,2022-06-07 05:17:20,623.77,payment,853556.69
46487,3464410,95.181.0.15,249.0,ATM,30,6514,778133517,CREDIT,0,active,2030-07-20,2022-06-28 23:40:14,624.1,transfer,852932.59
46488,3937774,37.0.123.105,328.0,ATM,10,5651,778133517,CREDIT,0,active,2030-07-20,2022-07-10 22:41:29,624.08,in_acc,853556.67
46489,4031628,46.0.54.210,1090.0,atm,25,5651,778133517,CREDIT,0,active,2030-07-20,2022-10-10 04:54:51,623.86,diff_cntry,852932.81
46490,4035659,46.0.0.120,663.0,prtbl trm,451,3069,778133517,CREDIT,0,active,2030-07-20,2022-10-11 06:50:13,623.9,payment,852308.91
46491,4040126,46.0.188.60,1232.0,cash_in,-1,4677,778133517,CREDIT,1,active,2030-07-20,2022-10-18 21:15:13,623.93,err,852308.91
46492,4169102,46.0.0.120,663.0,prtbl trm,451,5651,778133517,CREDIT,0,active,2030-07-20,2022-11-07 08:06:35,623.82,payment,851685.09
46493,4331006,46.0.128.15,699.0,port_trm,451,4337,778133517,CREDIT,0,active,2030-07-20,2022-11-09 14:25:37,623.9,payment,851061.19
46494,4480089,46.0.128.15,699.0,port_trm,25,9251,778133517,CREDIT,0,active,2030-07-20,2022-11-17 17:46:33,624.05,country_transfer,850437.14
46495,4534778,188.0.166.90,1305.0,cash_out,451,5932,778133517,CREDIT,0,active,2030-07-20,2022-12-20 23:22:01,623.81,payment,849813.33
46496,4551946,85.140.0.30,1249.0,cash_out,-1,9251,778133517,CREDIT,1,active,2030-07-20,2022-12-27 18:55:51,623.96,err_code,849813.33
46497,4575240,194.156.0.90,28.0,cash_in,10,2136,778133517,CREDIT,0,active,2030-07-20,2022-12-30 17:27:05,624.2,in_acc,850437.53
46498,4587895,128.0.24.45,883.0,atm,10,6514,778133517,CREDIT,0,active,2030-07-20,2022-12-31 01:24:59,624.1,in_acc,851061.63
46499,4687519,46.0.128.15,699.0,port_trm,30,5932,778133517,CREDIT,0,active,2030-07-20,2023-01-06 19:05:24,623.71,transfer,850437.92
46500,4723487,46.0.54.210,1090.0,atm,25,7407,778133517,CREDIT,0,active,2030-07-20,2023-01-14 06:56:21,623.92,country_transfer,849814.0
46501,4903649,46.0.0.120,663.0,prtbl trm,451,1736,778133517,CREDIT,0,active,2030-07-20,2023-01-18 19:04:23,624.14,payment,849189.86
46502,4936353,217.112.0.60,1476.0,atm,10,4153,778133517,CREDIT,0,active,2030-07-20,2023-01-19 10:40:48,624.06,add_on_acc,849813.92
46503,5055954,85.140.0.75,1254.0,prtbl trm,30,5959,778133517,CREDIT,0,active,2030-07-20,2023-02-21 18:49:42,624.15,transfer,849189.77
46504,5101362,85.140.0.30,1249.0,cash_out,25,1241,778133517,CREDIT,0,active,2030-07-20,2023-03-05 09:08:03,624.24,diff_cntry,848565.53
46505,5213475,46.0.54.210,1090.0,atm,10,4677,778133517,CREDIT,0,active,2030-07-20,2023-03-10 15:49:19,623.98,add_on_acc,849189.51
46506,5222577,46.0.123.15,910.0,ATM,10,5835,778133517,CREDIT,0,active,2030-07-20,2023-04-12 19:55:58,624.29,in_acc,849813.8
46507,5250111,85.140.0.30,1249.0,cash_out,451,6514,778133517,CREDIT,0,active,2030-07-20,2023-04-17 17:25:44,623.92,payment,849189.88
46508,5258560,95.167.0.105,208.0,atm,20,5651,778133517,CREDIT,0,active,2030-07-20,2023-04-25 03:07:58,623.92,from_acc,848565.96
46509,5380200,46.0.188.60,1232.0,cash_in,-1,6514,778133517,CREDIT,1,active,2030-07-20,2023-04-30 03:42:20,623.99,err_code,848565.96
46510,5659825,85.140.0.30,1249.0,cash_out,451,7922,778133517,CREDIT,0,active,2030-07-20,2023-06-06 01:01:36,624.06,payment,847941.9
46511,5806692,95.181.0.15,249.0,ATM,25,6514,778133517,CREDIT,0,active,2030-07-20,2023-06-08 22:39:23,623.91,country_transfer,847317.99
46512,5979174,95.181.0.15,249.0,ATM,25,2702,778133517,CREDIT,0,active,2030-07-20,2023-06-09 02:18:32,623.88,country_transfer,846694.11
46513,6087501,85.140.0.30,1249.0,cash_out,25,5959,778133517,CREDIT,0,active,2030-07-20,2023-06-15 16:01:53,623.83,diff_cntry,846070.28
46514,6254437,85.140.0.75,1254.0,prtbl trm,25,4907,778133517,CREDIT,0,active,2030-07-20,2023-07-10 01:24:24,623.97,country_transfer,845446.31
46515,6468155,88.210.0.45,343.0,cash_in,10,5651,778133517,CREDIT,0,active,2030-07-20,2023-07-12 01:09:45,623.99,in,846070.3
46516,6530648,78.24.158.99,939.0,atm,30,6514,778133517,CREDIT,0,active,2030-07-20,2023-08-28 00:46:09,623.96,transfer,845446.34
46517,6538621,46.0.188.60,1232.0,cash_in,451,3069,778133517,CREDIT,0,active,2030-07-20,2023-09-13 01:49:21,623.99,payment,844822.35
46518,6724478,85.140.0.30,1249.0,cash_out,25,7922,778133517,CREDIT,0,active,2030-07-20,2024-01-01 03:05:37,623.83,country_transfer,844198.52
46519,6827829,46.0.188.60,1232.0,cash_in,451,4337,778133517,CREDIT,0,active,2030-07-20,2024-01-26 05:17:22,623.94,payment,843574.58
46520,6906688,46.0.0.120,663.0,prtbl trm,451,2702,778133517,CREDIT,0,active,2030-07-20,2024-01-31 17:15:15,624.03,payment,842950.55
46521,7497808,46.0.128.15,699.0,port_trm,25,8604,778133517,CREDIT,0,active,2030-07-20,2024-03-30 11:18:40,624.14,diff_cntry,842326.41
46522,7700717,128.0.24.15,880.0,cash_in,10,5932,778133517,CREDIT,0,active,2030-07-20,2024-04-07 21:24:54,623.97,in_acc,842950.38
46523,7936864,95.181.0.15,249.0,ATM,-1,7407,778133517,CREDIT,1,active,2030-07-20,2024-04-19 10:16:35,624.05,err_code,842950.38
46524,8027150,46.0.0.120,663.0,prtbl trm,-1,4677,778133517,CREDIT,2,active,2030-07-20,2024-05-28 20:40:22,624.07,err_code,842950.38
46525,8341953,188.0.166.90,1305.0,cash_out,30,4337,778133517,CREDIT,0,active,2030-07-20,2024-06-01 02:05:18,623.7,transfer,842326.68
46526,8710232,95.167.0.75,205.0,ATM,10,3234,778133517,CREDIT,0,active,2030-07-20,2024-06-10 04:56:14,623.7,in,842950.38
46527,8730370,46.0.0.120,663.0,prtbl trm,451,6514,778133517,CREDIT,0,active,2030-07-20,2024-06-29 10:54:36,623.79,payment,842326.59
46528,8807091,188.0.166.90,1305.0,cash_out,30,5651,778133517,CREDIT,0,active,2030-07-20,2024-07-02 04:47:01,624.37,transfer,841702.22
46529,9042167,78.24.158.99,939.0,atm,451,2136,778133517,CREDIT,0,active,2030-07-20,2024-09-30 11:40:57,623.83,payment,841078.39
46530,9189550,188.0.166.90,1305.0,cash_out,451,1496,778133517,CREDIT,0,active,2030-07-20,2024-10-09 21:30:50,624.0,payment,840454.39
46531,9350441,46.0.54.210,1090.0,atm,30,8604,778133517,CREDIT,0,active,2030-07-20,2024-10-09 22:39:57,623.86,transfer,839830.53
46532,9425009,188.0.166.90,1305.0,cash_out,30,6990,778133517,CREDIT,0,active,2030-07-20,2024-10-28 06:19:46,623.7,transfer,839206.83
46533,9883164,85.140.0.75,1254.0,prtbl trm,30,5932,778133517,CREDIT,0,active,2030-07-20,2024-11-21 20:03:17,623.94,transfer,838582.89
46534,1061251,46.0.2.30,183.0,cash_in,25,5409,822595728,CREDIT,0,act,2028-01-18,2022-01-19 06:18:01,1028.06,country_transfer,271436.94
46535,1476792,188.0.189.90,838.0,Portable term,25,9136,822595728,CREDIT,0,act,2028-01-18,2022-02-01 20:53:57,1028.02,country_transfer,270408.92
46536,1546431,46.0.128.45,702.0,port_trm,451,6874,822595728,CREDIT,0,act,2028-01-18,2022-03-04 00:29:33,1027.94,payment,269380.98
46537,1579631,46.173.0.180,511.0,cash_in,-1,6150,822595728,CREDIT,1,act,2028-01-18,2022-04-20 23:41:29,1027.88,bad,269380.98
46538,1841767,194.156.0.150,32.0,pos trm,451,3484,822595728,CREDIT,0,act,2028-01-18,2022-06-08 16:22:29,1027.87,payment,268353.11
46539,1978863,194.156.0.150,32.0,pos trm,451,6927,822595728,CREDIT,0,act,2028-01-18,2022-07-22 08:53:36,1027.97,payment,267325.14
46540,2048345,188.0.189.90,838.0,Portable term,25,7275,822595728,CREDIT,0,act,2028-01-18,2022-07-27 03:54:38,1028.03,country_transfer,266297.11
46541,2204580,46.0.2.180,194.0,cash_in,10,7571,822595728,CREDIT,0,act,2028-01-18,2022-09-23 01:38:41,1028.26,in,267325.37
46542,2244429,46.0.128.45,702.0,port_trm,30,2984,822595728,CREDIT,0,act,2028-01-18,2022-10-18 03:37:13,1027.83,transfer,266297.54
46543,2273984,46.0.128.45,702.0,port_trm,30,6874,822595728,CREDIT,0,act,2028-01-18,2023-02-01 06:17:35,1027.9,transfer,265269.64
46544,2385133,195.143.0.90,1369.0,pos trm,30,2580,822595728,CREDIT,0,act,2028-01-18,2023-03-28 12:29:16,1027.99,transfer,264241.65
46545,2858460,46.0.2.30,183.0,cash_in,451,4476,822595728,CREDIT,0,act,2028-01-18,2023-04-09 00:58:32,1028.13,payment,263213.52
46546,2892796,195.143.0.90,1369.0,pos trm,25,5239,822595728,CREDIT,0,act,2028-01-18,2023-10-09 21:20:39,1027.75,diff_cntry,262185.77
46547,3100699,188.0.169.225,485.0,cash_in,10,7275,822595728,CREDIT,0,act,2028-01-18,2023-12-30 08:35:25,1028.12,in_acc,263213.89
46548,3299717,46.173.0.180,511.0,cash_in,-1,3049,822595728,CREDIT,1,act,2028-01-18,2024-03-18 08:24:35,1028.03,bad,263213.89
46549,3560435,46.0.128.45,702.0,port_trm,-1,1486,822595728,CREDIT,2,act,2028-01-18,2024-07-05 12:23:10,1027.99,err_code,263213.89
46550,3628584,194.156.0.150,32.0,pos trm,-1,2580,822595728,CREDIT,3,blocked,2028-01-18,2024-11-11 00:16:46,1027.95,err,0.0
46551,1187078,46.0.176.150,128.0,atm,30,5636,801384543,CREDIT,0,act,2027-02-08,2022-01-03 11:51:02,1130.84,transfer,425808.16
46552,1606670,151.0.38.90,394.0,ATM,30,2801,801384543,CREDIT,0,act,2027-02-08,2022-01-08 11:09:35,1130.84,transfer,424677.32
46553,1719919,185.17.0.195,1064.0,ATM,20,1619,801384543,CREDIT,0,act,2027-02-08,2022-03-17 15:51:48,1131.07,from_acc,423546.25
46554,2040673,46.0.176.150,128.0,atm,451,4018,801384543,CREDIT,0,act,2027-02-08,2022-03-30 15:29:39,1130.7,payment,422415.55
46555,2083446,46.0.176.150,128.0,atm,25,6996,801384543,CREDIT,0,act,2027-02-08,2022-04-05 03:13:49,1130.75,country_transfer,421284.8
46556,2089783,78.24.158.204,948.0,Portable term,-1,8346,801384543,CREDIT,1,act,2027-02-08,2022-04-07 00:14:21,1130.99,err_code,421284.8
46557,2126066,37.0.127.165,1034.0,cash_in,10,7469,801384543,CREDIT,0,act,2027-02-08,2022-04-25 02:26:43,1130.78,in,422415.58
46558,2154521,188.0.169.225,485.0,cash_in,10,7469,801384543,CREDIT,0,act,2027-02-08,2022-05-17 08:01:45,1131.17,add_on_acc,423546.75
46559,2163160,151.0.38.90,394.0,ATM,30,8346,801384543,CREDIT,0,act,2027-02-08,2022-06-09 20:57:48,1130.82,transfer,422415.93
46560,2252674,151.0.38.90,394.0,ATM,30,8674,801384543,CREDIT,0,act,2027-02-08,2022-06-14 02:07:37,1131.19,transfer,421284.74
46561,2268525,88.210.0.210,360.0,atm,451,4257,801384543,CREDIT,0,act,2027-02-08,2022-06-28 06:05:07,1131.08,payment,420153.66
46562,2490759,151.0.38.90,394.0,ATM,-1,8958,801384543,CREDIT,1,act,2027-02-08,2022-06-29 15:36:15,1130.89,bad,420153.66
46563,2743763,88.210.0.210,360.0,atm,-1,2801,801384543,CREDIT,2,act,2027-02-08,2022-07-03 05:04:42,1131.03,err,420153.66
46564,2750712,46.0.176.150,128.0,atm,30,2801,801384543,CREDIT,0,act,2027-02-08,2022-07-12 14:46:19,1131.03,transfer,419022.63
46565,2925896,88.210.0.210,360.0,atm,451,2784,801384543,CREDIT,0,act,2027-02-08,2022-09-01 17:08:25,1130.98,payment,417891.65
46566,2926153,188.0.166.15,1297.0,ATM,20,6996,801384543,CREDIT,0,act,2027-02-08,2022-10-01 07:10:14,1130.99,from_acc,416760.66
46567,3286687,46.0.0.240,673.0,ATM,451,6508,801384543,CREDIT,0,act,2027-02-08,2022-11-12 09:39:17,1131.12,payment,415629.54
46568,3299524,188.0.0.60,1210.0,ATM,10,2413,801384543,CREDIT,0,act,2027-02-08,2022-12-02 03:52:57,1131.1,in_acc,416760.64
46569,3495775,46.0.123.225,929.0,ATM,20,5636,801384543,CREDIT,0,act,2027-02-08,2022-12-03 18:14:39,1130.82,decrease_on_acc,415629.82
46570,3957790,78.24.158.204,948.0,Portable term,451,8346,801384543,CREDIT,0,act,2027-02-08,2022-12-08 13:06:27,1131.03,payment,414498.79
46571,4165583,46.0.176.150,128.0,atm,25,2413,801384543,CREDIT,0,act,2027-02-08,2022-12-26 08:02:56,1131.18,country_transfer,413367.61
46572,4223707,46.0.176.150,128.0,atm,20,4703,801384543,CREDIT,0,act,2027-02-08,2023-02-08 12:20:05,1130.99,from_acc,412236.62
46573,4420969,151.0.38.90,394.0,ATM,30,2784,801384543,CREDIT,0,act,2027-02-08,2023-03-14 13:58:54,1131.04,transfer,411105.58
46574,4706453,46.0.176.150,128.0,atm,30,8958,801384543,CREDIT,0,act,2027-02-08,2023-03-20 05:25:59,1130.76,transfer,409974.82
46575,4730280,46.0.0.240,673.0,ATM,30,2784,801384543,CREDIT,0,act,2027-02-08,2023-03-20 13:50:34,1130.99,transfer,408843.83
46576,4785516,78.24.158.204,948.0,Portable term,30,6508,801384543,CREDIT,0,act,2027-02-08,2023-06-18 23:57:16,1130.85,transfer,407712.98
46577,4792665,88.210.0.210,360.0,atm,451,8674,801384543,CREDIT,0,act,2027-02-08,2023-07-10 07:06:54,1131.17,payment,406581.81
46578,4877163,193.0.151.150,64.0,ATM,10,6996,801384543,CREDIT,0,act,2027-02-08,2023-07-15 16:56:26,1131.0,in,407712.81
46579,4955229,88.210.0.120,350.0,atm,20,4703,801384543,CREDIT,0,act,2027-02-08,2023-07-18 00:40:29,1130.51,out,406582.3
46580,4985552,151.0.38.90,394.0,ATM,30,2784,801384543,CREDIT,0,act,2027-02-08,2023-07-21 14:21:51,1130.87,transfer,405451.43
46581,4990663,46.0.0.240,673.0,ATM,30,8958,801384543,CREDIT,0,act,2027-02-08,2023-08-14 16:41:57,1130.71,transfer,404320.72
46582,5066673,46.0.176.150,128.0,atm,-1,5636,801384543,CREDIT,1,act,2027-02-08,2023-09-13 02:42:14,1130.93,bad,404320.72
46583,5112392,151.0.38.90,394.0,ATM,451,2784,801384543,CREDIT,0,act,2027-02-08,2023-10-10 15:27:09,1130.98,payment,403189.74
46584,5251319,88.210.0.210,360.0,atm,451,4128,801384543,CREDIT,0,act,2027-02-08,2023-10-23 23:05:05,1130.92,payment,402058.82
46585,6040447,46.0.0.240,673.0,ATM,-1,5636,801384543,CREDIT,1,act,2027-02-08,2023-12-03 05:25:17,1131.03,bad,402058.82
46586,6049050,78.24.158.204,948.0,Portable term,30,8674,801384543,CREDIT,0,act,2027-02-08,2023-12-11 18:25:30,1131.13,transfer,400927.69
46587,6253505,88.210.0.210,360.0,atm,451,5636,801384543,CREDIT,0,act,2027-02-08,2023-12-15 06:16:51,1130.75,payment,399796.94
46588,6289617,78.24.158.204,948.0,Portable term,30,9815,801384543,CREDIT,0,act,2027-02-08,2023-12-20 02:19:04,1130.98,transfer,398665.96
46589,6489742,46.0.0.240,673.0,ATM,-1,8346,801384543,CREDIT,1,act,2027-02-08,2024-01-09 01:50:08,1130.93,err_code,398665.96
46590,6492061,128.0.82.0,610.0,atm,20,2801,801384543,CREDIT,0,act,2027-02-08,2024-01-09 10:24:38,1130.98,decrease_on_acc,397534.98
46591,6542989,45.154.0.30,297.0,ATM,10,4909,801384543,CREDIT,0,act,2027-02-08,2024-01-22 14:59:14,1130.95,add_on_acc,398665.93
46592,6729983,46.0.0.240,673.0,ATM,30,4703,801384543,CREDIT,0,act,2027-02-08,2024-01-31 18:13:21,1130.97,transfer,397534.96
46593,6778433,151.0.38.90,394.0,ATM,25,4018,801384543,CREDIT,0,act,2027-02-08,2024-03-14 03:37:40,1131.09,diff_cntry,396403.87
46594,6917867,151.0.38.90,394.0,ATM,-1,6508,801384543,CREDIT,1,act,2027-02-08,2024-03-19 00:38:17,1130.84,err,396403.87
46595,7017283,46.0.123.75,916.0,ATM,20,4257,801384543,CREDIT,0,act,2027-02-08,2024-04-16 11:35:46,1130.67,from_acc,395273.2
46596,7636547,78.24.158.204,948.0,Portable term,25,4257,801384543,CREDIT,0,act,2027-02-08,2024-05-09 22:47:40,1131.05,country_transfer,394142.15
46597,7648588,88.210.0.210,360.0,atm,451,7469,801384543,CREDIT,0,act,2027-02-08,2024-05-13 03:03:43,1130.91,payment,393011.24
46598,8183995,151.0.38.90,394.0,ATM,25,2413,801384543,CREDIT,0,act,2027-02-08,2024-06-02 16:33:47,1130.79,country_transfer,391880.45
46599,8372677,94.243.0.240,116.0,atm,10,2784,801384543,CREDIT,0,act,2027-02-08,2024-06-19 15:58:39,1131.2,in_acc,393011.65
46600,8434647,46.0.0.240,673.0,ATM,25,8674,801384543,CREDIT,0,act,2027-02-08,2024-07-02 20:59:14,1130.93,diff_cntry,391880.72
46601,8717975,188.18.0.105,228.0,atm,10,8958,801384543,CREDIT,0,act,2027-02-08,2024-09-12 04:12:04,1130.97,add_on_acc,393011.69
46602,8822828,88.210.0.210,360.0,atm,25,8674,801384543,CREDIT,0,act,2027-02-08,2024-09-14 05:10:03,1131.06,diff_cntry,391880.63
46603,9303466,88.210.0.210,360.0,atm,30,3761,801384543,CREDIT,0,act,2027-02-08,2024-11-20 06:11:54,1131.05,transfer,390749.58
46604,1376064,193.31.0.60,591.0,atm,10,3850,584520677,DEBIT,0,act,2027-05-19,2022-01-12 01:09:03,861.95,in_acc,669670.95
46605,1605483,185.17.0.120,1058.0,Portable term,25,9265,584520677,DEBIT,0,act,2027-05-19,2022-01-12 15:03:26,861.78,diff_cntry,668809.17
46606,1848726,185.17.0.120,1058.0,Portable term,451,1091,584520677,DEBIT,0,act,2027-05-19,2022-01-27 13:49:45,861.83,payment,667947.34
46607,1872234,185.17.0.120,1058.0,Portable term,25,5116,584520677,DEBIT,0,act,2027-05-19,2022-01-28 21:50:47,862.01,diff_cntry,667085.33
46608,1952666,31.134.0.135,1125.0,cash_in,451,3567,584520677,DEBIT,0,act,2027-05-19,2022-01-31 19:56:23,861.98,payment,666223.35
46609,2038591,46.0.2.240,199.0,ATM,25,6342,584520677,DEBIT,0,act,2027-05-19,2022-02-18 14:26:41,862.04,country_transfer,665361.31
46610,2706590,188.0.169.240,486.0,prtbl trm,-1,3850,584520677,DEBIT,1,act,2027-05-19,2022-02-20 02:10:07,861.8,bad,665361.31
46611,3045395,5.189.0.60,860.0,cash_in,10,5753,584520677,DEBIT,0,act,2027-05-19,2022-03-28 14:17:22,862.01,in,666223.32
46612,3070583,188.0.189.195,848.0,cash_out,20,6053,584520677,DEBIT,0,act,2027-05-19,2022-04-15 18:15:16,862.38,decrease_on_acc,665360.94
46613,3099879,31.134.0.135,1125.0,cash_in,25,3850,584520677,DEBIT,0,act,2027-05-19,2022-04-30 23:13:40,862.02,country_transfer,664498.92
46614,3158817,188.191.0.240,1160.0,ATM,20,6342,584520677,DEBIT,0,act,2027-05-19,2022-05-01 11:29:34,861.79,out,663637.13
46615,3188838,31.134.0.135,1125.0,cash_in,30,5985,584520677,DEBIT,0,act,2027-05-19,2022-05-07 10:13:21,861.98,transfer,662775.15
46616,3238234,46.0.2.240,199.0,ATM,25,5116,584520677,DEBIT,0,act,2027-05-19,2022-07-24 06:41:29,862.1,country_transfer,661913.05
46617,3343267,151.0.0.60,16.0,prtbl trm,25,3567,584520677,DEBIT,0,act,2027-05-19,2022-08-03 10:30:05,862.05,diff_cntry,661051.0
46618,3369701,46.8.0.165,780.0,ATM,20,8860,584520677,DEBIT,0,act,2027-05-19,2022-08-08 06:25:32,862.02,from_acc,660188.98
46619,3766156,95.167.0.135,211.0,ATM,20,8860,584520677,DEBIT,0,act,2027-05-19,2022-08-21 19:44:25,862.12,from_acc,659326.86
46620,3945608,95.167.0.180,215.0,ATM,20,1091,584520677,DEBIT,0,act,2027-05-19,2022-10-20 13:44:28,862.22,out,658464.64
46621,4237832,31.134.0.135,1125.0,cash_in,30,3567,584520677,DEBIT,0,act,2027-05-19,2023-01-03 22:15:37,862.05,transfer,657602.59
46622,4264529,31.134.0.135,1125.0,cash_in,25,1390,584520677,DEBIT,0,act,2027-05-19,2023-01-18 01:53:55,862.06,country_transfer,656740.53
46623,4300016,188.0.169.240,486.0,prtbl trm,451,8199,584520677,DEBIT,0,act,2027-05-19,2023-02-12 01:48:22,861.95,payment,655878.58
46624,4434965,46.0.54.90,1076.0,cash_in,451,4487,584520677,DEBIT,0,act,2027-05-19,2023-02-26 23:23:04,861.67,payment,655016.91
46625,4593395,151.0.0.60,16.0,prtbl trm,30,5346,584520677,DEBIT,0,act,2027-05-19,2023-04-18 19:01:20,861.95,transfer,654154.96
46626,4719242,46.0.123.105,918.0,cash_out,20,6053,584520677,DEBIT,0,act,2027-05-19,2023-05-07 01:16:47,862.14,from_acc,653292.82
46627,4836339,185.17.0.120,1058.0,Portable term,25,5992,584520677,DEBIT,0,act,2027-05-19,2023-06-19 23:55:13,861.88,country_transfer,652430.94
46628,5062256,151.0.0.60,16.0,prtbl trm,451,9443,584520677,DEBIT,0,act,2027-05-19,2023-06-30 10:29:18,861.98,payment,651568.96
46629,5206276,151.0.0.60,16.0,prtbl trm,30,3983,584520677,DEBIT,0,act,2027-05-19,2023-07-07 09:25:22,861.86,transfer,650707.1
46630,5259326,212.20.0.15,446.0,cash_in,25,5985,584520677,DEBIT,0,act,2027-05-19,2023-08-13 17:05:49,862.29,diff_cntry,649844.81
46631,5329327,5.189.0.120,865.0,ATM,20,3983,584520677,DEBIT,0,act,2027-05-19,2023-09-05 11:27:18,862.1,from_acc,648982.71
46632,5746678,151.0.38.135,399.0,cash_out,20,9443,584520677,DEBIT,0,act,2027-05-19,2023-09-17 12:38:32,862.09,from_acc,648120.62
46633,5893695,151.0.0.60,16.0,prtbl trm,451,8919,584520677,DEBIT,0,act,2027-05-19,2023-09-29 01:36:26,861.96,payment,647258.66
46634,5915886,185.17.0.120,1058.0,Portable term,451,5753,584520677,DEBIT,0,act,2027-05-19,2023-10-16 02:07:52,862.06,payment,646396.6
46635,5933117,46.0.54.90,1076.0,cash_in,-1,5346,584520677,DEBIT,1,act,2027-05-19,2023-10-17 08:56:55,861.95,bad,646396.6
46636,5945369,46.0.8.225,155.0,cash_in,10,3567,584520677,DEBIT,0,act,2027-05-19,2023-10-29 10:30:27,862.04,in,647258.64
46637,6037076,188.0.169.240,486.0,prtbl trm,451,8199,584520677,DEBIT,0,act,2027-05-19,2023-12-03 05:36:14,862.11,payment,646396.53
46638,6049593,46.0.54.90,1076.0,cash_in,-1,6342,584520677,DEBIT,1,act,2027-05-19,2024-01-08 14:27:42,861.73,err,646396.53
46639,6138029,193.31.0.210,607.0,cash_out,20,1091,584520677,DEBIT,0,act,2027-05-19,2024-01-23 14:08:20,862.19,out,645534.34
46640,6140584,151.0.0.60,16.0,prtbl trm,-1,8860,584520677,DEBIT,1,act,2027-05-19,2024-01-29 17:01:14,861.66,err,645534.34
46641,6632403,194.156.0.75,27.0,atm,10,9443,584520677,DEBIT,0,act,2027-05-19,2024-02-29 04:13:54,862.04,in_acc,646396.38
46642,6651961,151.0.0.60,16.0,prtbl trm,25,3983,584520677,DEBIT,0,act,2027-05-19,2024-03-15 14:46:00,862.04,country_transfer,645534.34
46643,6698703,185.17.0.120,1058.0,Portable term,-1,2839,584520677,DEBIT,1,act,2027-05-19,2024-03-16 04:24:31,862.13,bad,645534.34
46644,6727312,85.140.0.90,1255.0,ATM,20,9443,584520677,DEBIT,0,act,2027-05-19,2024-03-18 14:49:08,862.09,decrease_on_acc,644672.25
46645,6899580,151.0.0.60,16.0,prtbl trm,451,9265,584520677,DEBIT,0,act,2027-05-19,2024-04-27 22:02:19,861.87,payment,643810.38
46646,6947344,188.0.169.240,486.0,prtbl trm,30,5992,584520677,DEBIT,0,act,2027-05-19,2024-04-28 06:35:33,862.03,transfer,642948.35
46647,7282785,31.134.0.135,1125.0,cash_in,451,6342,584520677,DEBIT,0,act,2027-05-19,2024-05-04 15:20:43,861.59,payment,642086.76
46648,7496957,31.134.0.135,1125.0,cash_in,451,5116,584520677,DEBIT,0,act,2027-05-19,2024-05-19 05:16:25,862.07,payment,641224.69
46649,7707569,46.0.54.90,1076.0,cash_in,451,8919,584520677,DEBIT,0,act,2027-05-19,2024-05-21 04:17:55,861.76,payment,640362.93
46650,8141972,212.20.0.195,463.0,cash_in,10,8199,584520677,DEBIT,0,act,2027-05-19,2024-05-29 22:49:42,861.75,add_on_acc,641224.68
46651,8142745,185.17.0.120,1058.0,Portable term,30,5346,584520677,DEBIT,0,act,2027-05-19,2024-06-18 03:24:44,861.97,transfer,640362.71
46652,8449327,188.0.169.240,486.0,prtbl trm,451,5753,584520677,DEBIT,0,act,2027-05-19,2024-06-24 11:14:46,861.91,payment,639500.8
46653,8536856,46.0.2.240,199.0,ATM,-1,9443,584520677,DEBIT,1,act,2027-05-19,2024-07-20 10:37:16,861.95,bad,639500.8
46654,8559516,212.20.0.15,446.0,cash_in,30,7927,584520677,DEBIT,0,act,2027-05-19,2024-08-02 11:14:15,862.13,transfer,638638.67
46655,8871168,46.0.54.90,1076.0,cash_in,30,6053,584520677,DEBIT,0,act,2027-05-19,2024-08-05 00:18:45,862.08,transfer,637776.59
46656,9088713,151.0.0.60,16.0,prtbl trm,25,9443,584520677,DEBIT,0,act,2027-05-19,2024-08-22 04:01:25,861.7,diff_cntry,636914.89
46657,9276317,46.0.54.90,1076.0,cash_in,451,3850,584520677,DEBIT,0,act,2027-05-19,2024-08-23 21:22:13,862.08,payment,636052.81
46658,9367181,31.134.0.135,1125.0,cash_in,451,5985,584520677,DEBIT,0,act,2027-05-19,2024-09-09 19:39:21,862.25,payment,635190.56
46659,9435309,212.20.0.15,446.0,cash_in,451,3983,584520677,DEBIT,0,act,2027-05-19,2024-09-21 05:32:41,861.96,payment,634328.6
46660,9788462,195.58.0.15,1425.0,atm,10,5346,584520677,DEBIT,0,act,2027-05-19,2024-10-27 03:40:37,861.92,add_on_acc,635190.52
46661,9901278,188.0.169.240,486.0,prtbl trm,-1,3850,584520677,DEBIT,1,act,2027-05-19,2024-10-28 22:04:19,861.94,err_code,635190.52
46662,1107651,193.0.151.120,60.0,prtbl trm,30,3401,400668031,CREDIT,0,act,2029-05-03,2022-01-02 12:39:09,390.18,transfer,683642.82
46663,1490579,85.140.0.0,1246.0,atm,10,4445,400668031,CREDIT,0,act,2029-05-03,2022-02-24 06:08:00,390.04,in,684032.86
46664,1885958,217.112.0.240,1495.0,pos trm,30,4445,400668031,CREDIT,0,act,2029-05-03,2022-03-06 03:26:00,390.02,transfer,683642.84
46665,2109084,217.112.0.240,1495.0,pos trm,25,3791,400668031,CREDIT,0,act,2029-05-03,2022-03-15 13:59:59,390.24,country_transfer,683252.6
46666,2198167,188.128.16.211,1201.0,ATM,451,7474,400668031,CREDIT,0,act,2029-05-03,2022-03-15 19:47:59,390.19,payment,682862.41
46667,2221962,188.0.189.120,841.0,cash_in,10,5868,400668031,CREDIT,0,act,2029-05-03,2022-03-25 21:52:02,390.16,in_acc,683252.57
46668,2310847,79.104.0.0,634.0,cash_in,10,4445,400668031,CREDIT,0,act,2029-05-03,2022-04-20 10:39:49,390.06,in_acc,683642.63
46669,2335488,79.104.60.90,434.0,pos trm,30,7474,400668031,CREDIT,0,act,2029-05-03,2022-05-02 02:51:21,390.09,transfer,683252.54
46670,2595987,91.107.0.60,979.0,ATM,10,4445,400668031,CREDIT,0,act,2029-05-03,2022-05-04 09:46:12,390.33,in_acc,683642.87
46671,2891717,46.0.188.0,1226.0,cash_out,20,5505,400668031,CREDIT,0,act,2029-05-03,2022-05-12 06:47:33,389.75,out,683253.12
46672,2941403,79.104.60.90,434.0,pos trm,-1,9053,400668031,CREDIT,1,act,2029-05-03,2022-06-15 15:45:13,389.95,bad,683253.12
46673,3239858,217.112.0.240,1495.0,pos trm,451,4037,400668031,CREDIT,0,act,2029-05-03,2022-07-30 00:53:06,390.07,payment,682863.05
46674,3469643,188.128.16.106,1191.0,Portable term,451,5480,400668031,CREDIT,0,act,2029-05-03,2022-08-12 14:20:48,389.99,payment,682473.06
46675,3584320,217.112.0.240,1495.0,pos trm,-1,2683,400668031,CREDIT,1,act,2029-05-03,2022-08-26 17:55:40,390.07,bad,682473.06
46676,3682653,217.112.0.240,1495.0,pos trm,451,5480,400668031,CREDIT,0,act,2029-05-03,2022-09-03 10:25:07,389.82,payment,682083.24
46677,3909520,217.112.0.240,1495.0,pos trm,30,3873,400668031,CREDIT,0,act,2029-05-03,2022-09-07 03:20:47,389.97,transfer,681693.27
46678,4344413,188.128.16.106,1191.0,Portable term,451,7175,400668031,CREDIT,0,act,2029-05-03,2022-09-08 03:27:12,390.12,payment,681303.15
46679,4388305,193.0.151.120,60.0,prtbl trm,-1,5480,400668031,CREDIT,1,act,2029-05-03,2022-09-30 02:39:27,390.04,bad,681303.15
46680,4455059,188.128.16.211,1201.0,ATM,451,4445,400668031,CREDIT,0,act,2029-05-03,2022-10-03 15:48:36,389.87,payment,680913.28
46681,4547380,217.112.0.0,1471.0,ATM,10,4687,400668031,CREDIT,0,act,2029-05-03,2022-11-29 12:11:25,389.82,in_acc,681303.1
46682,5095719,188.128.16.211,1201.0,ATM,451,3791,400668031,CREDIT,0,act,2029-05-03,2022-11-30 05:24:31,389.97,payment,680913.13
46683,5117194,188.128.16.106,1191.0,Portable term,25,5505,400668031,CREDIT,0,act,2029-05-03,2022-12-15 23:03:38,389.91,country_transfer,680523.22
46684,5139987,188.128.16.211,1201.0,ATM,-1,3791,400668031,CREDIT,1,act,2029-05-03,2022-12-30 08:28:47,389.82,err,680523.22
46685,5192445,79.104.60.90,434.0,pos trm,30,5505,400668031,CREDIT,0,act,2029-05-03,2022-12-30 11:20:51,389.93,transfer,680133.29
46686,5202418,193.0.151.120,60.0,prtbl trm,25,5480,400668031,CREDIT,0,act,2029-05-03,2022-12-31 22:42:12,390.17,country_transfer,679743.12
46687,5207507,188.128.16.106,1191.0,Portable term,-1,8719,400668031,CREDIT,1,act,2029-05-03,2023-01-07 08:52:14,390.1,err,679743.12
46688,5234781,188.128.16.211,1201.0,ATM,-1,3791,400668031,CREDIT,2,act,2029-05-03,2023-02-12 18:38:06,389.81,err,679743.12
46689,5335578,193.0.151.120,60.0,prtbl trm,451,4445,400668031,CREDIT,0,act,2029-05-03,2023-02-19 03:56:32,390.01,payment,679353.11
46690,5393089,95.106.0.75,549.0,cash_in,10,4037,400668031,CREDIT,0,act,2029-05-03,2023-05-08 23:17:52,390.11,in_acc,679743.22
46691,5699226,79.104.60.90,434.0,pos trm,451,4037,400668031,CREDIT,0,act,2029-05-03,2023-06-13 15:47:16,389.73,payment,679353.49
46692,5700706,217.112.0.240,1495.0,pos trm,451,9053,400668031,CREDIT,0,act,2029-05-03,2023-07-06 09:10:19,389.97,payment,678963.52
46693,5817284,79.104.60.90,434.0,pos trm,451,7474,400668031,CREDIT,0,act,2029-05-03,2023-07-09 12:07:55,390.17,payment,678573.35
46694,5878188,46.0.9.30,1319.0,cash_in,10,4037,400668031,CREDIT,0,act,2029-05-03,2023-08-31 05:35:07,390.13,in_acc,678963.48
46695,6013540,79.104.0.90,642.0,ATM,20,4037,400668031,CREDIT,0,act,2029-05-03,2023-09-19 04:40:18,390.14,out,678573.34
46696,6023096,193.0.151.120,60.0,prtbl trm,25,4687,400668031,CREDIT,0,act,2029-05-03,2023-10-10 06:09:26,390.07,diff_cntry,678183.27
46697,6204301,188.18.0.195,239.0,cash_in,10,4445,400668031,CREDIT,0,act,2029-05-03,2023-11-13 20:08:44,389.97,in_acc,678573.24
46698,6695663,79.104.60.90,434.0,pos trm,451,3791,400668031,CREDIT,0,act,2029-05-03,2023-11-20 13:32:10,389.84,payment,678183.4
46699,6914517,217.112.0.240,1495.0,pos trm,25,4037,400668031,CREDIT,0,act,2029-05-03,2023-12-02 19:37:00,389.89,country_transfer,677793.51
46700,7232004,95.167.0.135,211.0,ATM,20,7175,400668031,CREDIT,0,act,2029-05-03,2023-12-03 02:00:11,390.08,out,677403.43
46701,7482138,5.189.0.0,854.0,atm,10,3791,400668031,CREDIT,0,act,2029-05-03,2023-12-19 14:04:26,390.15,add_on_acc,677793.58
46702,7491083,193.0.151.120,60.0,prtbl trm,451,5505,400668031,CREDIT,0,act,2029-05-03,2023-12-27 07:18:52,390.05,payment,677403.53
46703,7769833,188.128.16.211,1201.0,ATM,25,4445,400668031,CREDIT,0,act,2029-05-03,2024-01-21 08:35:51,390.16,country_transfer,677013.37
46704,7918091,213.151.0.120,1009.0,ATM,20,2683,400668031,CREDIT,0,act,2029-05-03,2024-01-23 20:58:20,390.12,out,676623.25
46705,7995418,46.173.0.195,512.0,ATM,20,3873,400668031,CREDIT,0,act,2029-05-03,2024-01-29 19:38:06,390.19,decrease_on_acc,676233.06
46706,8052972,188.128.16.136,1195.0,cash_in,10,8719,400668031,CREDIT,0,act,2029-05-03,2024-03-11 12:19:39,390.07,in,676623.13
46707,8069861,193.0.151.120,60.0,prtbl trm,-1,4037,400668031,CREDIT,1,act,2029-05-03,2024-04-12 08:40:55,390.02,err_code,676623.13
46708,8154188,188.128.16.211,1201.0,ATM,451,3791,400668031,CREDIT,0,act,2029-05-03,2024-04-12 16:25:27,389.99,payment,676233.14
46709,8231162,188.128.16.106,1191.0,Portable term,451,8719,400668031,CREDIT,0,act,2029-05-03,2024-04-13 09:23:40,390.01,payment,675843.13
46710,8258850,188.18.0.105,228.0,atm,10,7474,400668031,CREDIT,0,act,2029-05-03,2024-04-27 01:20:56,390.09,in,676233.22
46711,8409432,85.140.0.90,1255.0,ATM,10,4037,400668031,CREDIT,0,act,2029-05-03,2024-04-29 09:06:18,390.09,add_on_acc,676623.31
46712,8463021,193.0.151.120,60.0,prtbl trm,25,3791,400668031,CREDIT,0,act,2029-05-03,2024-05-27 21:37:20,390.0,country_transfer,676233.31
46713,8739791,79.104.60.90,434.0,pos trm,30,3791,400668031,CREDIT,0,act,2029-05-03,2024-06-11 18:57:34,390.04,transfer,675843.27
46714,8775809,109.126.0.60,369.0,cash_in,10,9053,400668031,CREDIT,0,act,2029-05-03,2024-07-18 14:29:03,389.84,add_on_acc,676233.11
46715,8809655,217.112.0.240,1495.0,pos trm,30,9053,400668031,CREDIT,0,act,2029-05-03,2024-07-22 20:30:36,390.03,transfer,675843.08
46716,8886001,79.104.60.90,434.0,pos trm,30,4037,400668031,CREDIT,0,act,2029-05-03,2024-07-31 15:34:35,389.91,transfer,675453.17
46717,9388208,217.112.0.240,1495.0,pos trm,25,4445,400668031,CREDIT,0,act,2029-05-03,2024-08-17 00:54:06,389.87,country_transfer,675063.3
46718,9554202,188.128.16.106,1191.0,Portable term,30,7175,400668031,CREDIT,0,act,2029-05-03,2024-10-12 06:58:16,390.05,transfer,674673.25
46719,9870116,79.104.60.90,434.0,pos trm,-1,3401,400668031,CREDIT,1,act,2029-05-03,2024-10-24 19:25:07,390.19,err,674673.25
46720,1760220,128.0.82.210,631.0,pos trm,25,6683,339881146,DEBIT,0,act,2027-04-29,2022-01-08 17:40:06,1196.09,country_transfer,201995.91
46721,1909372,78.24.158.249,951.0,atm,20,7586,339881146,DEBIT,0,act,2027-04-29,2022-01-21 07:19:50,1195.98,decrease_on_acc,200799.93
46722,2026561,79.104.0.90,642.0,ATM,30,8258,339881146,DEBIT,0,act,2027-04-29,2022-03-10 19:58:04,1196.13,transfer,199603.8
46723,2067428,109.126.0.240,385.0,cash_in,30,4022,339881146,DEBIT,0,act,2027-04-29,2022-03-15 10:02:52,1195.9,transfer,198407.9
46724,2099295,95.181.0.150,259.0,port_trm,451,1867,339881146,DEBIT,0,act,2027-04-29,2022-03-23 05:12:01,1195.87,payment,197212.03
46725,2224595,77.242.0.90,278.0,cash_in,451,4032,339881146,DEBIT,0,act,2027-04-29,2022-03-28 02:17:10,1195.98,payment,196016.05
46726,2934158,95.167.0.135,211.0,ATM,10,4032,339881146,DEBIT,0,act,2027-04-29,2022-05-04 19:32:39,1195.93,add_on_acc,197211.98
46727,3055419,95.181.0.150,259.0,port_trm,-1,1590,339881146,DEBIT,1,act,2027-04-29,2022-05-29 13:05:15,1195.83,bad,197211.98
46728,3199070,194.156.0.75,27.0,atm,25,2393,339881146,DEBIT,0,act,2027-04-29,2022-06-23 07:19:35,1195.93,country_transfer,196016.05
46729,3464667,185.173.0.60,1277.0,cash_out,-1,5297,339881146,DEBIT,1,act,2027-04-29,2022-06-23 13:50:19,1195.89,bad,196016.05
46730,3711061,185.173.0.60,1277.0,cash_out,451,1171,339881146,DEBIT,0,act,2027-04-29,2022-07-22 03:07:06,1196.19,payment,194819.86
46731,3838128,79.104.0.90,642.0,ATM,25,8258,339881146,DEBIT,0,act,2027-04-29,2022-07-26 19:24:15,1195.95,diff_cntry,193623.91
46732,3954304,128.0.82.210,631.0,pos trm,25,7586,339881146,DEBIT,0,act,2027-04-29,2022-08-06 06:30:20,1195.74,country_transfer,192428.17
46733,4250807,128.0.82.210,631.0,pos trm,451,2127,339881146,DEBIT,0,act,2027-04-29,2022-09-02 15:59:07,1195.88,payment,191232.29
46734,4414307,77.242.0.90,278.0,cash_in,25,9203,339881146,DEBIT,0,act,2027-04-29,2022-09-25 06:54:29,1196.1,country_transfer,190036.19
46735,4585792,109.126.0.240,385.0,cash_in,25,1867,339881146,DEBIT,0,act,2027-04-29,2022-10-05 05:49:15,1196.13,diff_cntry,188840.06
46736,4664291,185.173.0.75,1278.0,ATM,20,6683,339881146,DEBIT,0,act,2027-04-29,2022-10-06 00:03:46,1196.17,from_acc,187643.89
46737,4757928,194.156.0.75,27.0,atm,451,2127,339881146,DEBIT,0,act,2027-04-29,2022-10-10 04:18:26,1196.04,payment,186447.85
46738,4807542,46.0.176.0,117.0,cash_in,10,3210,339881146,DEBIT,0,act,2027-04-29,2022-10-10 13:06:21,1196.07,in,187643.92
46739,4849431,188.162.0.165,966.0,Portable term,25,4736,339881146,DEBIT,0,act,2027-04-29,2022-11-02 21:56:18,1195.83,country_transfer,186448.09
46740,5001920,185.173.0.60,1277.0,cash_out,451,1867,339881146,DEBIT,0,act,2027-04-29,2022-12-10 04:02:11,1195.82,payment,185252.27
46741,5042765,46.0.9.15,1318.0,ATM,10,8574,339881146,DEBIT,0,act,2027-04-29,2022-12-10 23:21:56,1195.92,in_acc,186448.19
46742,5189312,78.24.158.99,939.0,atm,10,9203,339881146,DEBIT,0,act,2027-04-29,2023-02-06 02:02:48,1196.19,in_acc,187644.38
46743,5632660,128.0.82.210,631.0,pos trm,451,2271,339881146,DEBIT,0,act,2027-04-29,2023-02-23 10:27:11,1196.04,payment,186448.34
46744,5843522,188.162.0.165,966.0,Portable term,451,3524,339881146,DEBIT,0,act,2027-04-29,2023-05-18 21:47:47,1196.15,payment,185252.19
46745,5854194,95.106.0.150,557.0,cash_in,10,1635,339881146,DEBIT,0,act,2027-04-29,2023-08-26 00:48:55,1196.12,in,186448.31
46746,6111448,95.181.0.150,259.0,port_trm,30,1635,339881146,DEBIT,0,act,2027-04-29,2023-09-15 18:08:32,1195.89,transfer,185252.42
46747,6117107,77.242.0.90,278.0,cash_in,25,1867,339881146,DEBIT,0,act,2027-04-29,2023-11-08 01:36:42,1195.83,diff_cntry,184056.59
46748,6124955,188.162.0.165,966.0,Portable term,451,1385,339881146,DEBIT,0,act,2027-04-29,2023-12-19 16:31:14,1195.87,payment,182860.72
46749,6155303,212.20.0.225,465.0,atm,20,4736,339881146,DEBIT,0,act,2027-04-29,2023-12-28 03:26:37,1195.84,from_acc,181664.88
46750,6296336,95.181.0.150,259.0,port_trm,451,2271,339881146,DEBIT,0,act,2027-04-29,2024-01-12 08:04:50,1196.33,payment,180468.55
46751,6523575,79.104.0.90,642.0,ATM,25,1635,339881146,DEBIT,0,act,2027-04-29,2024-01-16 09:22:59,1195.53,country_transfer,179273.02
46752,6589615,185.173.0.60,1277.0,cash_out,-1,1171,339881146,DEBIT,1,act,2027-04-29,2024-01-28 12:01:44,1195.97,err,179273.02
46753,6626769,79.104.0.90,642.0,ATM,451,4736,339881146,DEBIT,0,act,2027-04-29,2024-03-04 05:53:41,1196.18,payment,178076.84
46754,6700513,194.156.0.75,27.0,atm,30,1590,339881146,DEBIT,0,act,2027-04-29,2024-03-14 22:29:03,1195.86,transfer,176880.98
46755,6807309,185.173.0.60,1277.0,cash_out,-1,1867,339881146,DEBIT,1,act,2027-04-29,2024-04-05 20:40:27,1196.03,err_code,176880.98
46756,6827335,185.173.0.60,1277.0,cash_out,25,1635,339881146,DEBIT,0,act,2027-04-29,2024-06-08 13:39:02,1195.99,country_transfer,175684.99
46757,6940055,77.242.0.90,278.0,cash_in,451,8574,339881146,DEBIT,0,act,2027-04-29,2024-06-17 10:22:23,1196.07,payment,174488.92
46758,7310119,188.244.0.210,1468.0,cash_in,10,2271,339881146,DEBIT,0,act,2027-04-29,2024-06-29 23:47:21,1196.21,in_acc,175685.13
46759,7317761,194.156.0.75,27.0,atm,25,4022,339881146,DEBIT,0,act,2027-04-29,2024-08-14 17:26:16,1196.23,diff_cntry,174488.9
46760,7495447,151.0.38.195,404.0,cash_in,10,9203,339881146,DEBIT,0,act,2027-04-29,2024-08-17 14:58:58,1195.81,add_on_acc,175684.71
46761,7689155,188.0.169.210,484.0,atm,10,1867,339881146,DEBIT,0,act,2027-04-29,2024-09-28 09:02:07,1195.77,in_acc,176880.48
46762,7887138,79.104.0.90,642.0,ATM,-1,4032,339881146,DEBIT,1,act,2027-04-29,2024-09-29 02:38:49,1196.05,bad,176880.48
46763,8269269,109.126.0.240,385.0,cash_in,-1,8574,339881146,DEBIT,2,act,2027-04-29,2024-10-26 21:34:43,1195.86,err,176880.48
46764,8294038,46.0.2.210,197.0,port_trm,-1,9162,339881146,DEBIT,3,blk,2027-04-29,2024-10-31 11:31:54,1196.12,bad,176880.48
46765,1022762,188.0.189.135,842.0,cash_out,451,1170,348889955,CREDIT,0,act,2026-03-21,2022-01-22 19:07:56,157.16,payment,450831.84
46766,1069094,188.0.189.0,831.0,cash_in,30,2027,348889955,CREDIT,0,act,2026-03-21,2022-02-03 11:26:09,157.02,transfer,450674.82
46767,1208981,37.0.123.195,334.0,ATM,20,3078,348889955,CREDIT,0,act,2026-03-21,2022-02-15 09:32:25,156.95,from_acc,450517.87
46768,1384371,213.151.0.240,1019.0,atm,451,4049,348889955,CREDIT,0,act,2026-03-21,2022-03-18 08:57:42,156.93,payment,450360.94
46769,1445690,46.0.2.60,185.0,cash_in,451,4434,348889955,CREDIT,0,act,2026-03-21,2022-03-25 12:31:18,156.95,payment,450203.99
46770,1545177,46.0.143.105,819.0,cash_out,20,6754,348889955,CREDIT,0,act,2026-03-21,2022-06-11 23:37:58,157.03,out,450046.96
46771,1594791,188.244.0.15,1449.0,ATM,20,1182,348889955,CREDIT,0,act,2026-03-21,2022-06-22 12:57:40,156.78,out,449890.18
46772,1911625,188.18.0.195,239.0,cash_in,10,4959,348889955,CREDIT,0,act,2026-03-21,2022-07-19 07:55:44,156.84,add_on_acc,450047.02
46773,1935020,77.242.0.75,276.0,ATM,20,1079,348889955,CREDIT,0,act,2026-03-21,2022-08-04 21:26:36,157.11,from_acc,449889.91
46774,1952014,188.0.189.135,842.0,cash_out,451,3869,348889955,CREDIT,0,act,2026-03-21,2022-08-05 20:12:03,157.24,payment,449732.67
46775,2323897,78.24.158.159,944.0,cash_out,451,4049,348889955,CREDIT,0,act,2026-03-21,2022-08-16 22:19:32,156.93,payment,449575.74
46776,2369887,188.0.189.135,842.0,cash_out,25,6381,348889955,CREDIT,0,act,2026-03-21,2022-08-23 14:09:53,157.23,country_transfer,449418.51
46777,2398192,194.84.192.222,46.0,cash_in,10,1518,348889955,CREDIT,0,act,2026-03-21,2022-08-26 18:13:48,156.98,in,449575.49
46778,2751932,78.24.158.159,944.0,cash_out,30,6754,348889955,CREDIT,0,act,2026-03-21,2022-09-12 12:02:50,157.06,transfer,449418.43
46779,2774113,31.134.0.105,1123.0,cash_out,20,1170,348889955,CREDIT,0,act,2026-03-21,2022-11-01 20:12:42,157.18,from_acc,449261.25
46780,3064640,46.0.188.210,1243.0,cash_out,20,1518,348889955,CREDIT,0,act,2026-03-21,2022-11-07 19:35:21,156.81,decrease_on_acc,449104.44
46781,3482285,46.0.123.225,929.0,ATM,20,3438,348889955,CREDIT,0,act,2026-03-21,2022-11-27 17:16:09,156.92,out,448947.52
46782,3572072,78.24.158.159,944.0,cash_out,30,6754,348889955,CREDIT,0,act,2026-03-21,2022-12-14 21:39:03,156.94,transfer,448790.58
46783,3692782,37.0.124.210,735.0,cash_in,10,1182,348889955,CREDIT,0,act,2026-03-21,2022-12-22 23:45:13,157.25,in,448947.83
46784,3869384,46.0.2.60,185.0,cash_in,-1,4821,348889955,CREDIT,1,act,2026-03-21,2023-01-22 13:24:07,156.96,err_code,448947.83
46785,3963003,195.143.0.30,1364.0,atm,20,4242,348889955,CREDIT,0,act,2026-03-21,2023-01-25 08:34:35,157.12,decrease_on_acc,448790.71
46786,4030060,188.43.0.0,1404.0,cash_out,20,3869,348889955,CREDIT,0,act,2026-03-21,2023-02-21 06:16:41,156.97,from_acc,448633.74
46787,4100398,95.167.0.60,204.0,ATM,451,4821,348889955,CREDIT,0,act,2026-03-21,2023-03-05 08:00:46,156.83,payment,448476.91
46788,4192859,213.151.0.240,1019.0,atm,30,4959,348889955,CREDIT,0,act,2026-03-21,2023-03-17 20:28:28,156.71,transfer,448320.2
46789,4194081,95.167.0.60,204.0,ATM,-1,6381,348889955,CREDIT,1,act,2026-03-21,2023-03-22 11:52:53,157.07,err_code,448320.2
46790,4533928,95.167.0.240,219.0,ATM,-1,1079,348889955,CREDIT,2,act,2026-03-21,2023-04-10 16:44:28,157.1,bad,448320.2
46791,4779040,188.0.189.135,842.0,cash_out,30,3078,348889955,CREDIT,0,act,2026-03-21,2023-04-13 05:46:31,156.96,transfer,448163.24
46792,4782211,78.24.158.159,944.0,cash_out,-1,1182,348889955,CREDIT,1,act,2026-03-21,2023-05-14 18:15:07,156.93,bad,448163.24
46793,4948438,95.167.0.60,204.0,ATM,451,4049,348889955,CREDIT,0,act,2026-03-21,2023-05-26 20:00:56,157.05,payment,448006.19
46794,5160113,91.107.0.210,993.0,atm,20,4049,348889955,CREDIT,0,act,2026-03-21,2023-06-06 04:31:13,157.31,out,447848.88
46795,5273955,46.0.2.60,185.0,cash_in,451,4959,348889955,CREDIT,0,act,2026-03-21,2023-08-25 22:34:31,156.89,payment,447691.99
46796,5326951,46.0.2.60,185.0,cash_in,451,4242,348889955,CREDIT,0,act,2026-03-21,2023-08-30 08:38:16,157.07,payment,447534.92
46797,5385690,95.181.0.165,260.0,atm,10,4049,348889955,CREDIT,0,act,2026-03-21,2023-09-07 10:31:48,156.88,in_acc,447691.8
46798,5392314,95.167.0.240,219.0,ATM,451,4959,348889955,CREDIT,0,act,2026-03-21,2023-09-08 16:52:20,157.19,payment,447534.61
46799,5462017,194.87.0.105,573.0,atm,20,4049,348889955,CREDIT,0,act,2026-03-21,2023-10-18 21:48:53,156.82,from_acc,447377.79
46800,5546562,46.0.2.60,185.0,cash_in,30,4242,348889955,CREDIT,0,act,2026-03-21,2023-10-20 01:05:23,157.06,transfer,447220.73
46801,6043181,91.107.0.180,990.0,atm,10,3869,348889955,CREDIT,0,act,2026-03-21,2023-10-25 03:40:53,157.13,add_on_acc,447377.86
46802,6362033,95.167.0.240,219.0,ATM,-1,3869,348889955,CREDIT,1,act,2026-03-21,2023-10-31 07:02:53,156.91,err_code,447377.86
46803,6592453,188.0.189.0,831.0,cash_in,25,1079,348889955,CREDIT,0,act,2026-03-21,2023-11-04 04:20:10,157.08,diff_cntry,447220.78
46804,6609232,212.20.0.30,448.0,ATM,20,1170,348889955,CREDIT,0,act,2026-03-21,2023-11-27 18:23:17,157.35,out,447063.43
46805,7251426,188.0.0.60,1210.0,ATM,10,7856,348889955,CREDIT,0,act,2026-03-21,2023-12-01 01:21:36,157.07,in_acc,447220.5
46806,7285606,194.156.0.240,41.0,cash_out,451,1182,348889955,CREDIT,0,act,2026-03-21,2023-12-10 23:47:07,156.72,payment,447063.78
46807,7757425,213.151.0.240,1019.0,atm,451,4242,348889955,CREDIT,0,act,2026-03-21,2024-02-10 15:15:59,156.99,payment,446906.79
46808,7780224,85.140.0.240,1271.0,ATM,10,4049,348889955,CREDIT,0,act,2026-03-21,2024-03-15 16:55:28,156.9,add_on_acc,447063.69
46809,8223946,95.167.0.240,219.0,ATM,30,4821,348889955,CREDIT,0,act,2026-03-21,2024-05-21 19:51:30,156.85,transfer,446906.84
46810,8353106,46.0.143.30,812.0,atm,10,7856,348889955,CREDIT,0,act,2026-03-21,2024-06-13 22:05:08,156.93,in,447063.77
46811,8380963,213.151.0.240,1019.0,atm,451,4049,348889955,CREDIT,0,act,2026-03-21,2024-07-12 14:19:16,157.0,payment,446906.77
46812,8442709,213.151.0.240,1019.0,atm,25,1182,348889955,CREDIT,0,act,2026-03-21,2024-07-17 17:04:40,156.91,country_transfer,446749.86
46813,8639623,188.43.0.105,1411.0,ATM,20,4049,348889955,CREDIT,0,act,2026-03-21,2024-07-19 08:16:30,156.93,from_acc,446592.93
46814,9240906,78.24.158.159,944.0,cash_out,30,4821,348889955,CREDIT,0,act,2026-03-21,2024-07-24 18:53:25,156.77,transfer,446436.16
46815,9286587,217.26.0.150,689.0,ATM,10,1518,348889955,CREDIT,0,act,2026-03-21,2024-07-24 22:04:51,156.72,add_on_acc,446592.88
46816,9316744,188.18.0.180,238.0,ATM,20,1182,348889955,CREDIT,0,act,2026-03-21,2024-08-30 14:30:59,156.96,out,446435.92
46817,9542700,193.31.0.30,588.0,ATM,20,1518,348889955,CREDIT,0,act,2026-03-21,2024-08-31 11:57:45,156.99,out,446278.93
46818,9671948,46.8.0.240,787.0,ATM,10,1079,348889955,CREDIT,0,act,2026-03-21,2024-09-17 19:37:21,157.0,in,446435.93
46819,9896994,78.24.158.159,944.0,cash_out,25,1079,348889955,CREDIT,0,act,2026-03-21,2024-10-08 14:25:41,156.84,diff_cntry,446279.09
46820,9901817,37.0.124.75,726.0,ATM,10,4434,348889955,CREDIT,0,act,2026-03-21,2024-11-28 12:35:41,156.91,in,446436.0
46821,1240341,46.0.8.90,144.0,cash_in,10,1545,516090826,DEBIT,0,act,2025-08-23,2022-01-08 14:03:47,1009.0,in,169705.0
46822,1522921,188.0.0.90,1212.0,atm,25,4326,516090826,DEBIT,0,act,2025-08-23,2022-01-19 17:57:32,1008.97,country_transfer,168696.03
46823,1599505,46.0.0.150,665.0,cash_out,25,5985,516090826,DEBIT,0,act,2025-08-23,2022-02-11 11:21:21,1009.19,country_transfer,167686.84
46824,1769691,195.58.0.30,1426.0,cash_in,-1,9924,516090826,DEBIT,1,act,2025-08-23,2022-02-15 11:14:57,1009.05,err_code,167686.84
46825,1995017,195.58.0.30,1426.0,cash_in,25,4453,516090826,DEBIT,0,act,2025-08-23,2022-03-11 05:49:43,1008.84,country_transfer,166678.0
46826,2005768,46.0.128.135,710.0,pos trm,-1,6973,516090826,DEBIT,1,act,2025-08-23,2022-04-03 08:22:21,1009.12,bad,166678.0
46827,2013848,85.140.0.105,1256.0,cash_out,20,3836,516090826,DEBIT,0,act,2025-08-23,2022-04-10 14:45:11,1008.93,from_acc,165669.07
46828,2473576,46.0.0.150,665.0,cash_out,30,8297,516090826,DEBIT,0,act,2025-08-23,2022-06-06 19:03:17,1009.12,transfer,164659.95
46829,2545454,37.0.127.0,1021.0,port_trm,25,6508,516090826,DEBIT,0,act,2025-08-23,2022-08-12 22:44:55,1008.75,diff_cntry,163651.2
46830,2584792,62.118.0.180,534.0,port_trm,451,8297,516090826,DEBIT,0,act,2025-08-23,2022-08-16 14:24:13,1008.81,payment,162642.39
46831,2721654,46.0.0.150,665.0,cash_out,30,4528,516090826,DEBIT,0,act,2025-08-23,2022-08-29 12:07:26,1008.89,transfer,161633.5
46832,2801512,95.167.0.45,203.0,atm,10,6973,516090826,DEBIT,0,act,2025-08-23,2022-10-09 12:53:46,1009.04,in_acc,162642.54
46833,2806755,195.58.0.30,1426.0,cash_in,451,3836,516090826,DEBIT,0,act,2025-08-23,2022-10-24 18:00:58,1009.02,payment,161633.52
46834,2963797,188.0.0.90,1212.0,atm,25,9537,516090826,DEBIT,0,act,2025-08-23,2022-11-04 11:24:36,1008.87,country_transfer,160624.65
46835,3211241,5.189.0.165,869.0,cash_out,20,4489,516090826,DEBIT,0,act,2025-08-23,2022-11-17 04:58:06,1009.13,from_acc,159615.52
46836,3587503,46.0.123.60,914.0,cash_out,451,9253,516090826,DEBIT,0,act,2025-08-23,2022-12-04 17:37:53,1008.86,payment,158606.66
46837,3641621,46.0.128.135,710.0,pos trm,25,3235,516090826,DEBIT,0,act,2025-08-23,2022-12-13 19:14:16,1008.94,country_transfer,157597.72
46838,3648656,128.0.24.15,880.0,cash_in,10,9253,516090826,DEBIT,0,act,2025-08-23,2022-12-31 16:44:59,1008.93,in,158606.65
46839,3691653,46.0.128.135,710.0,pos trm,451,1545,516090826,DEBIT,0,act,2025-08-23,2023-01-15 09:14:11,1009.08,payment,157597.57
46840,3765131,46.0.123.60,914.0,cash_out,451,4326,516090826,DEBIT,0,act,2025-08-23,2023-01-21 09:33:21,1008.89,payment,156588.68
46841,3787216,46.0.123.60,914.0,cash_out,451,6782,516090826,DEBIT,0,act,2025-08-23,2023-01-28 00:11:12,1008.75,payment,155579.93
46842,3787861,188.191.0.195,1155.0,atm,20,8299,516090826,DEBIT,0,act,2025-08-23,2023-03-09 14:08:57,1009.23,from_acc,154570.7
46843,3950754,46.0.123.60,914.0,cash_out,451,8127,516090826,DEBIT,0,act,2025-08-23,2023-04-06 15:25:49,1008.7,payment,153562.0
46844,3974108,46.0.128.135,710.0,pos trm,25,3836,516090826,DEBIT,0,act,2025-08-23,2023-05-17 18:09:05,1008.99,country_transfer,152553.01
46845,4361124,37.0.127.0,1021.0,port_trm,451,8297,516090826,DEBIT,0,act,2025-08-23,2023-06-16 16:30:10,1009.25,payment,151543.76
46846,4426081,95.167.0.0,200.0,ATM,20,3836,516090826,DEBIT,0,act,2025-08-23,2023-06-29 20:42:48,1008.81,from_acc,150534.95
46847,4626237,195.58.0.30,1426.0,cash_in,25,9924,516090826,DEBIT,0,act,2025-08-23,2023-10-23 11:32:33,1008.95,diff_cntry,149526.0
46848,4854794,62.118.0.180,534.0,port_trm,30,4326,516090826,DEBIT,0,act,2025-08-23,2023-10-25 08:57:46,1009.29,transfer,148516.71
46849,5159434,188.18.0.150,234.0,atm,10,9253,516090826,DEBIT,0,act,2025-08-23,2023-10-29 14:29:53,1009.15,in_acc,149525.86
46850,5411045,46.0.9.15,1318.0,ATM,20,3235,516090826,DEBIT,0,act,2025-08-23,2023-10-30 09:40:38,1009.08,from_acc,148516.78
46851,5424579,195.58.0.30,1426.0,cash_in,-1,8245,516090826,DEBIT,1,act,2025-08-23,2023-11-25 18:11:43,1008.92,err_code,148516.78
46852,5431044,217.112.0.60,1476.0,atm,10,8299,516090826,DEBIT,0,act,2025-08-23,2023-11-30 03:39:56,1009.02,in,149525.8
46853,5574434,46.0.123.60,914.0,cash_out,30,4326,516090826,DEBIT,0,act,2025-08-23,2023-12-09 06:39:24,1009.13,transfer,148516.67
46854,5626506,46.0.123.60,914.0,cash_out,451,4528,516090826,DEBIT,0,act,2025-08-23,2023-12-09 14:04:03,1008.82,payment,147507.85
46855,5635446,188.0.0.90,1212.0,atm,30,9253,516090826,DEBIT,0,act,2025-08-23,2023-12-12 06:21:05,1008.94,transfer,146498.91
46856,5699091,94.243.0.210,114.0,atm,20,5850,516090826,DEBIT,0,act,2025-08-23,2023-12-30 12:48:33,1008.96,from_acc,145489.95
46857,6107406,37.0.127.0,1021.0,port_trm,30,9924,516090826,DEBIT,0,act,2025-08-23,2024-01-08 01:29:07,1009.02,transfer,144480.93
46858,6304003,37.0.127.0,1021.0,port_trm,30,4528,516090826,DEBIT,0,act,2025-08-23,2024-02-03 22:10:25,1009.1,transfer,143471.83
46859,6321114,46.0.54.240,1093.0,atm,10,8127,516090826,DEBIT,0,act,2025-08-23,2024-02-28 19:14:52,1008.72,add_on_acc,144480.55
46860,6463624,46.0.123.60,914.0,cash_out,30,8297,516090826,DEBIT,0,act,2025-08-23,2024-03-03 12:08:48,1009.1,transfer,143471.45
46861,6973879,77.242.0.210,287.0,atm,10,3235,516090826,DEBIT,0,act,2025-08-23,2024-03-09 01:48:13,1009.07,add_on_acc,144480.52
46862,7013013,31.134.0.105,1123.0,cash_out,20,8299,516090826,DEBIT,0,act,2025-08-23,2024-03-28 19:11:52,1009.23,decrease_on_acc,143471.29
46863,7072678,85.140.0.0,1246.0,atm,10,1956,516090826,DEBIT,0,act,2025-08-23,2024-04-10 23:13:05,1009.2,in_acc,144480.49
46864,7556133,62.118.0.195,535.0,atm,10,8245,516090826,DEBIT,0,act,2025-08-23,2024-04-17 05:01:23,1008.89,in_acc,145489.38
46865,7709698,62.118.0.180,534.0,port_trm,-1,1697,516090826,DEBIT,1,act,2025-08-23,2024-05-14 19:04:14,1008.64,err,145489.38
46866,7835831,46.0.0.150,665.0,cash_out,-1,1545,516090826,DEBIT,2,act,2025-08-23,2024-05-19 06:52:47,1009.18,err,145489.38
46867,7877661,195.58.0.60,1429.0,ATM,20,4489,516090826,DEBIT,0,act,2025-08-23,2024-05-23 06:17:32,1008.73,out,144480.65
46868,7971618,37.0.127.180,1035.0,atm,20,4489,516090826,DEBIT,0,act,2025-08-23,2024-05-26 15:38:44,1009.13,from_acc,143471.52
46869,8078137,188.0.0.90,1212.0,atm,30,4528,516090826,DEBIT,0,act,2025-08-23,2024-06-08 01:14:36,1008.72,transfer,142462.8
46870,8087154,46.0.128.135,710.0,pos trm,451,7251,516090826,DEBIT,0,act,2025-08-23,2024-06-09 22:19:45,1009.01,payment,141453.79
46871,8096231,91.107.0.165,989.0,cash_in,10,4326,516090826,DEBIT,0,act,2025-08-23,2024-06-17 00:32:27,1009.01,in,142462.8
46872,8488385,194.87.0.120,574.0,cash_out,20,8127,516090826,DEBIT,0,act,2025-08-23,2024-06-22 12:41:16,1008.95,out,141453.85
46873,8699690,86.111.0.180,1356.0,cash_out,20,9537,516090826,DEBIT,0,act,2025-08-23,2024-08-11 14:53:41,1009.02,out,140444.83
46874,8910886,195.58.0.30,1426.0,cash_in,-1,3235,516090826,DEBIT,1,act,2025-08-23,2024-09-07 00:09:19,1008.95,err,140444.83
46875,8992243,37.0.127.0,1021.0,port_trm,30,8299,516090826,DEBIT,0,act,2025-08-23,2024-09-16 13:39:45,1009.02,transfer,139435.81
46876,9176316,62.118.0.180,534.0,port_trm,451,6973,516090826,DEBIT,0,act,2025-08-23,2024-10-14 12:38:49,1009.08,payment,138426.73
46877,9300430,188.0.0.90,1212.0,atm,25,4453,516090826,DEBIT,0,act,2025-08-23,2024-10-21 14:24:18,1008.83,country_transfer,137417.9
46878,9908767,46.0.0.150,665.0,cash_out,30,1697,516090826,DEBIT,0,act,2025-08-23,2024-11-20 00:54:03,1008.86,transfer,136409.04
46879,1247268,185.173.0.135,1282.0,cash_out,25,3825,265025860,CREDIT,0,act,2030-10-27,2022-01-10 11:32:22,588.21,country_transfer,767149.79
46880,1774219,193.31.0.180,603.0,ATM,20,8713,265025860,CREDIT,0,act,2030-10-27,2022-01-21 14:03:50,588.16,out,766561.63
46881,2048222,79.104.0.225,652.0,atm,25,7775,265025860,CREDIT,0,act,2030-10-27,2022-01-23 18:13:15,587.89,diff_cntry,765973.74
46882,2164527,79.104.0.90,642.0,ATM,20,4385,265025860,CREDIT,0,act,2030-10-27,2022-01-30 08:34:44,588.0,from_acc,765385.74
46883,2336791,188.0.166.60,1303.0,atm,30,7775,265025860,CREDIT,0,act,2030-10-27,2022-02-25 09:57:00,587.97,transfer,764797.77
46884,2380548,128.0.82.135,622.0,port_trm,451,6300,265025860,CREDIT,0,act,2030-10-27,2022-03-25 04:19:14,587.92,payment,764209.85
46885,2617775,88.210.0.240,362.0,ATM,20,6300,265025860,CREDIT,0,act,2030-10-27,2022-04-20 23:01:07,588.2,out,763621.65
46886,2967749,188.18.0.30,223.0,cash_out,20,1502,265025860,CREDIT,0,act,2030-10-27,2022-05-12 01:05:03,588.08,from_acc,763033.57
46887,3034198,185.173.0.135,1282.0,cash_out,25,2078,265025860,CREDIT,0,act,2030-10-27,2022-05-21 00:56:38,588.05,diff_cntry,762445.52
46888,3117675,195.161.0.105,1170.0,atm,20,1056,265025860,CREDIT,0,act,2030-10-27,2022-06-07 19:39:44,588.1,from_acc,761857.42
46889,3215136,193.31.0.30,588.0,ATM,20,9273,265025860,CREDIT,0,act,2030-10-27,2022-08-02 00:10:35,587.97,decrease_on_acc,761269.45
46890,3767165,46.0.54.90,1076.0,cash_in,10,9192,265025860,CREDIT,0,act,2030-10-27,2022-08-29 12:12:32,588.27,in,761857.72
46891,4216796,46.0.188.150,1239.0,cash_in,10,1056,265025860,CREDIT,0,act,2030-10-27,2022-09-09 22:27:35,588.15,add_on_acc,762445.87
46892,4296097,194.0.144.15,159.0,cash_out,20,1056,265025860,CREDIT,0,act,2030-10-27,2022-09-12 04:01:56,588.32,decrease_on_acc,761857.55
46893,4575265,46.173.0.120,503.0,ATM,30,8006,265025860,CREDIT,0,act,2030-10-27,2022-09-18 11:04:50,588.0,transfer,761269.55
46894,4633121,37.0.127.105,1029.0,atm,10,1502,265025860,CREDIT,0,act,2030-10-27,2022-10-11 04:10:20,587.87,in,761857.42
46895,4728517,128.0.82.135,622.0,port_trm,25,7604,265025860,CREDIT,0,act,2030-10-27,2022-10-17 11:16:58,587.92,diff_cntry,761269.5
46896,4760785,194.0.162.240,761.0,cash_out,451,9867,265025860,CREDIT,0,act,2030-10-27,2022-11-14 03:04:55,587.87,payment,760681.63
46897,4913778,109.126.0.60,369.0,cash_in,10,7604,265025860,CREDIT,0,act,2030-10-27,2022-11-14 08:50:44,588.14,in,761269.77
46898,5027244,188.18.0.180,238.0,ATM,-1,3176,265025860,CREDIT,1,act,2030-10-27,2022-12-13 20:18:04,588.07,err,761269.77
46899,5082031,194.0.162.240,761.0,cash_out,-1,2663,265025860,CREDIT,2,act,2030-10-27,2023-01-24 18:16:14,588.28,err,761269.77
46900,5085581,46.0.188.45,1231.0,cash_out,20,3176,265025860,CREDIT,0,act,2030-10-27,2023-01-26 00:57:15,588.21,out,760681.56
46901,5107448,46.173.0.120,503.0,ATM,451,2663,265025860,CREDIT,0,act,2030-10-27,2023-01-27 01:46:36,588.01,payment,760093.55
46902,5282077,46.0.128.210,715.0,atm,-1,4385,265025860,CREDIT,1,act,2030-10-27,2023-01-30 05:41:19,587.84,bad,760093.55
46903,5283252,45.154.0.105,303.0,ATM,10,9867,265025860,CREDIT,0,act,2030-10-27,2023-02-13 00:59:07,588.03,add_on_acc,760681.58
46904,5872106,188.18.0.180,238.0,ATM,25,3275,265025860,CREDIT,0,act,2030-10-27,2023-02-21 12:26:43,588.05,diff_cntry,760093.53
46905,5994427,85.140.0.225,1270.0,cash_in,451,3825,265025860,CREDIT,0,act,2030-10-27,2023-03-02 04:16:34,588.14,payment,759505.39
46906,6022384,46.0.128.210,715.0,atm,451,2663,265025860,CREDIT,0,act,2030-10-27,2023-04-07 12:24:42,588.22,payment,758917.17
46907,6182439,185.173.0.135,1282.0,cash_out,30,5397,265025860,CREDIT,0,act,2030-10-27,2023-04-08 06:24:17,588.07,transfer,758329.1
46908,6202900,188.18.0.180,238.0,ATM,451,3275,265025860,CREDIT,0,act,2030-10-27,2023-06-25 13:00:16,587.78,payment,757741.32
46909,6236556,188.0.166.60,1303.0,atm,25,1056,265025860,CREDIT,0,act,2030-10-27,2023-08-05 23:36:35,588.08,country_transfer,757153.24
46910,6327127,188.18.0.180,238.0,ATM,30,2078,265025860,CREDIT,0,act,2030-10-27,2023-08-10 18:56:02,588.13,transfer,756565.11
46911,6638021,85.140.0.225,1270.0,cash_in,25,9273,265025860,CREDIT,0,act,2030-10-27,2023-08-16 00:51:34,587.85,country_transfer,755977.26
46912,6941745,46.0.0.240,673.0,ATM,10,8713,265025860,CREDIT,0,act,2030-10-27,2023-09-10 09:02:19,588.33,add_on_acc,756565.59
46913,6950547,188.18.0.180,238.0,ATM,25,1875,265025860,CREDIT,0,act,2030-10-27,2023-10-13 16:27:39,588.09,diff_cntry,755977.5
46914,7046636,185.233.0.225,95.0,cash_out,20,2078,265025860,CREDIT,0,act,2030-10-27,2023-10-26 16:47:19,587.97,from_acc,755389.53
46915,7097722,194.0.162.240,761.0,cash_out,-1,5711,265025860,CREDIT,1,act,2030-10-27,2023-10-27 14:33:22,588.06,err_code,755389.53
46916,7342974,188.18.0.180,238.0,ATM,451,9192,265025860,CREDIT,0,act,2030-10-27,2023-11-12 06:49:40,588.06,payment,754801.47
46917,7352113,85.140.0.225,1270.0,cash_in,25,8440,265025860,CREDIT,0,act,2030-10-27,2023-12-25 05:32:01,587.81,diff_cntry,754213.66
46918,7388503,46.173.0.120,503.0,ATM,30,7604,265025860,CREDIT,0,act,2030-10-27,2024-02-04 01:30:20,588.29,transfer,753625.37
46919,7546659,95.106.0.120,553.0,cash_in,10,8506,265025860,CREDIT,0,act,2030-10-27,2024-05-07 05:41:37,587.74,in_acc,754213.11
46920,7583123,185.173.0.135,1282.0,cash_out,451,5745,265025860,CREDIT,0,act,2030-10-27,2024-05-09 17:18:44,588.0,payment,753625.11
46921,7905750,188.0.166.60,1303.0,atm,-1,1875,265025860,CREDIT,1,act,2030-10-27,2024-05-29 11:33:20,588.02,err,753625.11
46922,8097015,85.140.0.225,1270.0,cash_in,25,5397,265025860,CREDIT,0,act,2030-10-27,2024-06-19 21:42:53,587.97,diff_cntry,753037.14
46923,8211975,185.173.0.135,1282.0,cash_out,451,8713,265025860,CREDIT,0,act,2030-10-27,2024-06-21 06:43:30,588.18,payment,752448.96
46924,8286675,195.161.0.105,1170.0,atm,10,5745,265025860,CREDIT,0,act,2030-10-27,2024-07-04 04:37:25,588.08,in_acc,753037.04
46925,8508605,46.173.0.120,503.0,ATM,25,5397,265025860,CREDIT,0,act,2030-10-27,2024-07-18 02:58:18,588.01,country_transfer,752449.03
46926,8917774,79.104.60.150,438.0,cash_in,10,5120,265025860,CREDIT,0,act,2030-10-27,2024-07-23 05:48:30,587.96,in_acc,753036.99
46927,9358665,46.0.128.210,715.0,atm,-1,8713,265025860,CREDIT,1,act,2030-10-27,2024-08-23 22:37:27,587.91,bad,753036.99
46928,9375179,128.0.24.195,898.0,cash_in,10,5397,265025860,CREDIT,0,act,2030-10-27,2024-08-24 17:41:57,587.91,in,753624.9
46929,9613817,46.0.128.210,715.0,atm,451,8440,265025860,CREDIT,0,act,2030-10-27,2024-08-25 16:45:09,588.26,payment,753036.64
46930,9661283,128.0.82.135,622.0,port_trm,-1,5828,265025860,CREDIT,1,act,2030-10-27,2024-10-09 10:32:51,588.01,bad,753036.64
46931,9992650,85.140.0.225,1270.0,cash_in,451,5711,265025860,CREDIT,0,act,2030-10-27,2024-11-26 08:07:53,587.71,payment,752448.93
46932,1070933,46.0.143.60,816.0,ATM,20,6325,724193028,DEBIT,0,active,2027-02-07,2022-01-02 06:39:38,712.97,out,554114.03
46933,1111068,195.161.0.240,1181.0,cash_out,-1,5179,724193028,DEBIT,1,active,2027-02-07,2022-02-20 00:39:55,712.91,bad,554114.03
46934,1227463,195.161.0.240,1181.0,cash_out,30,2342,724193028,DEBIT,0,active,2027-02-07,2022-02-26 09:47:22,712.91,transfer,553401.12
46935,1257202,213.151.0.195,1015.0,atm,20,4668,724193028,DEBIT,0,active,2027-02-07,2022-02-28 05:52:47,713.15,out,552687.97
46936,1265217,46.0.2.225,198.0,ATM,10,7899,724193028,DEBIT,0,active,2027-02-07,2022-03-16 20:11:32,713.22,in_acc,553401.19
46937,1431881,85.140.0.165,1264.0,atm,30,6684,724193028,DEBIT,0,active,2027-02-07,2022-04-13 23:13:21,713.16,transfer,552688.03
46938,1433546,188.0.189.105,840.0,pos trm,451,6325,724193028,DEBIT,0,active,2027-02-07,2022-04-29 19:32:22,713.05,payment,551974.98
46939,1479226,81.17.0.60,1388.0,cash_in,25,1406,724193028,DEBIT,0,active,2027-02-07,2022-05-01 09:59:27,713.02,country_transfer,551261.96
46940,1876276,81.17.0.60,1388.0,cash_in,451,1667,724193028,DEBIT,0,active,2027-02-07,2022-05-06 04:46:17,712.92,payment,550549.04
46941,2317090,188.0.169.0,467.0,atm,10,9451,724193028,DEBIT,0,active,2027-02-07,2022-05-30 22:12:13,712.97,in,551262.01
46942,2454670,37.0.124.90,727.0,atm,20,3542,724193028,DEBIT,0,active,2027-02-07,2022-06-05 19:13:24,713.04,from_acc,550548.97
46943,2507424,195.161.0.240,1181.0,cash_out,25,6684,724193028,DEBIT,0,active,2027-02-07,2022-06-11 05:24:15,712.86,country_transfer,549836.11
46944,2514028,46.0.123.180,926.0,port_trm,-1,6257,724193028,DEBIT,1,active,2027-02-07,2022-07-04 13:53:06,712.88,err_code,549836.11
46945,2670432,188.0.189.105,840.0,pos trm,451,3511,724193028,DEBIT,0,active,2027-02-07,2022-07-20 11:24:17,712.8,payment,549123.31
46946,2704259,195.161.0.240,1181.0,cash_out,451,5236,724193028,DEBIT,0,active,2027-02-07,2022-08-07 19:49:03,713.11,payment,548410.2
46947,2797285,46.0.123.180,926.0,port_trm,30,9348,724193028,DEBIT,0,active,2027-02-07,2022-08-19 09:26:33,713.06,transfer,547697.14
46948,2981631,85.140.0.165,1264.0,atm,451,1960,724193028,DEBIT,0,active,2027-02-07,2022-08-25 04:13:06,713.08,payment,546984.06
46949,3021367,195.161.0.240,1181.0,cash_out,30,1960,724193028,DEBIT,0,active,2027-02-07,2022-08-26 22:14:47,713.02,transfer,546271.04
46950,3277104,185.17.0.30,1044.0,ATM,10,8428,724193028,DEBIT,0,active,2027-02-07,2022-09-02 12:58:44,713.26,add_on_acc,546984.3
46951,3691710,151.0.38.45,391.0,pos trm,451,3542,724193028,DEBIT,0,active,2027-02-07,2022-09-03 21:15:22,713.16,payment,546271.14
46952,4102001,185.233.0.120,85.0,cash_out,451,7340,724193028,DEBIT,0,active,2027-02-07,2022-10-17 04:03:20,712.89,payment,545558.25
46953,4931652,151.0.38.45,391.0,pos trm,451,6257,724193028,DEBIT,0,active,2027-02-07,2022-11-09 18:29:37,713.17,payment,544845.08
46954,5022600,85.140.0.15,1247.0,atm,20,6235,724193028,DEBIT,0,active,2027-02-07,2022-12-07 11:15:27,712.88,out,544132.2
46955,5174092,185.233.0.120,85.0,cash_out,451,6325,724193028,DEBIT,0,active,2027-02-07,2023-01-26 02:51:54,713.03,payment,543419.17
46956,5262782,188.0.189.105,840.0,pos trm,-1,2218,724193028,DEBIT,1,active,2027-02-07,2023-03-18 07:12:00,713.14,err,543419.17
46957,5378961,188.0.189.105,840.0,pos trm,451,6684,724193028,DEBIT,0,active,2027-02-07,2023-04-22 07:43:09,712.86,payment,542706.31
46958,5420552,46.0.123.180,926.0,port_trm,30,1667,724193028,DEBIT,0,active,2027-02-07,2023-05-11 05:49:30,712.92,transfer,541993.39
46959,5432832,128.0.24.180,897.0,atm,10,9348,724193028,DEBIT,0,active,2027-02-07,2023-06-05 06:10:25,712.99,in,542706.38
46960,5627227,85.140.0.165,1264.0,atm,451,6235,724193028,DEBIT,0,active,2027-02-07,2023-06-07 23:31:29,712.93,payment,541993.45
46961,5647813,46.0.123.180,926.0,port_trm,451,7340,724193028,DEBIT,0,active,2027-02-07,2023-06-30 12:37:44,713.08,payment,541280.37
46962,5678374,195.161.0.240,1181.0,cash_out,30,9451,724193028,DEBIT,0,active,2027-02-07,2023-07-08 20:12:34,712.81,transfer,540567.56
46963,5858357,188.0.189.105,840.0,pos trm,30,4911,724193028,DEBIT,0,active,2027-02-07,2023-07-15 22:55:47,712.94,transfer,539854.62
46964,5869485,151.0.38.45,391.0,pos trm,451,2218,724193028,DEBIT,0,active,2027-02-07,2023-07-21 19:17:23,713.0,payment,539141.62
46965,5912485,185.233.0.120,85.0,cash_out,451,5179,724193028,DEBIT,0,active,2027-02-07,2023-10-03 10:41:21,713.17,payment,538428.45
46966,6175209,195.161.0.240,1181.0,cash_out,451,1003,724193028,DEBIT,0,active,2027-02-07,2023-10-05 05:53:03,712.92,payment,537715.53
46967,6321524,46.0.123.180,926.0,port_trm,-1,3511,724193028,DEBIT,1,active,2027-02-07,2023-10-16 21:12:57,713.02,err_code,537715.53
46968,6432821,195.161.0.240,1181.0,cash_out,451,2218,724193028,DEBIT,0,active,2027-02-07,2023-10-22 00:28:34,713.12,payment,537002.41
46969,6740863,151.0.38.45,391.0,pos trm,-1,6325,724193028,DEBIT,1,active,2027-02-07,2023-10-23 09:52:36,712.76,bad,537002.41
46970,7034658,95.106.0.15,542.0,atm,20,7340,724193028,DEBIT,0,active,2027-02-07,2023-11-15 18:04:00,713.15,decrease_on_acc,536289.26
46971,7091069,77.242.0.75,276.0,ATM,10,2342,724193028,DEBIT,0,active,2027-02-07,2024-02-19 03:48:59,712.72,add_on_acc,537001.98
46972,7121816,77.242.0.75,276.0,ATM,10,1960,724193028,DEBIT,0,active,2027-02-07,2024-03-11 15:39:44,713.15,in_acc,537715.13
46973,7151777,185.233.0.120,85.0,cash_out,25,3511,724193028,DEBIT,0,active,2027-02-07,2024-04-03 20:08:25,712.76,country_transfer,537002.37
46974,7582442,46.0.0.210,670.0,ATM,10,6235,724193028,DEBIT,0,active,2027-02-07,2024-04-30 05:37:50,712.79,in,537715.16
46975,7847307,185.233.0.120,85.0,cash_out,25,5316,724193028,DEBIT,0,active,2027-02-07,2024-05-08 20:39:42,713.07,diff_cntry,537002.09
46976,8130655,85.140.0.165,1264.0,atm,451,3511,724193028,DEBIT,0,active,2027-02-07,2024-05-24 22:07:15,713.02,payment,536289.07
46977,8210322,188.244.0.195,1467.0,atm,20,9451,724193028,DEBIT,0,active,2027-02-07,2024-06-03 00:39:47,712.89,from_acc,535576.18
46978,8299185,217.112.0.180,1486.0,cash_out,-1,2635,724193028,DEBIT,1,active,2027-02-07,2024-07-08 13:19:31,713.02,err_code,535576.18
46979,8439912,46.0.123.180,926.0,port_trm,30,3172,724193028,DEBIT,0,active,2027-02-07,2024-07-26 03:42:16,712.8,transfer,534863.38
46980,8768816,81.17.0.60,1388.0,cash_in,-1,3511,724193028,DEBIT,1,active,2027-02-07,2024-08-12 02:42:11,713.19,err_code,534863.38
46981,8845807,78.24.158.234,950.0,ATM,10,8428,724193028,DEBIT,0,active,2027-02-07,2024-09-09 12:48:39,713.24,in_acc,535576.62
46982,8887135,185.173.0.135,1282.0,cash_out,20,1406,724193028,DEBIT,0,active,2027-02-07,2024-09-20 02:46:30,712.81,out,534863.81
46983,9113939,188.0.189.105,840.0,pos trm,451,6325,724193028,DEBIT,0,active,2027-02-07,2024-10-17 13:23:51,712.79,payment,534151.02
46984,9639150,217.26.0.90,681.0,cash_out,20,9451,724193028,DEBIT,0,active,2027-02-07,2024-10-27 00:41:23,713.39,out,533437.63
46985,9895510,185.233.0.120,85.0,cash_out,30,6325,724193028,DEBIT,0,active,2027-02-07,2024-11-19 07:58:53,712.94,transfer,532724.69
46986,1120438,62.118.0.165,533.0,cash_out,451,1057,703497824,DEBIT,0,act,2026-05-05,2022-01-15 02:15:41,809.09,payment,127241.91
46987,1210916,194.0.162.135,749.0,port_trm,25,7436,703497824,DEBIT,0,act,2026-05-05,2022-02-22 16:41:27,809.2,country_transfer,126432.71
46988,1287991,94.243.0.135,108.0,cash_out,30,1057,703497824,DEBIT,0,act,2026-05-05,2022-03-03 05:52:44,808.93,transfer,125623.78
46989,1301519,151.0.0.0,10.0,Portable term,-1,9494,703497824,DEBIT,1,act,2026-05-05,2022-03-04 02:35:47,809.13,err_code,125623.78
46990,1570919,188.43.0.210,1421.0,ATM,10,8820,703497824,DEBIT,0,act,2026-05-05,2022-03-19 09:22:38,808.97,in_acc,126432.75
46991,1658034,5.189.0.180,871.0,ATM,20,9494,703497824,DEBIT,0,act,2026-05-05,2022-03-29 22:46:10,809.0,decrease_on_acc,125623.75
46992,2239552,46.0.123.150,924.0,Portable term,30,8756,703497824,DEBIT,0,act,2026-05-05,2022-05-02 05:52:46,808.83,transfer,124814.92
46993,2284205,31.134.0.195,1132.0,atm,20,9001,703497824,DEBIT,0,act,2026-05-05,2022-05-04 03:52:41,809.11,from_acc,124005.81
46994,2527230,94.243.0.135,108.0,cash_out,25,9494,703497824,DEBIT,0,act,2026-05-05,2022-05-12 13:46:32,809.24,diff_cntry,123196.57
46995,2561094,45.154.0.90,302.0,cash_in,10,6891,703497824,DEBIT,0,act,2026-05-05,2022-06-19 01:52:03,809.01,in,124005.58
46996,2653136,217.26.0.150,689.0,ATM,451,6917,703497824,DEBIT,0,act,2026-05-05,2022-06-25 20:14:34,808.99,payment,123196.59
46997,2758767,193.0.151.105,59.0,ATM,10,5601,703497824,DEBIT,0,act,2026-05-05,2022-08-21 08:05:12,808.79,add_on_acc,124005.38
46998,2911588,45.154.0.75,300.0,ATM,20,8756,703497824,DEBIT,0,act,2026-05-05,2022-09-04 16:18:17,809.09,from_acc,123196.29
46999,2962992,94.243.0.135,108.0,cash_out,30,2293,703497824,DEBIT,0,act,2026-05-05,2022-09-28 07:42:23,808.98,transfer,122387.31
47000,3027092,194.0.162.135,749.0,port_trm,451,8756,703497824,DEBIT,0,act,2026-05-05,2022-10-01 16:00:17,809.0,payment,121578.31
47001,3469290,94.243.0.135,108.0,cash_out,30,5700,703497824,DEBIT,0,act,2026-05-05,2022-10-03 04:47:57,809.02,transfer,120769.29
47002,3583844,86.111.0.150,1354.0,ATM,20,8756,703497824,DEBIT,0,act,2026-05-05,2022-10-05 13:02:44,808.93,from_acc,119960.36
47003,3738910,217.26.0.150,689.0,ATM,451,8560,703497824,DEBIT,0,act,2026-05-05,2022-10-09 18:16:12,808.78,payment,119151.58
47004,3945167,217.26.0.150,689.0,ATM,-1,9922,703497824,DEBIT,1,act,2026-05-05,2022-10-19 01:19:39,808.96,err_code,119151.58
47005,4102343,62.118.0.165,533.0,cash_out,-1,2293,703497824,DEBIT,2,act,2026-05-05,2022-11-01 22:46:42,808.96,err,119151.58
47006,4197799,94.243.0.135,108.0,cash_out,451,8820,703497824,DEBIT,0,act,2026-05-05,2022-12-10 11:04:35,809.19,payment,118342.39
47007,4199063,151.0.0.0,10.0,Portable term,25,6212,703497824,DEBIT,0,act,2026-05-05,2023-01-04 23:55:42,808.99,diff_cntry,117533.4
47008,4412662,37.0.123.0,318.0,ATM,20,6891,703497824,DEBIT,0,act,2026-05-05,2023-02-11 22:18:24,808.86,out,116724.54
47009,4743960,86.111.0.30,1345.0,cash_out,25,3409,703497824,DEBIT,0,act,2026-05-05,2023-02-28 21:32:41,808.75,country_transfer,115915.79
47010,4791176,86.111.0.30,1345.0,cash_out,25,6891,703497824,DEBIT,0,act,2026-05-05,2023-03-11 23:00:16,809.07,country_transfer,115106.72
47011,4913077,217.26.0.150,689.0,ATM,25,5236,703497824,DEBIT,0,act,2026-05-05,2023-03-18 01:17:12,809.1,country_transfer,114297.62
47012,4920686,151.0.0.0,10.0,Portable term,451,8820,703497824,DEBIT,0,act,2026-05-05,2023-04-14 04:37:05,809.24,payment,113488.38
47013,5115477,109.126.0.180,378.0,atm,20,5601,703497824,DEBIT,0,act,2026-05-05,2023-04-26 11:54:49,809.01,out,112679.37
47014,5202170,151.0.0.0,10.0,Portable term,-1,2293,703497824,DEBIT,1,act,2026-05-05,2023-05-04 07:39:21,809.0,err_code,112679.37
47015,6076459,62.118.0.165,533.0,cash_out,451,3409,703497824,DEBIT,0,act,2026-05-05,2023-07-26 00:07:18,808.88,payment,111870.49
47016,6194002,217.26.0.150,689.0,ATM,30,2293,703497824,DEBIT,0,act,2026-05-05,2023-07-26 16:01:24,809.22,transfer,111061.27
47017,6220980,151.0.0.0,10.0,Portable term,-1,7300,703497824,DEBIT,1,act,2026-05-05,2023-08-22 21:50:24,808.95,err_code,111061.27
47018,6222800,95.106.0.150,557.0,cash_in,10,5582,703497824,DEBIT,0,act,2026-05-05,2023-09-08 16:38:12,809.1,in,111870.37
47019,6265660,151.0.0.0,10.0,Portable term,25,2406,703497824,DEBIT,0,act,2026-05-05,2023-10-08 23:24:11,809.0,diff_cntry,111061.37
47020,6394527,217.26.0.150,689.0,ATM,451,8560,703497824,DEBIT,0,act,2026-05-05,2023-10-17 00:06:00,809.11,payment,110252.26
47021,6515114,46.0.128.225,716.0,ATM,20,1689,703497824,DEBIT,0,act,2026-05-05,2023-11-05 12:32:48,808.98,from_acc,109443.28
47022,6701853,94.243.0.135,108.0,cash_out,-1,8756,703497824,DEBIT,1,act,2026-05-05,2023-11-10 12:23:43,808.77,err_code,109443.28
47023,6968326,85.140.0.90,1255.0,ATM,10,9001,703497824,DEBIT,0,act,2026-05-05,2024-01-31 12:59:32,808.92,in,110252.2
47024,7039246,134.0.98.0,790.0,atm,20,5497,703497824,DEBIT,0,act,2026-05-05,2024-02-08 00:03:48,808.96,from_acc,109443.24
47025,7173143,62.118.0.165,533.0,cash_out,451,1117,703497824,DEBIT,0,act,2026-05-05,2024-03-02 16:06:17,808.81,payment,108634.43
47026,7239993,194.0.162.135,749.0,port_trm,-1,5236,703497824,DEBIT,1,act,2026-05-05,2024-04-01 11:08:54,808.93,bad,108634.43
47027,7244850,217.26.0.150,689.0,ATM,25,1689,703497824,DEBIT,0,act,2026-05-05,2024-04-14 17:56:45,808.93,country_transfer,107825.5
47028,7426196,151.0.0.0,10.0,Portable term,-1,9494,703497824,DEBIT,1,act,2026-05-05,2024-04-23 05:20:17,808.99,err,107825.5
47029,8181294,193.0.151.180,68.0,atm,10,9922,703497824,DEBIT,0,act,2026-05-05,2024-05-16 17:00:47,809.02,add_on_acc,108634.52
47030,8245203,86.111.0.30,1345.0,cash_out,30,5700,703497824,DEBIT,0,act,2026-05-05,2024-05-27 15:14:19,808.97,transfer,107825.55
47031,8435432,194.0.144.30,160.0,atm,10,2468,703497824,DEBIT,0,act,2026-05-05,2024-06-16 05:21:36,809.04,in_acc,108634.59
47032,8665548,46.0.123.150,924.0,Portable term,25,2406,703497824,DEBIT,0,act,2026-05-05,2024-07-15 03:55:39,808.85,country_transfer,107825.74
47033,8714597,86.111.0.30,1345.0,cash_out,451,9922,703497824,DEBIT,0,act,2026-05-05,2024-07-16 20:00:17,808.99,payment,107016.75
47034,8858096,86.111.0.30,1345.0,cash_out,30,8756,703497824,DEBIT,0,act,2026-05-05,2024-08-25 22:49:22,809.11,transfer,106207.64
47035,8880605,94.243.0.135,108.0,cash_out,30,5623,703497824,DEBIT,0,act,2026-05-05,2024-09-02 11:40:08,808.99,transfer,105398.65
47036,8945875,212.20.0.75,454.0,cash_in,10,1057,703497824,DEBIT,0,act,2026-05-05,2024-09-28 21:50:42,808.98,add_on_acc,106207.63
47037,9021237,78.24.158.234,950.0,ATM,10,9001,703497824,DEBIT,0,act,2026-05-05,2024-10-24 09:31:35,809.06,in_acc,107016.69
47038,9230047,62.118.0.165,533.0,cash_out,25,5582,703497824,DEBIT,0,act,2026-05-05,2024-11-01 23:53:17,809.17,diff_cntry,106207.52
47039,9795518,94.243.0.135,108.0,cash_out,-1,8756,703497824,DEBIT,1,act,2026-05-05,2024-11-27 04:08:59,809.09,err_code,106207.52
47040,1291480,46.0.0.240,673.0,ATM,10,6250,301324542,DEBIT,0,active,2028-09-11,2022-01-08 01:06:35,1034.09,add_on_acc,170737.09
47041,2050814,188.162.0.120,962.0,ATM,30,1344,301324542,DEBIT,0,active,2028-09-11,2022-01-13 15:45:24,1033.93,transfer,169703.16
47042,2094418,213.151.0.30,998.0,ATM,10,1344,301324542,DEBIT,0,active,2028-09-11,2022-01-29 13:13:18,1033.97,in_acc,170737.13
47043,2095289,46.0.143.225,829.0,Portable term,25,2463,301324542,DEBIT,0,active,2028-09-11,2022-02-14 18:11:53,1034.05,diff_cntry,169703.08
47044,2121595,188.0.0.165,1217.0,ATM,10,4734,301324542,DEBIT,0,active,2028-09-11,2022-02-21 19:22:12,1033.89,in_acc,170736.97
47045,2468364,46.0.143.225,829.0,Portable term,25,1902,301324542,DEBIT,0,active,2028-09-11,2022-03-09 04:48:34,1034.08,diff_cntry,169702.89
47046,2775244,45.154.0.60,299.0,cash_in,10,3556,301324542,DEBIT,0,active,2028-09-11,2022-03-29 21:39:29,1034.21,add_on_acc,170737.1
47047,2873061,128.0.24.105,890.0,prtbl trm,25,3045,301324542,DEBIT,0,active,2028-09-11,2022-04-01 14:06:48,1033.87,diff_cntry,169703.23
47048,3070008,37.0.124.0,719.0,port_trm,25,9355,301324542,DEBIT,0,active,2028-09-11,2022-05-03 17:30:52,1034.11,country_transfer,168669.12
47049,3080214,217.112.0.0,1471.0,ATM,20,2646,301324542,DEBIT,0,active,2028-09-11,2022-05-28 19:19:00,1033.85,out,167635.27
47050,3253085,37.0.127.210,1037.0,ATM,10,3556,301324542,DEBIT,0,active,2028-09-11,2022-06-03 12:07:51,1033.87,in,168669.14
47051,3852776,46.0.143.225,829.0,Portable term,-1,9264,301324542,DEBIT,1,active,2028-09-11,2022-06-12 08:45:40,1033.89,err_code,168669.14
47052,3983395,109.126.0.180,378.0,atm,20,1344,301324542,DEBIT,0,active,2028-09-11,2022-07-01 18:56:27,1033.92,out,167635.22
47053,4187290,86.111.0.165,1355.0,prtbl trm,25,8546,301324542,DEBIT,0,active,2028-09-11,2022-07-11 18:30:18,1034.08,country_transfer,166601.14
47054,4406238,46.0.0.30,656.0,cash_out,20,6250,301324542,DEBIT,0,active,2028-09-11,2022-07-14 01:24:31,1034.0,decrease_on_acc,165567.14
47055,4488670,194.87.0.90,572.0,atm,-1,4734,301324542,DEBIT,1,active,2028-09-11,2022-07-26 06:01:39,1034.21,err_code,165567.14
47056,4542871,78.24.158.234,950.0,ATM,20,9264,301324542,DEBIT,0,active,2028-09-11,2022-07-27 20:10:57,1033.77,from_acc,164533.37
47057,4862137,37.0.124.0,719.0,port_trm,451,8546,301324542,DEBIT,0,active,2028-09-11,2022-08-05 15:20:57,1034.1,payment,163499.27
47058,5051905,46.0.188.45,1231.0,cash_out,20,2463,301324542,DEBIT,0,active,2028-09-11,2022-08-21 14:20:55,1033.92,out,162465.35
47059,5192415,46.0.54.240,1093.0,atm,20,2646,301324542,DEBIT,0,active,2028-09-11,2022-09-22 14:22:26,1033.96,out,161431.39
47060,5203674,86.111.0.165,1355.0,prtbl trm,451,9890,301324542,DEBIT,0,active,2028-09-11,2022-10-08 06:07:15,1033.96,payment,160397.43
47061,5245668,46.0.143.225,829.0,Portable term,30,3556,301324542,DEBIT,0,active,2028-09-11,2022-11-04 23:15:46,1033.82,transfer,159363.61
47062,5487374,37.0.124.0,719.0,port_trm,25,2463,301324542,DEBIT,0,active,2028-09-11,2023-01-19 12:58:44,1034.08,country_transfer,158329.53
47063,5619035,45.154.0.210,314.0,atm,20,8546,301324542,DEBIT,0,active,2028-09-11,2023-02-05 00:16:40,1034.04,from_acc,157295.49
47064,5662928,46.0.128.195,714.0,cash_out,20,7173,301324542,DEBIT,0,active,2028-09-11,2023-03-18 11:44:57,1034.12,decrease_on_acc,156261.37
47065,5695908,188.0.166.225,1315.0,atm,20,2463,301324542,DEBIT,0,active,2028-09-11,2023-03-22 02:02:06,1033.83,decrease_on_acc,155227.54
47066,5830661,128.0.24.105,890.0,prtbl trm,25,1902,301324542,DEBIT,0,active,2028-09-11,2023-03-26 04:10:05,1033.95,country_transfer,154193.59
47067,6251782,37.0.124.0,719.0,port_trm,451,1634,301324542,DEBIT,0,active,2028-09-11,2023-04-16 03:07:56,1033.92,payment,153159.67
47068,6344828,37.0.124.0,719.0,port_trm,30,4734,301324542,DEBIT,0,active,2028-09-11,2023-04-29 16:25:29,1033.95,transfer,152125.72
47069,6666386,151.0.38.75,393.0,cash_in,10,2646,301324542,DEBIT,0,active,2028-09-11,2023-05-18 07:44:10,1034.05,in,153159.77
47070,6738315,37.0.124.0,719.0,port_trm,451,1634,301324542,DEBIT,0,active,2028-09-11,2023-05-24 03:16:36,1033.98,payment,152125.79
47071,6909512,128.0.24.105,890.0,prtbl trm,30,3556,301324542,DEBIT,0,active,2028-09-11,2023-06-25 20:58:59,1033.82,transfer,151091.97
47072,7506407,194.87.0.90,572.0,atm,25,9264,301324542,DEBIT,0,active,2028-09-11,2023-06-27 06:26:18,1033.97,diff_cntry,150058.0
47073,7548711,46.0.143.225,829.0,Portable term,25,2066,301324542,DEBIT,0,active,2028-09-11,2023-08-11 01:17:26,1034.09,country_transfer,149023.91
47074,7594009,46.0.143.225,829.0,Portable term,451,2463,301324542,DEBIT,0,active,2028-09-11,2023-11-27 09:01:03,1033.89,payment,147990.02
47075,7825925,37.0.124.0,719.0,port_trm,-1,9264,301324542,DEBIT,1,active,2028-09-11,2024-01-01 01:03:45,1033.73,err_code,147990.02
47076,7933906,195.161.0.225,1180.0,cash_in,10,9890,301324542,DEBIT,0,active,2028-09-11,2024-01-07 07:11:52,1034.05,in_acc,149024.07
47077,8028879,46.0.143.225,829.0,Portable term,451,2646,301324542,DEBIT,0,active,2028-09-11,2024-02-22 12:43:30,1034.08,payment,147989.99
47078,8185719,46.0.143.225,829.0,Portable term,25,3511,301324542,DEBIT,0,active,2028-09-11,2024-02-28 13:21:55,1033.97,country_transfer,146956.02
47079,8210522,195.58.0.105,1434.0,ATM,10,3511,301324542,DEBIT,0,active,2028-09-11,2024-04-15 01:38:00,1033.95,in_acc,147989.97
47080,8287084,128.0.24.105,890.0,prtbl trm,451,1344,301324542,DEBIT,0,active,2028-09-11,2024-05-28 10:40:15,1034.05,payment,146955.92
47081,8791109,46.0.54.210,1090.0,atm,20,9355,301324542,DEBIT,0,active,2028-09-11,2024-06-01 19:22:46,1033.96,out,145921.96
47082,8992388,86.111.0.165,1355.0,prtbl trm,451,9264,301324542,DEBIT,0,active,2028-09-11,2024-07-02 10:49:44,1033.96,payment,144888.0
47083,9072373,37.0.124.0,719.0,port_trm,451,4734,301324542,DEBIT,0,active,2028-09-11,2024-07-09 18:04:15,1033.9,payment,143854.1
47084,9109481,46.0.143.225,829.0,Portable term,25,8546,301324542,DEBIT,0,active,2028-09-11,2024-07-18 14:44:06,1034.03,diff_cntry,142820.07
47085,9242222,194.87.0.90,572.0,atm,30,8546,301324542,DEBIT,0,active,2028-09-11,2024-08-04 01:45:18,1034.06,transfer,141786.01
47086,9381792,188.162.0.120,962.0,ATM,25,3556,301324542,DEBIT,0,active,2028-09-11,2024-08-11 18:41:57,1033.78,diff_cntry,140752.23
47087,9551861,128.0.24.105,890.0,prtbl trm,30,2066,301324542,DEBIT,0,active,2028-09-11,2024-08-19 07:51:09,1034.11,transfer,139718.12
47088,9670536,212.20.0.225,465.0,atm,20,9355,301324542,DEBIT,0,active,2028-09-11,2024-09-02 15:08:17,1033.89,from_acc,138684.23
47089,9770678,86.111.0.165,1355.0,prtbl trm,-1,7290,301324542,DEBIT,1,active,2028-09-11,2024-09-04 18:55:59,1034.05,err,138684.23
47090,9804341,86.111.0.165,1355.0,prtbl trm,30,6250,301324542,DEBIT,0,active,2028-09-11,2024-09-09 05:16:20,1034.21,transfer,137650.02
47091,9989339,46.0.143.225,829.0,Portable term,30,3045,301324542,DEBIT,0,active,2028-09-11,2024-11-14 12:39:27,1033.89,transfer,136616.13
47092,1206811,46.0.143.15,811.0,atm,20,6112,584035289,CREDIT,0,active,2026-10-18,2022-01-01 01:28:58,1034.08,decrease_on_acc,459780.92
47093,1484989,37.0.123.105,328.0,ATM,451,4285,584035289,CREDIT,0,active,2026-10-18,2022-01-15 03:38:26,1034.14,payment,458746.78
47094,1564115,188.244.0.15,1449.0,ATM,451,7590,584035289,CREDIT,0,active,2026-10-18,2022-02-11 08:08:35,1033.92,payment,457712.86
47095,1769094,188.162.0.105,961.0,prtbl trm,451,7752,584035289,CREDIT,0,active,2026-10-18,2022-03-07 17:34:38,1033.95,payment,456678.91
47096,1777935,188.162.0.105,961.0,prtbl trm,30,8367,584035289,CREDIT,0,active,2026-10-18,2022-03-22 08:46:39,1034.19,transfer,455644.72
47097,1795705,46.0.0.150,665.0,cash_out,451,2811,584035289,CREDIT,0,active,2026-10-18,2022-03-24 08:06:09,1033.96,payment,454610.76
47098,1817799,188.162.0.105,961.0,prtbl trm,451,2865,584035289,CREDIT,0,active,2026-10-18,2022-04-18 23:40:27,1034.02,payment,453576.74
47099,2348374,193.0.151.150,64.0,ATM,20,5590,584035289,CREDIT,0,active,2026-10-18,2022-04-20 12:16:47,1034.19,out,452542.55
47100,2462744,37.0.123.105,328.0,ATM,25,8308,584035289,CREDIT,0,active,2026-10-18,2022-04-24 05:22:07,1034.27,diff_cntry,451508.28
47101,2534683,46.0.2.0,180.0,atm,451,8948,584035289,CREDIT,0,active,2026-10-18,2022-04-26 08:49:57,1034.11,payment,450474.17
47102,2541859,46.0.9.165,1328.0,port_trm,451,5408,584035289,CREDIT,0,active,2026-10-18,2022-05-22 22:36:03,1033.96,payment,449440.21
47103,3146866,188.0.0.60,1210.0,ATM,30,8948,584035289,CREDIT,0,active,2026-10-18,2022-05-31 13:01:07,1033.99,transfer,448406.22
47104,3285538,37.0.123.105,328.0,ATM,-1,8100,584035289,CREDIT,1,active,2026-10-18,2022-06-12 03:35:53,1033.95,err,448406.22
47105,3578528,46.0.9.165,1328.0,port_trm,451,1473,584035289,CREDIT,0,active,2026-10-18,2022-07-03 06:29:33,1034.13,payment,447372.09
47106,3695548,188.162.0.105,961.0,prtbl trm,30,1473,584035289,CREDIT,0,active,2026-10-18,2022-08-03 09:14:31,1033.97,transfer,446338.12
47107,3769139,188.162.0.105,961.0,prtbl trm,25,5360,584035289,CREDIT,0,active,2026-10-18,2022-10-24 13:17:26,1034.02,diff_cntry,445304.1
47108,3852629,95.167.0.135,211.0,ATM,451,7100,584035289,CREDIT,0,active,2026-10-18,2022-10-28 02:49:44,1034.07,payment,444270.03
47109,3863965,37.0.123.105,328.0,ATM,30,9517,584035289,CREDIT,0,active,2026-10-18,2022-12-01 17:04:10,1034.2,transfer,443235.83
47110,3946982,193.31.0.135,599.0,ATM,10,2865,584035289,CREDIT,0,active,2026-10-18,2023-01-30 10:35:42,1033.93,in_acc,444269.76
47111,4455283,95.167.0.135,211.0,ATM,-1,6511,584035289,CREDIT,1,active,2026-10-18,2023-02-25 06:10:48,1034.02,err_code,444269.76
47112,4798305,188.244.0.15,1449.0,ATM,451,7752,584035289,CREDIT,0,active,2026-10-18,2023-02-28 02:17:59,1033.88,payment,443235.88
47113,4849722,77.242.0.105,279.0,cash_out,20,1498,584035289,CREDIT,0,active,2026-10-18,2023-05-20 11:34:14,1033.69,decrease_on_acc,442202.19
47114,5997302,46.0.0.150,665.0,cash_out,30,8308,584035289,CREDIT,0,active,2026-10-18,2023-06-09 09:04:58,1033.87,transfer,441168.32
47115,6144586,46.0.2.0,180.0,atm,25,9483,584035289,CREDIT,0,active,2026-10-18,2023-08-04 23:01:32,1033.94,diff_cntry,440134.38
47116,6223402,188.244.0.15,1449.0,ATM,25,6480,584035289,CREDIT,0,active,2026-10-18,2023-08-23 01:02:51,1034.02,diff_cntry,439100.36
47117,6449563,37.0.127.30,1023.0,cash_out,20,8308,584035289,CREDIT,0,active,2026-10-18,2023-09-08 12:35:02,1033.93,from_acc,438066.43
47118,6631099,188.0.0.60,1210.0,ATM,451,3476,584035289,CREDIT,0,active,2026-10-18,2023-09-23 06:34:19,1033.76,payment,437032.67
47119,6885290,46.0.176.150,128.0,atm,20,4439,584035289,CREDIT,0,active,2026-10-18,2023-09-30 18:17:39,1033.97,from_acc,435998.7
47120,6887495,46.0.0.150,665.0,cash_out,451,6480,584035289,CREDIT,0,active,2026-10-18,2023-10-08 19:18:11,1033.98,payment,434964.72
47121,7002264,46.0.2.0,180.0,atm,451,4439,584035289,CREDIT,0,active,2026-10-18,2023-12-19 21:43:16,1034.09,payment,433930.63
47122,7389015,188.244.0.15,1449.0,ATM,451,1498,584035289,CREDIT,0,active,2026-10-18,2023-12-20 04:41:55,1033.85,payment,432896.78
47123,7479128,46.0.54.75,1075.0,ATM,10,6112,584035289,CREDIT,0,active,2026-10-18,2023-12-21 18:00:09,1033.95,add_on_acc,433930.73
47124,7533834,46.0.0.150,665.0,cash_out,451,1498,584035289,CREDIT,0,active,2026-10-18,2024-01-17 05:26:03,1034.13,payment,432896.6
47125,7560592,188.162.0.105,961.0,prtbl trm,25,8100,584035289,CREDIT,0,active,2026-10-18,2024-02-03 07:35:53,1034.4,diff_cntry,431862.2
47126,7820114,46.0.2.0,180.0,atm,451,3404,584035289,CREDIT,0,active,2026-10-18,2024-03-16 15:19:58,1033.99,payment,430828.21
47127,7956533,79.104.60.225,443.0,cash_out,451,6648,584035289,CREDIT,0,active,2026-10-18,2024-03-30 11:13:17,1034.16,payment,429794.05
47128,8081620,46.0.54.225,1092.0,cash_in,10,4439,584035289,CREDIT,0,active,2026-10-18,2024-04-16 09:22:56,1033.93,in_acc,430827.98
47129,8096866,95.167.0.135,211.0,ATM,451,5360,584035289,CREDIT,0,active,2026-10-18,2024-04-16 15:35:52,1034.06,payment,429793.92
47130,8182400,79.104.60.225,443.0,cash_out,451,7590,584035289,CREDIT,0,active,2026-10-18,2024-05-05 18:39:30,1033.98,payment,428759.94
47131,8284461,188.18.0.0,220.0,atm,10,1473,584035289,CREDIT,0,active,2026-10-18,2024-05-16 00:05:33,1033.68,in,429793.62
47132,8355660,46.0.9.165,1328.0,port_trm,451,1833,584035289,CREDIT,0,active,2026-10-18,2024-05-24 10:23:26,1033.96,payment,428759.66
47133,8449666,81.17.0.105,1391.0,cash_out,20,8367,584035289,CREDIT,0,active,2026-10-18,2024-06-03 09:25:25,1033.83,out,427725.83
47134,8455208,46.0.9.165,1328.0,port_trm,30,3476,584035289,CREDIT,0,active,2026-10-18,2024-06-17 12:01:49,1034.12,transfer,426691.71
47135,8668030,195.58.0.135,1436.0,atm,20,2811,584035289,CREDIT,0,active,2026-10-18,2024-07-20 12:07:44,1033.97,out,425657.74
47136,8729619,37.0.123.105,328.0,ATM,30,8367,584035289,CREDIT,0,active,2026-10-18,2024-08-05 01:01:57,1034.09,transfer,424623.65
47137,8823570,46.0.0.150,665.0,cash_out,451,4996,584035289,CREDIT,0,active,2026-10-18,2024-08-07 09:13:16,1034.06,payment,423589.59
47138,9240734,188.0.0.60,1210.0,ATM,-1,6480,584035289,CREDIT,1,active,2026-10-18,2024-08-08 04:10:16,1034.35,bad,423589.59
47139,9447787,46.0.8.225,155.0,cash_in,10,8367,584035289,CREDIT,0,active,2026-10-18,2024-09-05 03:30:52,1034.01,in_acc,424623.6
47140,9592751,46.0.0.150,665.0,cash_out,30,8308,584035289,CREDIT,0,active,2026-10-18,2024-09-21 22:24:47,1033.89,transfer,423589.71
47141,9638328,188.0.0.60,1210.0,ATM,451,5360,584035289,CREDIT,0,active,2026-10-18,2024-10-03 20:14:49,1033.98,payment,422555.73
47142,9774801,188.0.0.60,1210.0,ATM,25,9869,584035289,CREDIT,0,active,2026-10-18,2024-11-24 15:58:11,1033.81,country_transfer,421521.92
47143,1073094,78.24.158.129,942.0,ATM,10,8322,517195670,DEBIT,0,act,2027-07-06,2022-02-06 08:52:54,846.95,add_on_acc,938492.95
47144,1156529,78.24.158.159,944.0,cash_out,20,1948,517195670,DEBIT,0,act,2027-07-06,2022-02-08 15:50:19,847.13,out,937645.82
47145,1264997,195.161.0.105,1170.0,atm,10,6218,517195670,DEBIT,0,act,2027-07-06,2022-03-06 11:34:40,847.05,in_acc,938492.87
47146,1303843,31.134.0.195,1132.0,atm,10,3437,517195670,DEBIT,0,act,2027-07-06,2022-03-14 03:07:43,846.99,in_acc,939339.86
47147,1332464,37.0.127.105,1029.0,atm,10,4986,517195670,DEBIT,0,act,2027-07-06,2022-06-07 05:21:53,846.95,add_on_acc,940186.81
47148,1404224,194.156.0.105,29.0,ATM,10,9567,517195670,DEBIT,0,act,2027-07-06,2022-06-21 20:59:59,847.17,in_acc,941033.98
47149,1791572,46.0.143.105,819.0,cash_out,-1,5089,517195670,DEBIT,1,act,2027-07-06,2022-06-30 06:58:03,847.08,err_code,941033.98
47150,1804005,217.26.0.180,693.0,port_trm,25,5089,517195670,DEBIT,0,act,2027-07-06,2022-07-08 04:13:15,847.06,country_transfer,940186.92
47151,1881856,91.107.0.150,988.0,pos trm,451,9010,517195670,DEBIT,0,act,2027-07-06,2022-07-17 17:23:10,847.08,payment,939339.84
47152,1958209,46.0.123.0,909.0,cash_out,20,6218,517195670,DEBIT,0,act,2027-07-06,2022-08-18 15:54:53,846.86,decrease_on_acc,938492.98
47153,2023611,185.17.0.105,1053.0,cash_in,10,5089,517195670,DEBIT,0,act,2027-07-06,2022-09-07 06:10:03,847.19,add_on_acc,939340.17
47154,2131464,46.0.54.15,1069.0,cash_in,25,3916,517195670,DEBIT,0,act,2027-07-06,2022-11-06 06:28:23,846.78,country_transfer,938493.39
47155,2197709,217.26.0.180,693.0,port_trm,451,1902,517195670,DEBIT,0,act,2027-07-06,2022-12-15 07:23:35,847.16,payment,937646.23
47156,2224053,46.0.143.105,819.0,cash_out,25,9567,517195670,DEBIT,0,act,2027-07-06,2022-12-15 19:24:37,847.46,country_transfer,936798.77
47157,2883492,188.0.169.0,467.0,atm,20,6060,517195670,DEBIT,0,act,2027-07-06,2022-12-18 04:20:35,847.36,out,935951.41
47158,3034544,46.0.143.105,819.0,cash_out,30,9010,517195670,DEBIT,0,act,2027-07-06,2022-12-29 06:34:17,846.94,transfer,935104.47
47159,3181961,194.0.162.120,748.0,cash_in,10,8322,517195670,DEBIT,0,act,2027-07-06,2023-01-01 20:08:30,847.09,in,935951.56
47160,3192872,37.0.123.120,329.0,cash_in,-1,9644,517195670,DEBIT,1,act,2027-07-06,2023-01-15 15:08:27,846.67,err,935951.56
47161,3337844,217.26.0.180,693.0,port_trm,451,7244,517195670,DEBIT,0,act,2027-07-06,2023-05-28 18:21:44,847.15,payment,935104.41
47162,3349436,128.0.24.60,885.0,pos trm,-1,6081,517195670,DEBIT,1,act,2027-07-06,2023-05-30 09:44:52,846.75,bad,935104.41
47163,3386614,46.0.0.135,664.0,cash_out,20,8482,517195670,DEBIT,0,act,2027-07-06,2023-06-05 12:38:08,847.07,from_acc,934257.34
47164,3693878,37.0.124.105,728.0,cash_in,10,3916,517195670,DEBIT,0,act,2027-07-06,2023-06-29 10:30:37,846.67,in,935104.01
47165,3995864,37.0.123.120,329.0,cash_in,451,3916,517195670,DEBIT,0,act,2027-07-06,2023-08-01 17:35:43,847.13,payment,934256.88
47166,4088410,217.26.0.180,693.0,port_trm,451,6218,517195670,DEBIT,0,act,2027-07-06,2023-08-18 18:10:01,847.16,payment,933409.72
47167,4108225,37.0.123.120,329.0,cash_in,-1,3916,517195670,DEBIT,1,act,2027-07-06,2023-09-06 01:49:05,846.84,err_code,933409.72
47168,5154974,188.128.16.211,1201.0,ATM,451,8364,517195670,DEBIT,0,act,2027-07-06,2023-10-10 10:41:16,846.88,payment,932562.84
47169,5483935,128.0.24.60,885.0,pos trm,451,8322,517195670,DEBIT,0,act,2027-07-06,2023-10-19 10:20:38,847.24,payment,931715.6
47170,5758831,46.0.143.105,819.0,cash_out,25,4986,517195670,DEBIT,0,act,2027-07-06,2023-10-23 10:17:18,847.06,diff_cntry,930868.54
47171,6050453,217.26.0.15,675.0,cash_out,20,9010,517195670,DEBIT,0,act,2027-07-06,2023-10-29 02:19:11,847.12,from_acc,930021.42
47172,6148154,188.0.166.45,1300.0,port_trm,451,1902,517195670,DEBIT,0,act,2027-07-06,2023-11-04 21:37:27,846.97,payment,929174.45
47173,6321466,188.128.16.211,1201.0,ATM,25,1948,517195670,DEBIT,0,act,2027-07-06,2023-11-05 16:17:30,846.98,diff_cntry,928327.47
47174,6541040,46.0.143.105,819.0,cash_out,30,6081,517195670,DEBIT,0,act,2027-07-06,2023-11-11 02:21:03,847.12,transfer,927480.35
47175,6607623,128.0.24.60,885.0,pos trm,451,3916,517195670,DEBIT,0,act,2027-07-06,2023-11-21 01:56:06,846.77,payment,926633.58
47176,6751336,62.118.0.120,530.0,ATM,20,8364,517195670,DEBIT,0,act,2027-07-06,2023-11-21 03:35:59,847.0,out,925786.58
47177,7154379,188.128.16.211,1201.0,ATM,-1,8364,517195670,DEBIT,1,act,2027-07-06,2023-12-19 22:53:08,847.05,bad,925786.58
47178,7399435,91.107.0.150,988.0,pos trm,25,9567,517195670,DEBIT,0,act,2027-07-06,2024-01-30 07:10:12,846.65,country_transfer,924939.93
47179,7646883,151.0.38.75,393.0,cash_in,10,1902,517195670,DEBIT,0,act,2027-07-06,2024-02-25 01:25:08,847.04,in,925786.97
47180,7819383,37.0.123.120,329.0,cash_in,30,9010,517195670,DEBIT,0,act,2027-07-06,2024-03-09 22:44:20,846.89,transfer,924940.08
47181,7847751,46.0.143.105,819.0,cash_out,-1,8364,517195670,DEBIT,1,act,2027-07-06,2024-03-26 18:14:00,846.76,err,924940.08
47182,7987842,46.0.9.120,1325.0,ATM,10,1948,517195670,DEBIT,0,act,2027-07-06,2024-04-25 14:07:47,847.0,in_acc,925787.08
47183,8401900,217.26.0.180,693.0,port_trm,451,5089,517195670,DEBIT,0,act,2027-07-06,2024-05-04 16:06:57,846.85,payment,924940.23
47184,8503729,213.151.0.120,1009.0,ATM,20,6081,517195670,DEBIT,0,act,2027-07-06,2024-05-11 08:24:42,846.99,out,924093.24
47185,8509678,46.0.54.15,1069.0,cash_in,30,3437,517195670,DEBIT,0,act,2027-07-06,2024-05-31 15:17:19,847.2,transfer,923246.04
47186,8679430,91.107.0.150,988.0,pos trm,25,5089,517195670,DEBIT,0,act,2027-07-06,2024-06-22 17:32:32,847.12,diff_cntry,922398.92
47187,8683869,128.0.24.60,885.0,pos trm,25,6218,517195670,DEBIT,0,act,2027-07-06,2024-06-30 15:23:09,846.96,country_transfer,921551.96
47188,8939472,188.0.0.165,1217.0,ATM,10,9010,517195670,DEBIT,0,act,2027-07-06,2024-07-22 03:12:51,847.16,in_acc,922399.12
47189,9351118,94.243.0.240,116.0,atm,10,5089,517195670,DEBIT,0,act,2027-07-06,2024-08-05 20:57:39,847.13,in,923246.25
47190,9390873,37.0.123.120,329.0,cash_in,-1,6060,517195670,DEBIT,1,act,2027-07-06,2024-08-11 00:39:17,847.35,err_code,923246.25
47191,9480346,188.128.16.211,1201.0,ATM,451,6218,517195670,DEBIT,0,act,2027-07-06,2024-09-11 20:00:59,847.0,payment,922399.25
47192,9499786,37.0.123.120,329.0,cash_in,451,8293,517195670,DEBIT,0,act,2027-07-06,2024-09-12 23:49:01,846.85,payment,921552.4
47193,9506676,37.0.123.120,329.0,cash_in,30,4986,517195670,DEBIT,0,act,2027-07-06,2024-10-19 17:17:53,846.95,transfer,920705.45
47194,9890608,128.0.24.30,882.0,atm,10,5089,517195670,DEBIT,0,act,2027-07-06,2024-10-29 00:47:49,846.95,in,921552.4
47195,1030159,185.173.0.150,1283.0,cash_out,30,6404,412833308,DEBIT,0,act,2029-10-22,2022-01-14 04:55:17,1110.02,transfer,750901.98
47196,1057035,46.173.0.105,502.0,atm,10,6019,412833308,DEBIT,0,act,2029-10-22,2022-02-08 16:32:39,1109.87,add_on_acc,752011.85
47197,1224164,188.0.189.105,840.0,pos trm,30,4661,412833308,DEBIT,0,act,2029-10-22,2022-02-13 07:59:58,1110.05,transfer,750901.8
47198,1691224,95.181.0.210,263.0,pos trm,30,9885,412833308,DEBIT,0,act,2029-10-22,2022-02-15 02:01:33,1110.12,transfer,749791.68
47199,1738206,213.151.0.195,1015.0,atm,-1,1494,412833308,DEBIT,1,act,2029-10-22,2022-03-17 11:25:08,1110.35,err_code,749791.68
47200,1821693,213.151.0.195,1015.0,atm,451,6404,412833308,DEBIT,0,act,2029-10-22,2022-04-17 22:30:08,1110.28,payment,748681.4
47201,1834012,188.0.166.135,1308.0,pos trm,-1,7153,412833308,DEBIT,1,act,2029-10-22,2022-05-09 15:38:04,1109.92,err,748681.4
47202,2027631,95.181.0.210,263.0,pos trm,451,1894,412833308,DEBIT,0,act,2029-10-22,2022-06-12 17:31:26,1110.21,payment,747571.19
47203,2042097,213.151.0.195,1015.0,atm,-1,9989,412833308,DEBIT,1,act,2029-10-22,2022-06-25 16:57:49,1110.11,bad,747571.19
47204,2089500,213.151.0.195,1015.0,atm,451,1494,412833308,DEBIT,0,act,2029-10-22,2022-07-23 08:56:56,1110.08,payment,746461.11
47205,2307938,188.0.189.105,840.0,pos trm,30,2583,412833308,DEBIT,0,act,2029-10-22,2022-08-05 21:56:20,1110.13,transfer,745350.98
47206,2309746,95.181.0.135,257.0,cash_in,10,6991,412833308,DEBIT,0,act,2029-10-22,2022-08-05 23:07:02,1110.05,in_acc,746461.03
47207,2373132,188.0.166.135,1308.0,pos trm,451,4522,412833308,DEBIT,0,act,2029-10-22,2022-09-10 16:49:32,1110.31,payment,745350.72
47208,3258309,212.20.0.225,465.0,atm,10,7332,412833308,DEBIT,0,act,2029-10-22,2022-09-11 01:50:41,1110.0,in_acc,746460.72
47209,3536597,213.151.0.195,1015.0,atm,-1,7153,412833308,DEBIT,1,act,2029-10-22,2022-09-25 09:40:19,1109.56,err,746460.72
47210,3666707,188.0.189.105,840.0,pos trm,451,6991,412833308,DEBIT,0,act,2029-10-22,2022-10-02 20:32:23,1110.06,payment,745350.66
47211,3764296,46.0.176.180,130.0,ATM,10,4863,412833308,DEBIT,0,act,2029-10-22,2022-10-14 09:01:48,1110.13,in,746460.79
47212,4153077,37.0.127.30,1023.0,cash_out,30,1894,412833308,DEBIT,0,act,2029-10-22,2022-10-15 23:28:14,1109.72,transfer,745351.07
47213,4611074,188.0.166.135,1308.0,pos trm,25,1079,412833308,DEBIT,0,act,2029-10-22,2022-11-02 18:10:04,1109.81,country_transfer,744241.26
47214,4652390,217.26.0.195,694.0,cash_out,20,6991,412833308,DEBIT,0,act,2029-10-22,2022-11-07 18:23:44,1109.88,decrease_on_acc,743131.38
47215,4661180,188.0.166.135,1308.0,pos trm,-1,7153,412833308,DEBIT,1,act,2029-10-22,2022-12-27 01:01:57,1109.91,err,743131.38
47216,4724877,88.210.0.90,348.0,atm,20,1079,412833308,DEBIT,0,act,2029-10-22,2023-02-07 20:42:23,1109.76,decrease_on_acc,742021.62
47217,4935709,37.0.127.30,1023.0,cash_out,451,9989,412833308,DEBIT,0,act,2029-10-22,2023-02-17 23:32:08,1109.88,payment,740911.74
47218,5288459,62.118.0.195,535.0,atm,20,1494,412833308,DEBIT,0,act,2029-10-22,2023-03-08 08:23:05,1110.1,decrease_on_acc,739801.64
47219,5327960,188.0.166.225,1315.0,atm,20,7567,412833308,DEBIT,0,act,2029-10-22,2023-03-11 23:12:13,1110.2,decrease_on_acc,738691.44
47220,5425213,188.0.166.135,1308.0,pos trm,-1,6404,412833308,DEBIT,1,act,2029-10-22,2023-03-13 15:39:14,1110.04,err,738691.44
47221,5731653,95.181.0.210,263.0,pos trm,30,3989,412833308,DEBIT,0,act,2029-10-22,2023-03-24 15:56:37,1110.11,transfer,737581.33
47222,5755098,95.181.0.210,263.0,pos trm,30,6056,412833308,DEBIT,0,act,2029-10-22,2023-04-01 17:31:09,1110.23,transfer,736471.1
47223,5770672,95.181.0.210,263.0,pos trm,-1,3989,412833308,DEBIT,1,act,2029-10-22,2023-05-01 10:02:56,1109.8,bad,736471.1
47224,5972915,95.181.0.165,260.0,atm,10,3989,412833308,DEBIT,0,act,2029-10-22,2023-05-05 08:03:09,1110.06,add_on_acc,737581.16
47225,6054537,45.154.0.30,297.0,ATM,10,2583,412833308,DEBIT,0,act,2029-10-22,2023-05-18 22:03:17,1110.04,add_on_acc,738691.2
47226,6169820,128.0.82.195,630.0,ATM,10,2583,412833308,DEBIT,0,act,2029-10-22,2023-06-21 17:36:40,1110.16,in,739801.36
47227,6176236,46.0.54.45,1072.0,atm,25,6404,412833308,DEBIT,0,act,2029-10-22,2023-06-22 06:13:32,1110.01,diff_cntry,738691.35
47228,6227324,185.173.0.150,1283.0,cash_out,451,4863,412833308,DEBIT,0,act,2029-10-22,2023-07-14 00:09:23,1110.07,payment,737581.28
47229,6496223,188.0.189.105,840.0,pos trm,30,8026,412833308,DEBIT,0,act,2029-10-22,2023-08-18 15:48:55,1110.19,transfer,736471.09
47230,6504301,185.173.0.150,1283.0,cash_out,25,8026,412833308,DEBIT,0,act,2029-10-22,2023-08-22 21:04:08,1110.27,country_transfer,735360.82
47231,6753540,81.17.0.60,1388.0,cash_in,10,5257,412833308,DEBIT,0,act,2029-10-22,2023-09-14 16:28:05,1110.26,in,736471.08
47232,7411730,46.0.123.75,916.0,ATM,10,8629,412833308,DEBIT,0,act,2029-10-22,2023-09-21 20:58:38,1109.84,in,737580.92
47233,7425572,46.0.54.45,1072.0,atm,-1,7332,412833308,DEBIT,1,act,2029-10-22,2023-10-08 00:35:05,1110.21,bad,737580.92
47234,7446014,213.151.0.195,1015.0,atm,30,2696,412833308,DEBIT,0,act,2029-10-22,2023-10-27 17:13:22,1110.0,transfer,736470.92
47235,7487254,78.24.158.24,931.0,ATM,20,4522,412833308,DEBIT,0,act,2029-10-22,2023-11-08 04:44:02,1110.2,from_acc,735360.72
47236,7800834,193.0.151.15,51.0,ATM,20,2486,412833308,DEBIT,0,act,2029-10-22,2023-11-09 12:12:50,1109.78,decrease_on_acc,734250.94
47237,7998591,188.0.166.135,1308.0,pos trm,30,9062,412833308,DEBIT,0,act,2029-10-22,2023-12-20 05:16:42,1109.83,transfer,733141.11
47238,8075519,188.0.189.105,840.0,pos trm,30,6650,412833308,DEBIT,0,act,2029-10-22,2023-12-29 20:18:07,1109.96,transfer,732031.15
47239,8135554,188.244.0.195,1467.0,atm,10,9950,412833308,DEBIT,0,act,2029-10-22,2024-01-21 00:15:33,1109.96,in,733141.11
47240,8189349,46.0.54.45,1072.0,atm,-1,6650,412833308,DEBIT,1,act,2029-10-22,2024-02-10 02:02:11,1110.22,bad,733141.11
47241,8244560,46.0.54.45,1072.0,atm,451,8629,412833308,DEBIT,0,act,2029-10-22,2024-02-25 09:16:59,1109.92,payment,732031.19
47242,8489839,46.0.54.45,1072.0,atm,451,8047,412833308,DEBIT,0,act,2029-10-22,2024-03-25 07:02:50,1109.94,payment,730921.25
47243,8685968,37.0.127.30,1023.0,cash_out,451,2486,412833308,DEBIT,0,act,2029-10-22,2024-04-09 22:34:06,1110.2,payment,729811.05
47244,8790362,37.0.127.30,1023.0,cash_out,451,9062,412833308,DEBIT,0,act,2029-10-22,2024-04-14 17:43:34,1110.18,payment,728700.87
47245,8939057,188.0.189.105,840.0,pos trm,30,2486,412833308,DEBIT,0,act,2029-10-22,2024-04-19 07:19:59,1109.93,transfer,727590.94
47246,8960051,95.181.0.210,263.0,pos trm,-1,8026,412833308,DEBIT,1,act,2029-10-22,2024-06-16 22:11:18,1109.87,err_code,727590.94
47247,8965122,213.151.0.195,1015.0,atm,25,2696,412833308,DEBIT,0,act,2029-10-22,2024-06-25 06:18:28,1110.01,country_transfer,726480.93
47248,9141590,188.0.166.135,1308.0,pos trm,451,2486,412833308,DEBIT,0,act,2029-10-22,2024-07-16 18:45:51,1110.11,payment,725370.82
47249,9150685,37.0.127.30,1023.0,cash_out,25,9950,412833308,DEBIT,0,act,2029-10-22,2024-07-25 01:31:31,1110.28,country_transfer,724260.54
47250,9173018,194.87.0.120,574.0,cash_out,20,6650,412833308,DEBIT,0,act,2029-10-22,2024-08-06 04:50:45,1110.11,out,723150.43
47251,9274113,109.126.0.240,385.0,cash_in,10,9530,412833308,DEBIT,0,act,2029-10-22,2024-08-28 18:45:51,1110.06,in_acc,724260.49
47252,9731743,188.18.0.150,234.0,atm,10,4522,412833308,DEBIT,0,act,2029-10-22,2024-11-16 12:56:57,1110.04,in_acc,725370.53
47253,9774390,213.151.0.195,1015.0,atm,25,9989,412833308,DEBIT,0,act,2029-10-22,2024-11-20 04:01:15,1110.11,diff_cntry,724260.42
47254,1111858,193.31.0.135,599.0,ATM,20,9434,253020703,DEBIT,0,active,2027-02-20,2022-01-24 19:38:09,408.99,decrease_on_acc,971944.01
47255,1483537,37.0.124.90,727.0,atm,20,4656,253020703,DEBIT,0,active,2027-02-20,2022-02-18 11:15:48,409.12,from_acc,971534.89
47256,1492203,37.0.127.45,1025.0,cash_in,10,3727,253020703,DEBIT,0,active,2027-02-20,2022-02-24 03:58:15,408.78,in_acc,971943.67
47257,1913877,188.0.169.0,467.0,atm,30,1854,253020703,DEBIT,0,active,2027-02-20,2022-05-05 17:52:30,409.22,transfer,971534.45
47258,2014979,188.0.169.0,467.0,atm,451,4656,253020703,DEBIT,0,active,2027-02-20,2022-05-18 00:02:31,408.93,payment,971125.52
47259,2075674,128.0.82.165,627.0,atm,20,4081,253020703,DEBIT,0,active,2027-02-20,2022-06-02 19:16:15,409.11,out,970716.41
47260,3032404,81.17.0.105,1391.0,cash_out,-1,3919,253020703,DEBIT,1,active,2027-02-20,2022-06-26 18:27:02,409.02,err_code,970716.41
47261,3202687,185.173.0.150,1283.0,cash_out,451,7759,253020703,DEBIT,0,active,2027-02-20,2022-08-20 04:01:04,408.94,payment,970307.47
47262,3243399,217.26.0.15,675.0,cash_out,20,9821,253020703,DEBIT,0,active,2027-02-20,2022-09-01 06:50:46,408.74,from_acc,969898.73
47263,3288430,188.0.169.0,467.0,atm,451,2193,253020703,DEBIT,0,active,2027-02-20,2022-09-16 21:43:53,409.13,payment,969489.6
47264,3541577,185.173.0.75,1278.0,ATM,20,2703,253020703,DEBIT,0,active,2027-02-20,2022-09-19 19:27:13,408.93,from_acc,969080.67
47265,3665451,188.18.0.165,235.0,port_trm,30,3727,253020703,DEBIT,0,active,2027-02-20,2022-10-17 01:36:57,408.73,transfer,968671.94
47266,3707101,185.173.0.150,1283.0,cash_out,451,9242,253020703,DEBIT,0,active,2027-02-20,2022-10-24 10:59:08,408.78,payment,968263.16
47267,3732488,188.0.0.0,1206.0,atm,10,2826,253020703,DEBIT,0,active,2027-02-20,2022-12-31 09:16:39,408.79,in,968671.95
47268,3768262,188.191.0.135,1150.0,atm,20,4181,253020703,DEBIT,0,active,2027-02-20,2023-01-27 12:44:27,409.18,from_acc,968262.77
47269,3793073,128.0.94.60,1101.0,cash_out,20,4181,253020703,DEBIT,0,active,2027-02-20,2023-02-10 01:04:56,409.31,from_acc,967853.46
47270,4033608,195.143.0.150,1377.0,ATM,-1,7860,253020703,DEBIT,1,active,2027-02-20,2023-03-29 21:22:02,408.89,bad,967853.46
47271,4034787,194.156.0.105,29.0,ATM,10,8201,253020703,DEBIT,0,active,2027-02-20,2023-04-15 22:21:06,408.98,add_on_acc,968262.44
47272,4149776,194.0.144.75,166.0,Portable term,451,9242,253020703,DEBIT,0,active,2027-02-20,2023-04-28 19:45:29,409.0,payment,967853.44
47273,4150082,46.0.2.105,189.0,prtbl trm,30,2826,253020703,DEBIT,0,active,2027-02-20,2023-04-30 01:39:14,409.0,transfer,967444.44
47274,4220504,134.0.98.195,806.0,cash_in,10,9242,253020703,DEBIT,0,active,2027-02-20,2023-05-08 22:28:37,408.95,in_acc,967853.39
47275,4355837,46.0.2.0,180.0,atm,10,3727,253020703,DEBIT,0,active,2027-02-20,2023-05-18 06:40:10,408.95,in_acc,968262.34
47276,5060327,217.26.0.105,685.0,pos trm,30,9821,253020703,DEBIT,0,active,2027-02-20,2023-07-25 10:56:30,409.04,transfer,967853.3
47277,5109720,185.173.0.150,1283.0,cash_out,30,9821,253020703,DEBIT,0,active,2027-02-20,2023-08-20 07:32:01,408.9,transfer,967444.4
47278,5120807,188.0.169.0,467.0,atm,451,4656,253020703,DEBIT,0,active,2027-02-20,2023-08-23 09:05:14,409.09,payment,967035.31
47279,5377850,46.0.2.105,189.0,prtbl trm,30,2193,253020703,DEBIT,0,active,2027-02-20,2023-09-11 18:55:02,409.22,transfer,966626.09
47280,5516188,46.0.128.165,712.0,atm,10,2226,253020703,DEBIT,0,active,2027-02-20,2023-09-25 01:40:31,408.79,in,967034.88
47281,5658603,188.18.0.165,235.0,port_trm,30,3481,253020703,DEBIT,0,active,2027-02-20,2023-09-25 16:24:02,408.71,transfer,966626.17
47282,5698280,188.18.0.165,235.0,port_trm,30,4181,253020703,DEBIT,0,active,2027-02-20,2023-09-26 20:55:47,408.92,transfer,966217.25
47283,5770085,185.173.0.150,1283.0,cash_out,-1,9434,253020703,DEBIT,1,active,2027-02-20,2023-10-11 03:50:52,409.17,err_code,966217.25
47284,5979703,217.26.0.105,685.0,pos trm,30,9242,253020703,DEBIT,0,active,2027-02-20,2023-10-24 08:42:50,409.18,transfer,965808.07
47285,6067554,188.191.0.240,1160.0,ATM,20,8201,253020703,DEBIT,0,active,2027-02-20,2023-10-25 16:50:22,409.12,from_acc,965398.95
47286,6303291,194.0.162.210,757.0,ATM,20,2601,253020703,DEBIT,0,active,2027-02-20,2023-11-21 17:52:22,409.07,decrease_on_acc,964989.88
47287,6318886,194.0.144.75,166.0,Portable term,451,3919,253020703,DEBIT,0,active,2027-02-20,2023-12-28 16:42:37,408.91,payment,964580.97
47288,6416198,46.0.2.105,189.0,prtbl trm,451,3727,253020703,DEBIT,0,active,2027-02-20,2024-01-06 02:53:35,408.67,payment,964172.3
47289,6524594,185.173.0.150,1283.0,cash_out,30,6287,253020703,DEBIT,0,active,2027-02-20,2024-01-08 09:04:10,409.0,transfer,963763.3
47290,6963758,194.0.144.75,166.0,Portable term,451,1729,253020703,DEBIT,0,active,2027-02-20,2024-03-21 13:35:58,408.86,payment,963354.44
47291,7171408,194.0.144.75,166.0,Portable term,30,9392,253020703,DEBIT,0,active,2027-02-20,2024-04-06 20:46:52,408.94,transfer,962945.5
47292,7218434,188.0.166.30,1298.0,ATM,10,4081,253020703,DEBIT,0,active,2027-02-20,2024-04-27 08:15:06,409.14,add_on_acc,963354.64
47293,7303769,188.0.169.0,467.0,atm,451,9434,253020703,DEBIT,0,active,2027-02-20,2024-04-27 17:22:45,408.87,payment,962945.77
47294,7728680,95.167.0.60,204.0,ATM,20,8201,253020703,DEBIT,0,active,2027-02-20,2024-04-30 05:11:05,409.0,out,962536.77
47295,7896658,37.0.123.15,319.0,atm,10,7860,253020703,DEBIT,0,active,2027-02-20,2024-05-03 05:32:35,408.81,in_acc,962945.58
47296,8064416,46.0.2.105,189.0,prtbl trm,25,2601,253020703,DEBIT,0,active,2027-02-20,2024-05-16 08:08:05,409.03,country_transfer,962536.55
47297,8166063,188.18.0.165,235.0,port_trm,30,2226,253020703,DEBIT,0,active,2027-02-20,2024-05-24 13:05:14,408.89,transfer,962127.66
47298,8486375,151.0.0.90,20.0,ATM,10,2193,253020703,DEBIT,0,active,2027-02-20,2024-06-13 22:16:22,408.92,add_on_acc,962536.58
47299,8693464,217.26.0.105,685.0,pos trm,25,9434,253020703,DEBIT,0,active,2027-02-20,2024-07-03 07:14:55,408.97,country_transfer,962127.61
47300,9253749,194.0.144.75,166.0,Portable term,25,4081,253020703,DEBIT,0,active,2027-02-20,2024-07-03 11:31:48,408.96,diff_cntry,961718.65
47301,9285598,194.0.144.75,166.0,Portable term,451,3727,253020703,DEBIT,0,active,2027-02-20,2024-09-22 08:50:24,409.04,payment,961309.61
47302,9410251,194.156.0.30,23.0,atm,10,4656,253020703,DEBIT,0,active,2027-02-20,2024-09-28 20:02:40,409.08,in_acc,961718.69
47303,9475539,194.0.144.75,166.0,Portable term,25,3481,253020703,DEBIT,0,active,2027-02-20,2024-09-30 05:55:22,408.94,diff_cntry,961309.75
47304,9478852,217.112.0.60,1476.0,atm,10,3512,253020703,DEBIT,0,active,2027-02-20,2024-10-18 23:13:44,408.97,add_on_acc,961718.72
47305,9669827,195.143.0.150,1377.0,ATM,30,8297,253020703,DEBIT,0,active,2027-02-20,2024-10-27 06:45:59,409.07,transfer,961309.65
47306,1174403,46.0.54.15,1069.0,cash_in,451,3998,125855613,DEBIT,0,act,2029-09-01,2022-01-05 08:39:47,185.04,payment,198638.96
47307,1403088,45.154.0.75,300.0,ATM,10,3998,125855613,DEBIT,0,act,2029-09-01,2022-01-07 21:01:56,184.77,in,198823.73
47308,1490728,46.0.54.15,1069.0,cash_in,30,8385,125855613,DEBIT,0,act,2029-09-01,2022-05-18 07:08:34,185.01,transfer,198638.72
47309,1594645,193.0.151.180,68.0,atm,-1,1106,125855613,DEBIT,1,act,2029-09-01,2022-06-01 15:04:23,184.91,bad,198638.72
47310,2013635,185.17.0.90,1052.0,atm,25,2119,125855613,DEBIT,0,act,2029-09-01,2022-09-01 20:39:24,184.91,country_transfer,198453.81
47311,2052621,128.0.94.120,1107.0,pos trm,30,5180,125855613,DEBIT,0,act,2029-09-01,2022-10-18 05:20:11,185.12,transfer,198268.69
47312,2148474,193.0.151.90,58.0,cash_out,20,4802,125855613,DEBIT,0,act,2029-09-01,2022-11-07 13:39:37,184.95,from_acc,198083.74
47313,2153202,109.126.0.75,370.0,prtbl trm,30,6449,125855613,DEBIT,0,act,2029-09-01,2022-11-14 22:40:11,185.13,transfer,197898.61
47314,2269841,151.0.38.105,395.0,prtbl trm,451,1642,125855613,DEBIT,0,act,2029-09-01,2022-11-20 06:13:54,185.06,payment,197713.55
47315,2650450,193.31.0.30,588.0,ATM,20,6449,125855613,DEBIT,0,act,2029-09-01,2022-11-22 15:24:52,185.12,out,197528.43
47316,2788728,188.0.166.120,1307.0,ATM,10,2119,125855613,DEBIT,0,act,2029-09-01,2022-11-23 03:12:37,185.21,in_acc,197713.64
47317,3166119,46.0.143.165,824.0,cash_out,20,5180,125855613,DEBIT,0,act,2029-09-01,2022-12-03 10:33:26,185.2,decrease_on_acc,197528.44
47318,3380238,185.17.0.90,1052.0,atm,30,9326,125855613,DEBIT,0,act,2029-09-01,2022-12-13 06:33:58,185.06,transfer,197343.38
47319,3444479,62.118.0.225,538.0,ATM,20,3738,125855613,DEBIT,0,act,2029-09-01,2022-12-31 06:07:09,185.12,decrease_on_acc,197158.26
47320,3540798,194.0.162.195,755.0,pos trm,25,5872,125855613,DEBIT,0,act,2029-09-01,2023-01-07 13:03:43,185.02,country_transfer,196973.24
47321,3583257,128.0.94.120,1107.0,pos trm,-1,8385,125855613,DEBIT,1,act,2029-09-01,2023-02-15 13:41:48,185.04,bad,196973.24
47322,3587299,46.0.54.15,1069.0,cash_in,25,5869,125855613,DEBIT,0,act,2029-09-01,2023-02-27 02:37:00,184.78,country_transfer,196788.46
47323,4007163,46.0.143.30,812.0,atm,10,9326,125855613,DEBIT,0,act,2029-09-01,2023-03-15 18:49:59,185.05,add_on_acc,196973.51
47324,4025834,128.0.94.120,1107.0,pos trm,451,7007,125855613,DEBIT,0,act,2029-09-01,2023-03-16 00:43:52,185.11,payment,196788.4
47325,4359909,37.0.124.120,729.0,atm,10,4802,125855613,DEBIT,0,act,2029-09-01,2023-03-18 19:24:14,185.14,add_on_acc,196973.54
47326,4550754,185.17.0.90,1052.0,atm,25,3738,125855613,DEBIT,0,act,2029-09-01,2023-04-13 20:38:31,185.03,country_transfer,196788.51
47327,4650703,185.17.0.90,1052.0,atm,25,2119,125855613,DEBIT,0,act,2029-09-01,2023-05-30 20:39:51,184.91,country_transfer,196603.6
47328,4805402,128.0.94.120,1107.0,pos trm,451,9310,125855613,DEBIT,0,act,2029-09-01,2023-09-13 05:43:52,185.14,payment,196418.46
47329,4960846,46.0.54.15,1069.0,cash_in,30,5869,125855613,DEBIT,0,act,2029-09-01,2023-12-10 15:25:37,185.11,transfer,196233.35
47330,5079505,185.17.0.105,1053.0,cash_in,10,9043,125855613,DEBIT,0,act,2029-09-01,2023-12-24 14:44:00,184.99,in_acc,196418.34
47331,5450593,109.126.0.75,370.0,prtbl trm,30,7724,125855613,DEBIT,0,act,2029-09-01,2024-02-17 22:17:47,185.21,transfer,196233.13
47332,5508039,193.0.151.180,68.0,atm,-1,4314,125855613,DEBIT,1,act,2029-09-01,2024-03-19 11:07:43,185.13,bad,196233.13
47333,5594742,193.0.151.180,68.0,atm,30,2338,125855613,DEBIT,0,act,2029-09-01,2024-05-10 05:21:33,185.05,transfer,196048.08
47334,5940846,194.0.162.195,755.0,pos trm,-1,2283,125855613,DEBIT,1,act,2029-09-01,2024-05-10 16:12:05,185.03,bad,196048.08
47335,6274961,194.0.162.195,755.0,pos trm,25,8385,125855613,DEBIT,0,act,2029-09-01,2024-05-25 23:55:55,184.94,diff_cntry,195863.14
47336,6443451,194.156.0.0,21.0,ATM,20,9326,125855613,DEBIT,0,act,2029-09-01,2024-06-25 03:11:00,185.32,out,195677.82
47337,6497691,188.191.0.225,1159.0,atm,10,7724,125855613,DEBIT,0,act,2029-09-01,2024-07-02 04:17:51,184.92,in_acc,195862.74
47338,6707296,95.167.0.180,215.0,ATM,20,4802,125855613,DEBIT,0,act,2029-09-01,2024-07-14 10:29:19,185.22,decrease_on_acc,195677.52
47339,6727094,185.17.0.90,1052.0,atm,30,1106,125855613,DEBIT,0,act,2029-09-01,2024-08-16 23:09:33,185.13,transfer,195492.39
47340,7077158,194.0.162.195,755.0,pos trm,-1,6449,125855613,DEBIT,1,act,2029-09-01,2024-08-18 14:35:41,184.67,err_code,195492.39
47341,7174383,193.0.151.180,68.0,atm,-1,4802,125855613,DEBIT,2,act,2029-09-01,2024-09-30 00:07:34,184.87,err_code,195492.39
47342,7344973,185.17.0.90,1052.0,atm,-1,9310,125855613,DEBIT,3,blk,2029-09-01,2024-11-21 19:53:08,185.19,err,195492.39
47343,1224310,188.0.169.165,480.0,atm,25,5788,403085721,CREDIT,0,act,2027-03-02,2022-01-02 21:19:05,557.18,diff_cntry,979691.82
47344,1255653,95.167.0.45,203.0,atm,10,2329,403085721,CREDIT,0,act,2027-03-02,2022-01-03 18:35:57,556.92,in,980248.74
47345,1277546,188.0.166.195,1313.0,Portable term,451,7847,403085721,CREDIT,0,act,2027-03-02,2022-01-04 08:33:23,557.1,payment,979691.64
47346,1342127,85.140.0.165,1264.0,atm,10,3740,403085721,CREDIT,0,act,2027-03-02,2022-01-06 17:02:10,557.08,add_on_acc,980248.72
47347,1370273,212.20.0.210,464.0,cash_in,451,7944,403085721,CREDIT,0,act,2027-03-02,2022-01-18 05:04:59,557.03,payment,979691.69
47348,1460946,188.0.169.165,480.0,atm,451,6194,403085721,CREDIT,0,act,2027-03-02,2022-01-18 14:32:27,557.15,payment,979134.54
47349,1549664,134.0.98.165,802.0,cash_out,20,2329,403085721,CREDIT,0,act,2027-03-02,2022-01-19 02:19:22,557.18,out,978577.36
47350,1551640,77.242.0.15,269.0,atm,20,5507,403085721,CREDIT,0,act,2027-03-02,2022-02-28 09:52:47,556.66,out,978020.7
47351,1650032,217.112.0.240,1495.0,pos trm,25,8364,403085721,CREDIT,0,act,2027-03-02,2022-03-30 06:06:21,557.2,diff_cntry,977463.5
47352,1986222,188.0.169.165,480.0,atm,451,8364,403085721,CREDIT,0,act,2027-03-02,2022-04-22 11:22:13,556.9,payment,976906.6
47353,2024928,188.0.169.165,480.0,atm,-1,8935,403085721,CREDIT,1,act,2027-03-02,2022-05-09 23:33:22,557.08,err,976906.6
47354,2096127,95.167.0.75,205.0,ATM,10,2358,403085721,CREDIT,0,act,2027-03-02,2022-05-18 00:31:50,556.96,add_on_acc,977463.56
47355,2273985,128.0.94.240,1115.0,cash_in,10,9347,403085721,CREDIT,0,act,2027-03-02,2022-05-18 11:56:39,556.94,in_acc,978020.5
47356,2547191,188.0.166.195,1313.0,Portable term,-1,6194,403085721,CREDIT,1,act,2027-03-02,2022-05-23 10:53:00,556.87,err,978020.5
47357,2761129,217.112.0.240,1495.0,pos trm,451,8364,403085721,CREDIT,0,act,2027-03-02,2022-08-05 04:37:05,557.27,payment,977463.23
47358,2962775,188.0.166.195,1313.0,Portable term,451,6194,403085721,CREDIT,0,act,2027-03-02,2022-09-20 18:03:42,556.97,payment,976906.26
47359,3049086,217.26.0.210,695.0,cash_out,20,2526,403085721,CREDIT,0,act,2027-03-02,2022-09-30 12:15:39,556.97,decrease_on_acc,976349.29
47360,3261820,217.112.0.240,1495.0,pos trm,25,8364,403085721,CREDIT,0,act,2027-03-02,2022-10-11 04:53:01,557.2,diff_cntry,975792.09
47361,3436012,212.20.0.210,464.0,cash_in,25,8364,403085721,CREDIT,0,act,2027-03-02,2022-10-22 20:30:43,557.04,diff_cntry,975235.05
47362,3492184,217.112.0.240,1495.0,pos trm,-1,8364,403085721,CREDIT,1,act,2027-03-02,2022-10-26 12:12:42,557.17,err,975235.05
47363,3626424,212.20.0.195,463.0,cash_in,10,8364,403085721,CREDIT,0,act,2027-03-02,2022-11-20 02:30:01,557.29,add_on_acc,975792.34
47364,3872533,151.0.0.90,20.0,ATM,10,7847,403085721,CREDIT,0,act,2027-03-02,2022-12-27 14:44:07,557.0,in,976349.34
47365,4130751,217.112.0.240,1495.0,pos trm,25,5788,403085721,CREDIT,0,act,2027-03-02,2023-01-10 23:07:33,556.68,diff_cntry,975792.66
47366,4651293,217.112.0.240,1495.0,pos trm,25,6134,403085721,CREDIT,0,act,2027-03-02,2023-01-23 19:32:54,556.92,diff_cntry,975235.74
47367,4726720,37.0.124.60,724.0,pos trm,25,6194,403085721,CREDIT,0,act,2027-03-02,2023-03-30 12:59:35,557.38,country_transfer,974678.36
47368,5043467,37.0.124.60,724.0,pos trm,451,3801,403085721,CREDIT,0,act,2027-03-02,2023-04-01 00:15:23,557.0,payment,974121.36
47369,5184354,212.20.0.210,464.0,cash_in,-1,2329,403085721,CREDIT,1,act,2027-03-02,2023-05-24 02:32:26,557.15,err,974121.36
47370,5435172,46.0.188.15,1227.0,atm,10,1409,403085721,CREDIT,0,act,2027-03-02,2023-05-28 01:46:26,557.09,in,974678.45
47371,5792994,217.112.0.240,1495.0,pos trm,451,1409,403085721,CREDIT,0,act,2027-03-02,2023-06-03 23:39:13,557.24,payment,974121.21
47372,5939515,188.162.0.0,952.0,atm,20,5507,403085721,CREDIT,0,act,2027-03-02,2023-06-04 11:05:47,557.19,from_acc,973564.02
47373,6008459,37.0.124.60,724.0,pos trm,-1,1409,403085721,CREDIT,1,act,2027-03-02,2023-06-09 04:26:39,557.12,err,973564.02
47374,6248791,212.20.0.210,464.0,cash_in,451,6134,403085721,CREDIT,0,act,2027-03-02,2023-06-10 03:48:37,557.13,payment,973006.89
47375,6278743,193.0.151.180,68.0,atm,10,6194,403085721,CREDIT,0,act,2027-03-02,2023-06-19 20:27:50,557.08,in,973563.97
47376,6558934,88.210.0.240,362.0,ATM,20,3740,403085721,CREDIT,0,act,2027-03-02,2023-07-02 02:25:43,557.1,out,973006.87
47377,6566733,188.0.169.165,480.0,atm,30,7847,403085721,CREDIT,0,act,2027-03-02,2023-07-12 01:02:04,556.88,transfer,972449.99
47378,6806077,78.24.158.129,942.0,ATM,10,9347,403085721,CREDIT,0,act,2027-03-02,2023-07-24 10:12:26,557.32,in,973007.31
47379,6910408,5.189.0.0,854.0,atm,10,8935,403085721,CREDIT,0,act,2027-03-02,2023-08-05 14:45:46,557.01,in_acc,973564.32
47380,7108194,188.0.166.195,1313.0,Portable term,30,3901,403085721,CREDIT,0,act,2027-03-02,2023-08-25 12:39:19,556.95,transfer,973007.37
47381,7388586,46.0.188.15,1227.0,atm,10,7847,403085721,CREDIT,0,act,2027-03-02,2023-10-26 13:00:43,556.99,in,973564.36
47382,7526796,188.0.166.195,1313.0,Portable term,451,8364,403085721,CREDIT,0,act,2027-03-02,2023-12-22 21:08:30,556.88,payment,973007.48
47383,7680398,46.0.54.210,1090.0,atm,10,5507,403085721,CREDIT,0,act,2027-03-02,2024-01-03 21:36:25,556.66,in,973564.14
47384,7709098,188.0.169.165,480.0,atm,25,3740,403085721,CREDIT,0,act,2027-03-02,2024-02-21 06:09:56,556.85,diff_cntry,973007.29
47385,7751322,188.0.166.195,1313.0,Portable term,25,3901,403085721,CREDIT,0,act,2027-03-02,2024-03-08 18:22:36,557.06,diff_cntry,972450.23
47386,7792367,212.20.0.210,464.0,cash_in,451,6804,403085721,CREDIT,0,act,2027-03-02,2024-03-20 15:14:22,557.21,payment,971893.02
47387,7971208,188.0.166.195,1313.0,Portable term,451,1914,403085721,CREDIT,0,act,2027-03-02,2024-03-22 16:17:39,556.93,payment,971336.09
47388,8487281,217.112.0.0,1471.0,ATM,10,5507,403085721,CREDIT,0,act,2027-03-02,2024-03-23 14:27:36,557.18,in,971893.27
47389,8504176,217.112.0.240,1495.0,pos trm,451,3801,403085721,CREDIT,0,act,2027-03-02,2024-04-15 20:36:55,556.97,payment,971336.3
47390,8776674,188.0.166.195,1313.0,Portable term,451,3801,403085721,CREDIT,0,act,2027-03-02,2024-05-01 15:30:50,557.17,payment,970779.13
47391,8870566,212.20.0.210,464.0,cash_in,451,7944,403085721,CREDIT,0,act,2027-03-02,2024-06-11 23:06:06,557.13,payment,970222.0
47392,8884120,188.0.169.165,480.0,atm,451,8935,403085721,CREDIT,0,act,2027-03-02,2024-07-02 01:26:17,557.05,payment,969664.95
47393,8962395,37.0.124.60,724.0,pos trm,451,2358,403085721,CREDIT,0,act,2027-03-02,2024-07-08 05:54:57,556.86,payment,969108.09
47394,9074701,188.0.166.195,1313.0,Portable term,25,6134,403085721,CREDIT,0,act,2027-03-02,2024-08-07 04:11:36,556.9,country_transfer,968551.19
47395,9141117,195.143.0.225,1382.0,ATM,10,6804,403085721,CREDIT,0,act,2027-03-02,2024-10-17 05:14:30,557.11,in,969108.3
47396,9679960,128.0.24.45,883.0,atm,20,7509,403085721,CREDIT,0,act,2027-03-02,2024-11-04 18:34:12,556.91,decrease_on_acc,968551.39
47397,1375673,188.162.0.45,955.0,port_trm,451,1461,212991804,CREDIT,0,act,2029-04-14,2022-02-17 07:59:45,734.91,payment,78341.09
47398,1417860,109.126.0.165,377.0,port_trm,451,5850,212991804,CREDIT,0,act,2029-04-14,2022-02-18 03:22:13,734.82,payment,77606.27
47399,1468556,46.8.0.150,779.0,prtbl trm,30,5987,212991804,CREDIT,0,act,2029-04-14,2022-03-10 04:45:09,735.19,transfer,76871.08
47400,1751242,194.0.144.195,176.0,pos trm,-1,4921,212991804,CREDIT,1,act,2029-04-14,2022-03-11 02:57:11,735.09,err_code,76871.08
47401,1922388,95.106.0.105,551.0,atm,25,3722,212991804,CREDIT,0,act,2029-04-14,2022-03-29 04:03:57,734.99,country_transfer,76136.09
47402,1968627,79.104.0.150,647.0,Portable term,451,6087,212991804,CREDIT,0,act,2029-04-14,2022-06-02 11:59:18,734.94,payment,75401.15
47403,1988725,193.0.151.15,51.0,ATM,25,7975,212991804,CREDIT,0,act,2029-04-14,2022-06-08 07:14:46,734.95,country_transfer,74666.2
47404,2009670,77.242.0.15,269.0,atm,20,2173,212991804,CREDIT,0,act,2029-04-14,2022-06-23 04:42:36,734.77,out,73931.43
47405,2216289,188.0.0.90,1212.0,atm,20,5987,212991804,CREDIT,0,act,2029-04-14,2022-07-17 11:07:58,735.12,out,73196.31
47406,2243905,193.0.151.15,51.0,ATM,451,6106,212991804,CREDIT,0,act,2029-04-14,2022-08-04 03:46:21,734.92,payment,72461.39
47407,2466069,46.0.2.0,180.0,atm,10,4155,212991804,CREDIT,0,act,2029-04-14,2022-08-17 16:42:30,735.01,in_acc,73196.4
47408,2822955,46.8.0.150,779.0,prtbl trm,-1,6106,212991804,CREDIT,1,act,2029-04-14,2022-09-26 06:17:19,734.74,err,73196.4
47409,3042814,109.126.0.165,377.0,port_trm,451,6441,212991804,CREDIT,0,act,2029-04-14,2022-10-01 12:58:31,735.08,payment,72461.32
47410,3147567,195.161.0.30,1164.0,ATM,10,7975,212991804,CREDIT,0,act,2029-04-14,2022-10-12 07:18:43,734.84,add_on_acc,73196.16
47411,3168865,46.0.123.45,913.0,atm,10,7975,212991804,CREDIT,0,act,2029-04-14,2022-10-30 04:57:58,735.17,in_acc,73931.33
47412,3239837,194.0.162.210,757.0,ATM,20,7548,212991804,CREDIT,0,act,2029-04-14,2022-11-17 08:01:55,735.11,from_acc,73196.22
47413,3457618,95.106.0.105,551.0,atm,30,8442,212991804,CREDIT,0,act,2029-04-14,2022-11-18 19:04:15,734.97,transfer,72461.25
47414,3563832,95.106.0.105,551.0,atm,-1,6441,212991804,CREDIT,1,act,2029-04-14,2023-01-01 09:14:17,735.23,err,72461.25
47415,3596761,81.17.0.0,1384.0,prtbl trm,451,9789,212991804,CREDIT,0,act,2029-04-14,2023-01-11 22:11:07,734.83,payment,71726.42
47416,3690031,46.8.0.150,779.0,prtbl trm,451,7021,212991804,CREDIT,0,act,2029-04-14,2023-01-31 08:34:17,735.2,payment,70991.22
47417,3711642,193.0.151.15,51.0,ATM,20,9944,212991804,CREDIT,0,act,2029-04-14,2023-02-21 12:35:05,734.94,decrease_on_acc,70256.28
47418,3763701,195.161.0.135,1173.0,cash_in,10,6441,212991804,CREDIT,0,act,2029-04-14,2023-03-02 16:09:13,735.03,add_on_acc,70991.31
47419,3978155,195.143.0.195,1380.0,atm,10,1572,212991804,CREDIT,0,act,2029-04-14,2023-03-13 01:24:24,735.11,add_on_acc,71726.42
47420,4094606,188.162.0.45,955.0,port_trm,451,6106,212991804,CREDIT,0,act,2029-04-14,2023-03-19 19:33:04,734.81,payment,70991.61
47421,4134398,212.20.0.30,448.0,ATM,20,2173,212991804,CREDIT,0,act,2029-04-14,2023-04-27 20:45:10,734.91,from_acc,70256.7
47422,4246057,79.104.0.240,653.0,cash_in,451,7021,212991804,CREDIT,0,act,2029-04-14,2023-05-04 06:54:52,734.95,payment,69521.75
47423,4404789,46.173.0.105,502.0,atm,10,3722,212991804,CREDIT,0,act,2029-04-14,2023-05-10 18:35:59,734.99,in_acc,70256.74
47424,4478726,193.0.151.15,51.0,ATM,451,1572,212991804,CREDIT,0,act,2029-04-14,2023-05-24 13:15:28,734.87,payment,69521.87
47425,4749209,194.0.144.195,176.0,pos trm,451,4921,212991804,CREDIT,0,act,2029-04-14,2023-06-03 13:05:19,735.28,payment,68786.59
47426,5597118,91.107.0.195,991.0,cash_in,10,5850,212991804,CREDIT,0,act,2029-04-14,2023-06-21 23:44:56,735.24,in,69521.83
47427,5732953,194.87.0.165,577.0,atm,20,6893,212991804,CREDIT,0,act,2029-04-14,2023-06-28 15:16:31,735.08,out,68786.75
47428,5770777,46.0.8.105,145.0,atm,20,9944,212991804,CREDIT,0,act,2029-04-14,2023-08-22 23:24:40,735.12,decrease_on_acc,68051.63
47429,5817989,46.8.0.150,779.0,prtbl trm,25,5576,212991804,CREDIT,0,act,2029-04-14,2023-08-31 02:34:09,735.11,diff_cntry,67316.52
47430,6197128,46.0.2.30,183.0,cash_in,10,3722,212991804,CREDIT,0,act,2029-04-14,2023-09-08 03:59:55,735.02,in_acc,68051.54
47431,6368335,212.20.0.30,448.0,ATM,10,4155,212991804,CREDIT,0,act,2029-04-14,2023-11-19 00:01:59,734.95,in_acc,68786.49
47432,6956639,193.0.151.15,51.0,ATM,25,4155,212991804,CREDIT,0,act,2029-04-14,2023-11-22 03:53:55,734.79,diff_cntry,68051.7
47433,6959745,95.106.0.105,551.0,atm,-1,3722,212991804,CREDIT,1,act,2029-04-14,2023-12-04 18:21:21,735.03,bad,68051.7
47434,7241806,46.8.0.150,779.0,prtbl trm,451,5987,212991804,CREDIT,0,act,2029-04-14,2023-12-25 18:10:20,734.95,payment,67316.75
47435,7702654,46.8.0.150,779.0,prtbl trm,451,9944,212991804,CREDIT,0,act,2029-04-14,2024-01-15 12:16:21,735.08,payment,66581.67
47436,7968149,85.140.0.90,1255.0,ATM,10,3722,212991804,CREDIT,0,act,2029-04-14,2024-01-26 17:35:24,734.79,in,67316.46
47437,8020700,46.0.8.135,147.0,atm,20,9064,212991804,CREDIT,0,act,2029-04-14,2024-02-05 11:01:46,734.9,from_acc,66581.56
47438,8106594,81.17.0.0,1384.0,prtbl trm,451,9385,212991804,CREDIT,0,act,2029-04-14,2024-02-14 02:21:36,735.22,payment,65846.34
47439,8428511,188.162.0.45,955.0,port_trm,25,8491,212991804,CREDIT,0,act,2029-04-14,2024-02-19 03:21:48,735.19,diff_cntry,65111.15
47440,8524654,81.17.0.0,1384.0,prtbl trm,451,5576,212991804,CREDIT,0,act,2029-04-14,2024-03-19 15:39:57,735.02,payment,64376.13
47441,8544557,95.106.0.105,551.0,atm,25,3076,212991804,CREDIT,0,act,2029-04-14,2024-05-06 09:19:30,734.92,country_transfer,63641.21
47442,8893111,151.0.38.180,403.0,atm,10,2173,212991804,CREDIT,0,act,2029-04-14,2024-05-08 20:28:35,734.95,add_on_acc,64376.16
47443,8965600,193.0.151.15,51.0,ATM,30,9789,212991804,CREDIT,0,act,2029-04-14,2024-05-29 23:08:31,734.69,transfer,63641.47
47444,8975670,151.0.38.75,393.0,cash_in,10,1461,212991804,CREDIT,0,act,2029-04-14,2024-06-27 14:13:45,735.05,in_acc,64376.52
47445,9020789,46.8.0.150,779.0,prtbl trm,451,9317,212991804,CREDIT,0,act,2029-04-14,2024-07-27 23:43:06,734.92,payment,63641.6
47446,9055153,109.126.0.45,367.0,cash_in,10,1572,212991804,CREDIT,0,act,2029-04-14,2024-08-09 10:26:23,734.94,add_on_acc,64376.54
47447,9144162,188.162.0.45,955.0,port_trm,451,3549,212991804,CREDIT,0,act,2029-04-14,2024-08-23 18:29:57,734.77,payment,63641.77
47448,9193675,31.134.0.0,1116.0,atm,20,4875,212991804,CREDIT,0,act,2029-04-14,2024-10-02 04:13:48,734.75,from_acc,62907.02
47449,9656051,213.151.0.195,1015.0,atm,10,9385,212991804,CREDIT,0,act,2029-04-14,2024-10-31 11:49:01,734.94,add_on_acc,63641.96
47450,9817560,78.24.158.249,951.0,atm,20,6106,212991804,CREDIT,0,act,2029-04-14,2024-11-17 12:06:48,735.04,from_acc,62906.92
47451,9923274,79.104.0.240,653.0,cash_in,451,5987,212991804,CREDIT,0,act,2029-04-14,2024-11-23 05:05:25,734.91,payment,62172.01
47452,1008796,185.173.0.60,1277.0,cash_out,30,7029,496919397,DEBIT,0,act,2026-10-09,2022-01-09 17:36:20,371.11,transfer,782132.89
47453,1106684,128.0.24.90,889.0,ATM,30,2585,496919397,DEBIT,0,act,2026-10-09,2022-02-07 18:13:15,371.1,transfer,781761.79
47454,1548726,128.0.24.90,889.0,ATM,451,6879,496919397,DEBIT,0,act,2026-10-09,2022-02-22 19:50:09,370.91,payment,781390.88
47455,1566892,79.104.0.120,644.0,ATM,451,4276,496919397,DEBIT,0,act,2026-10-09,2022-03-15 17:51:03,371.22,payment,781019.66
47456,1667124,128.0.24.90,889.0,ATM,451,5374,496919397,DEBIT,0,act,2026-10-09,2022-03-22 11:49:24,370.96,payment,780648.7
47457,2081992,185.173.0.60,1277.0,cash_out,451,5374,496919397,DEBIT,0,act,2026-10-09,2022-03-30 09:37:51,371.3,payment,780277.4
47458,2350445,194.87.0.105,573.0,atm,10,1420,496919397,DEBIT,0,act,2026-10-09,2022-04-17 15:14:06,370.94,in_acc,780648.34
47459,2432725,79.104.0.120,644.0,ATM,-1,1565,496919397,DEBIT,1,act,2026-10-09,2022-04-23 02:20:33,371.16,bad,780648.34
47460,2434672,128.0.24.90,889.0,ATM,451,2996,496919397,DEBIT,0,act,2026-10-09,2022-04-30 08:21:57,370.88,payment,780277.46
47461,2727043,185.173.0.60,1277.0,cash_out,-1,1299,496919397,DEBIT,1,act,2026-10-09,2022-06-01 08:32:31,370.92,err,780277.46
47462,2957602,46.173.0.165,509.0,ATM,-1,7029,496919397,DEBIT,2,act,2026-10-09,2022-07-22 00:10:46,370.86,err,780277.46
47463,3187197,193.0.151.15,51.0,ATM,20,6636,496919397,DEBIT,0,act,2026-10-09,2022-08-07 12:12:32,370.62,from_acc,779906.84
47464,3270323,185.173.0.60,1277.0,cash_out,451,1299,496919397,DEBIT,0,act,2026-10-09,2022-08-28 22:59:20,371.16,payment,779535.68
47465,3309501,46.0.176.150,128.0,atm,10,5359,496919397,DEBIT,0,act,2026-10-09,2022-08-29 05:03:38,371.13,in_acc,779906.81
47466,3425630,79.104.0.120,644.0,ATM,451,1299,496919397,DEBIT,0,act,2026-10-09,2022-09-28 12:03:54,371.01,payment,779535.8
47467,3511269,128.0.82.180,628.0,atm,10,8528,496919397,DEBIT,0,act,2026-10-09,2022-11-05 07:53:36,371.07,in,779906.87
47468,3690967,188.162.0.75,958.0,cash_out,-1,5374,496919397,DEBIT,1,act,2026-10-09,2022-12-18 10:27:07,371.21,err_code,779906.87
47469,3810115,185.173.0.60,1277.0,cash_out,-1,6636,496919397,DEBIT,2,act,2026-10-09,2022-12-19 23:29:29,371.13,err,779906.87
47470,3833192,188.162.0.75,958.0,cash_out,25,7112,496919397,DEBIT,0,act,2026-10-09,2022-12-26 07:45:16,370.96,country_transfer,779535.91
47471,3848407,185.173.0.60,1277.0,cash_out,451,9828,496919397,DEBIT,0,act,2026-10-09,2023-01-12 12:20:25,371.02,payment,779164.89
47472,4349816,188.162.0.75,958.0,cash_out,25,5303,496919397,DEBIT,0,act,2026-10-09,2023-02-10 18:19:56,371.12,country_transfer,778793.77
47473,4419608,79.104.0.120,644.0,ATM,451,5359,496919397,DEBIT,0,act,2026-10-09,2023-02-18 01:57:39,371.42,payment,778422.35
47474,4559544,85.140.0.90,1255.0,ATM,20,3426,496919397,DEBIT,0,act,2026-10-09,2023-02-26 07:55:42,371.02,from_acc,778051.33
47475,4631195,46.173.0.165,509.0,ATM,30,3426,496919397,DEBIT,0,act,2026-10-09,2023-02-26 16:09:31,371.07,transfer,777680.26
47476,4821117,46.173.0.165,509.0,ATM,30,2996,496919397,DEBIT,0,act,2026-10-09,2023-04-03 23:10:44,371.14,transfer,777309.12
47477,5266886,91.107.0.180,990.0,atm,20,3426,496919397,DEBIT,0,act,2026-10-09,2023-04-14 23:32:47,371.06,out,776938.06
47478,5697088,188.162.0.75,958.0,cash_out,-1,2996,496919397,DEBIT,1,act,2026-10-09,2023-05-01 14:24:48,371.04,err,776938.06
47479,5850882,128.0.24.90,889.0,ATM,451,1565,496919397,DEBIT,0,act,2026-10-09,2023-05-10 13:09:36,371.19,payment,776566.87
47480,5966324,188.162.0.75,958.0,cash_out,30,5303,496919397,DEBIT,0,act,2026-10-09,2023-06-11 19:52:36,371.21,transfer,776195.66
47481,6025860,79.104.0.120,644.0,ATM,25,2585,496919397,DEBIT,0,act,2026-10-09,2023-06-14 06:10:09,370.84,country_transfer,775824.82
47482,6501544,128.0.24.90,889.0,ATM,25,7112,496919397,DEBIT,0,act,2026-10-09,2023-07-02 21:38:13,370.76,diff_cntry,775454.06
47483,6509284,188.162.0.75,958.0,cash_out,451,1299,496919397,DEBIT,0,act,2026-10-09,2023-07-13 10:12:07,370.83,payment,775083.23
47484,6787328,37.0.127.75,1027.0,ATM,20,6636,496919397,DEBIT,0,act,2026-10-09,2023-08-20 07:46:35,370.87,from_acc,774712.36
47485,6794975,46.173.0.165,509.0,ATM,451,6879,496919397,DEBIT,0,act,2026-10-09,2023-10-07 08:44:42,370.86,payment,774341.5
47486,7209038,188.162.0.75,958.0,cash_out,451,5374,496919397,DEBIT,0,act,2026-10-09,2023-10-27 22:50:03,370.8,payment,773970.7
47487,7222009,128.0.24.90,889.0,ATM,25,5359,496919397,DEBIT,0,act,2026-10-09,2023-11-10 18:25:20,371.16,diff_cntry,773599.54
47488,7264540,46.0.54.210,1090.0,atm,10,5359,496919397,DEBIT,0,act,2026-10-09,2023-12-17 14:58:43,371.04,add_on_acc,773970.58
47489,7590630,128.0.24.90,889.0,ATM,-1,9935,496919397,DEBIT,1,act,2026-10-09,2024-01-08 05:24:41,371.05,err,773970.58
47490,7662290,188.162.0.75,958.0,cash_out,451,7029,496919397,DEBIT,0,act,2026-10-09,2024-02-08 18:39:37,371.1,payment,773599.48
47491,7883595,185.173.0.60,1277.0,cash_out,451,9828,496919397,DEBIT,0,act,2026-10-09,2024-02-26 19:10:11,370.98,payment,773228.5
47492,8031105,128.0.24.90,889.0,ATM,451,9935,496919397,DEBIT,0,act,2026-10-09,2024-03-14 12:46:21,370.96,payment,772857.54
47493,8148310,188.162.0.75,958.0,cash_out,20,6879,496919397,DEBIT,0,act,2026-10-09,2024-04-03 08:31:34,370.91,decrease_on_acc,772486.63
47494,8438773,188.162.0.75,958.0,cash_out,451,7029,496919397,DEBIT,0,act,2026-10-09,2024-04-16 15:21:06,371.07,payment,772115.56
47495,8532049,188.162.0.75,958.0,cash_out,451,6636,496919397,DEBIT,0,act,2026-10-09,2024-05-30 23:47:45,371.0,payment,771744.56
47496,8666327,79.104.0.120,644.0,ATM,451,3426,496919397,DEBIT,0,act,2026-10-09,2024-06-06 03:46:12,370.7,payment,771373.86
47497,8667783,188.162.0.75,958.0,cash_out,451,2585,496919397,DEBIT,0,act,2026-10-09,2024-06-06 21:22:24,371.1,payment,771002.76
47498,8801201,46.8.0.105,774.0,cash_out,20,4554,496919397,DEBIT,0,act,2026-10-09,2024-07-24 10:35:40,371.12,out,770631.64
47499,9038889,188.0.166.210,1314.0,cash_out,20,3426,496919397,DEBIT,0,act,2026-10-09,2024-08-06 12:53:57,371.15,out,770260.49
47500,9170875,185.173.0.60,1277.0,cash_out,451,7029,496919397,DEBIT,0,act,2026-10-09,2024-08-10 06:11:02,371.16,payment,769889.33
47501,9191969,185.173.0.60,1277.0,cash_out,-1,3254,496919397,DEBIT,1,act,2026-10-09,2024-09-28 12:27:50,371.16,err_code,769889.33
47502,9348628,128.0.24.90,889.0,ATM,-1,1299,496919397,DEBIT,2,act,2026-10-09,2024-10-10 15:26:19,371.27,bad,769889.33
47503,9524131,46.0.143.90,818.0,cash_in,10,7112,496919397,DEBIT,0,act,2026-10-09,2024-10-20 19:37:43,371.26,in,770260.59
47504,9700989,194.87.0.90,572.0,atm,20,1299,496919397,DEBIT,0,act,2026-10-09,2024-11-11 01:59:09,371.12,decrease_on_acc,769889.47
47505,9728377,188.162.0.75,958.0,cash_out,-1,1565,496919397,DEBIT,1,act,2026-10-09,2024-11-25 18:12:47,371.03,err,769889.47
47506,1021178,195.161.0.45,1166.0,cash_out,30,1746,169968618,DEBIT,0,act,2025-09-07,2022-02-05 07:22:22,410.9,transfer,585399.1
47507,1289802,195.143.0.195,1380.0,atm,20,4317,169968618,DEBIT,0,act,2025-09-07,2022-03-07 20:53:39,410.61,from_acc,584988.49
47508,1330887,46.0.143.165,824.0,cash_out,20,4635,169968618,DEBIT,0,act,2025-09-07,2022-03-21 20:18:10,411.15,from_acc,584577.34
47509,1344319,46.0.123.15,910.0,ATM,10,1746,169968618,DEBIT,0,act,2025-09-07,2022-03-28 23:46:12,410.94,add_on_acc,584988.28
47510,1489673,46.0.123.105,918.0,cash_out,451,7915,169968618,DEBIT,0,act,2025-09-07,2022-04-10 20:12:38,411.02,payment,584577.26
47511,1528482,217.26.0.210,695.0,cash_out,20,7457,169968618,DEBIT,0,act,2025-09-07,2022-04-30 22:09:10,411.03,decrease_on_acc,584166.23
47512,1605097,37.0.124.0,719.0,port_trm,-1,2783,169968618,DEBIT,1,act,2025-09-07,2022-05-01 11:30:14,411.15,err,584166.23
47513,1901818,46.8.0.225,785.0,ATM,10,9442,169968618,DEBIT,0,act,2025-09-07,2022-05-03 06:03:04,410.88,add_on_acc,584577.11
47514,1909194,195.161.0.45,1166.0,cash_out,451,2783,169968618,DEBIT,0,act,2025-09-07,2022-05-31 03:19:59,411.16,payment,584165.95
47515,1960642,46.0.123.105,918.0,cash_out,30,1469,169968618,DEBIT,0,act,2025-09-07,2022-06-01 05:40:09,410.92,transfer,583755.03
47516,2322895,195.161.0.45,1166.0,cash_out,25,9442,169968618,DEBIT,0,act,2025-09-07,2022-06-27 11:14:12,411.02,country_transfer,583344.01
47517,2415469,37.0.124.0,719.0,port_trm,451,4475,169968618,DEBIT,0,act,2025-09-07,2022-07-17 00:46:04,411.15,payment,582932.86
47518,2813557,37.0.124.0,719.0,port_trm,451,7915,169968618,DEBIT,0,act,2025-09-07,2022-08-02 03:52:33,410.87,payment,582521.99
47519,2834854,195.161.0.45,1166.0,cash_out,25,6820,169968618,DEBIT,0,act,2025-09-07,2022-09-12 03:46:38,411.09,country_transfer,582110.9
47520,3127404,195.161.0.45,1166.0,cash_out,451,3684,169968618,DEBIT,0,act,2025-09-07,2022-11-24 02:37:45,410.54,payment,581700.36
47521,3147155,46.0.123.105,918.0,cash_out,451,7203,169968618,DEBIT,0,act,2025-09-07,2022-12-05 00:10:48,411.06,payment,581289.3
47522,3336326,46.0.9.0,1317.0,Portable term,451,4317,169968618,DEBIT,0,act,2025-09-07,2023-01-18 11:20:25,410.72,payment,580878.58
47523,3462283,46.0.123.105,918.0,cash_out,30,4302,169968618,DEBIT,0,act,2025-09-07,2023-02-18 13:59:59,410.98,transfer,580467.6
47524,3473796,46.0.123.45,913.0,atm,20,2824,169968618,DEBIT,0,act,2025-09-07,2023-03-07 01:28:25,411.05,decrease_on_acc,580056.55
47525,3515677,37.0.124.0,719.0,port_trm,30,3419,169968618,DEBIT,0,act,2025-09-07,2023-05-17 05:55:02,411.35,transfer,579645.2
47526,3661642,46.0.123.105,918.0,cash_out,451,4302,169968618,DEBIT,0,act,2025-09-07,2023-05-26 01:12:30,411.07,payment,579234.13
47527,4051683,188.0.166.225,1315.0,atm,10,7203,169968618,DEBIT,0,act,2025-09-07,2023-06-09 02:49:26,410.85,add_on_acc,579644.98
47528,4123170,46.0.123.105,918.0,cash_out,451,5154,169968618,DEBIT,0,act,2025-09-07,2023-06-14 21:11:56,410.98,payment,579234.0
47529,4659254,195.161.0.45,1166.0,cash_out,30,6820,169968618,DEBIT,0,act,2025-09-07,2023-06-21 22:27:40,411.18,transfer,578822.82
47530,4694342,46.0.9.0,1317.0,Portable term,451,3684,169968618,DEBIT,0,act,2025-09-07,2023-07-03 14:47:59,410.93,payment,578411.89
47531,4974304,37.0.124.0,719.0,port_trm,-1,7915,169968618,DEBIT,1,act,2025-09-07,2023-07-14 18:32:35,410.77,err,578411.89
47532,5203771,46.0.123.105,918.0,cash_out,30,7457,169968618,DEBIT,0,act,2025-09-07,2023-07-25 02:26:25,410.83,transfer,578001.06
47533,5329830,195.161.0.45,1166.0,cash_out,25,7679,169968618,DEBIT,0,act,2025-09-07,2023-07-31 18:54:54,410.91,country_transfer,577590.15
47534,5467233,37.0.124.0,719.0,port_trm,25,6820,169968618,DEBIT,0,act,2025-09-07,2023-08-20 08:43:24,411.23,diff_cntry,577178.92
47535,5580718,46.0.9.0,1317.0,Portable term,30,3684,169968618,DEBIT,0,act,2025-09-07,2023-09-04 03:40:11,410.88,transfer,576768.04
47536,5607068,195.161.0.45,1166.0,cash_out,451,2783,169968618,DEBIT,0,act,2025-09-07,2023-09-19 17:33:00,411.07,payment,576356.97
47537,5651236,46.0.9.0,1317.0,Portable term,-1,7457,169968618,DEBIT,1,act,2025-09-07,2023-10-17 21:09:48,410.96,bad,576356.97
47538,5975599,46.0.9.0,1317.0,Portable term,30,4475,169968618,DEBIT,0,act,2025-09-07,2023-11-17 07:47:16,410.98,transfer,575945.99
47539,6393234,46.0.123.105,918.0,cash_out,-1,9442,169968618,DEBIT,1,act,2025-09-07,2023-11-19 18:17:33,411.19,err_code,575945.99
47540,6481494,195.161.0.45,1166.0,cash_out,25,7457,169968618,DEBIT,0,act,2025-09-07,2023-11-24 17:26:06,410.99,country_transfer,575535.0
47541,6699058,88.210.0.135,353.0,cash_in,10,6820,169968618,DEBIT,0,act,2025-09-07,2023-12-13 23:03:22,410.88,add_on_acc,575945.88
47542,6701233,46.0.123.105,918.0,cash_out,451,6820,169968618,DEBIT,0,act,2025-09-07,2024-02-17 18:32:12,411.25,payment,575534.63
47543,6726819,195.161.0.45,1166.0,cash_out,451,5983,169968618,DEBIT,0,act,2025-09-07,2024-04-02 11:40:59,411.07,payment,575123.56
47544,6761194,195.161.0.45,1166.0,cash_out,451,4302,169968618,DEBIT,0,act,2025-09-07,2024-04-22 16:52:04,411.38,payment,574712.18
47545,6994530,195.161.0.45,1166.0,cash_out,30,1469,169968618,DEBIT,0,act,2025-09-07,2024-06-06 17:22:39,411.08,transfer,574301.1
47546,7252213,46.0.123.105,918.0,cash_out,451,2198,169968618,DEBIT,0,act,2025-09-07,2024-08-18 22:51:56,411.1,payment,573890.0
47547,7290857,46.0.123.105,918.0,cash_out,451,4475,169968618,DEBIT,0,act,2025-09-07,2024-08-21 10:07:48,411.05,payment,573478.95
47548,7533052,46.0.123.105,918.0,cash_out,451,5983,169968618,DEBIT,0,act,2025-09-07,2024-09-25 00:04:25,411.05,payment,573067.9
47549,7702899,46.0.9.0,1317.0,Portable term,-1,2824,169968618,DEBIT,1,act,2025-09-07,2024-11-06 10:04:54,410.95,err_code,573067.9
47550,7867185,195.161.0.45,1166.0,cash_out,-1,6820,169968618,DEBIT,2,act,2025-09-07,2024-11-09 20:05:15,410.85,err,573067.9
47551,7990776,195.161.0.45,1166.0,cash_out,-1,6460,169968618,DEBIT,3,blk,2025-09-07,2024-11-24 23:10:44,410.69,bad,573067.9
47552,1276993,5.189.0.240,877.0,cash_out,-1,1330,250329786,CREDIT,1,active,2028-04-11,2022-02-07 09:34:00,744.01,bad,565506.0
47553,1379669,185.233.0.15,78.0,pos trm,25,9667,250329786,CREDIT,0,active,2028-04-11,2022-02-25 06:11:28,744.1,country_transfer,564761.9
47554,1571179,78.24.158.249,951.0,atm,20,4967,250329786,CREDIT,0,active,2028-04-11,2022-03-06 08:44:21,743.94,from_acc,564017.96
47555,1628228,195.161.0.0,1162.0,cash_out,30,8928,250329786,CREDIT,0,active,2028-04-11,2022-03-12 07:33:22,743.58,transfer,563274.38
47556,1732391,95.181.0.150,259.0,port_trm,-1,6218,250329786,CREDIT,1,active,2028-04-11,2022-03-21 19:51:01,743.8,err,563274.38
47557,1859788,85.140.0.90,1255.0,ATM,20,8682,250329786,CREDIT,0,active,2028-04-11,2022-03-30 13:54:26,743.79,out,562530.59
47558,1879445,188.128.16.91,1190.0,pos trm,451,9009,250329786,CREDIT,0,active,2028-04-11,2022-05-12 13:04:43,743.88,payment,561786.71
47559,1935811,188.128.16.91,1190.0,pos trm,-1,1330,250329786,CREDIT,1,active,2028-04-11,2022-05-15 04:35:11,744.12,bad,561786.71
47560,2074920,95.181.0.240,267.0,ATM,451,3103,250329786,CREDIT,0,active,2028-04-11,2022-05-22 23:12:27,744.09,payment,561042.62
47561,2132165,185.233.0.15,78.0,pos trm,451,7537,250329786,CREDIT,0,active,2028-04-11,2022-05-23 06:42:46,744.26,payment,560298.36
47562,2134751,188.43.0.75,1409.0,cash_in,30,7537,250329786,CREDIT,0,active,2028-04-11,2022-06-10 15:00:10,744.22,transfer,559554.14
47563,2312863,188.128.16.91,1190.0,pos trm,25,4487,250329786,CREDIT,0,active,2028-04-11,2022-06-15 18:26:33,744.11,country_transfer,558810.03
47564,2318919,185.233.0.15,78.0,pos trm,25,8682,250329786,CREDIT,0,active,2028-04-11,2022-08-21 06:06:03,744.01,diff_cntry,558066.02
47565,2896404,195.161.0.0,1162.0,cash_out,-1,5937,250329786,CREDIT,1,active,2028-04-11,2022-08-26 07:47:47,744.06,err_code,558066.02
47566,3068935,188.128.16.91,1190.0,pos trm,-1,6218,250329786,CREDIT,2,active,2028-04-11,2022-08-28 04:36:01,743.85,bad,558066.02
47567,3422592,212.20.0.195,463.0,cash_in,10,1383,250329786,CREDIT,0,active,2028-04-11,2022-08-28 08:24:27,744.03,in,558810.05
47568,3696467,128.0.94.60,1101.0,cash_out,25,5199,250329786,CREDIT,0,active,2028-04-11,2022-08-28 13:03:41,744.09,country_transfer,558065.96
47569,3985578,95.181.0.150,259.0,port_trm,-1,8928,250329786,CREDIT,1,active,2028-04-11,2022-10-03 11:43:12,743.98,err_code,558065.96
47570,4011763,37.0.127.195,1036.0,cash_in,10,4967,250329786,CREDIT,0,active,2028-04-11,2022-10-13 02:27:03,743.93,add_on_acc,558809.89
47571,4248187,195.161.0.0,1162.0,cash_out,30,7537,250329786,CREDIT,0,active,2028-04-11,2022-10-26 07:39:44,743.91,transfer,558065.98
47572,4410164,151.0.38.90,394.0,ATM,20,8682,250329786,CREDIT,0,active,2028-04-11,2022-11-12 01:44:00,743.82,out,557322.16
47573,4826723,95.181.0.150,259.0,port_trm,30,4487,250329786,CREDIT,0,active,2028-04-11,2022-11-25 18:46:17,743.98,transfer,556578.18
47574,4850662,188.128.16.91,1190.0,pos trm,25,4522,250329786,CREDIT,0,active,2028-04-11,2022-11-26 12:00:01,744.01,diff_cntry,555834.17
47575,5325036,46.0.2.45,184.0,ATM,20,4487,250329786,CREDIT,0,active,2028-04-11,2022-12-29 00:39:20,743.81,out,555090.36
47576,5349173,188.0.169.195,482.0,cash_in,10,8140,250329786,CREDIT,0,active,2028-04-11,2023-01-06 18:05:37,743.99,in_acc,555834.35
47577,5565308,95.181.0.150,259.0,port_trm,451,4021,250329786,CREDIT,0,active,2028-04-11,2023-02-01 22:22:25,743.78,payment,555090.57
47578,5804480,95.181.0.150,259.0,port_trm,25,1601,250329786,CREDIT,0,active,2028-04-11,2023-04-02 05:45:40,743.9,diff_cntry,554346.67
47579,5954895,95.181.0.150,259.0,port_trm,-1,9667,250329786,CREDIT,1,active,2028-04-11,2023-05-14 02:47:20,744.07,bad,554346.67
47580,5981307,5.189.0.240,877.0,cash_out,451,4522,250329786,CREDIT,0,active,2028-04-11,2023-05-18 17:40:57,743.77,payment,553602.9
47581,6169784,185.17.0.180,1063.0,atm,10,4522,250329786,CREDIT,0,active,2028-04-11,2023-08-31 21:13:37,744.05,in_acc,554346.95
47582,6239560,188.43.0.75,1409.0,cash_in,25,1601,250329786,CREDIT,0,active,2028-04-11,2023-10-16 09:41:40,743.95,diff_cntry,553603.0
47583,6280334,95.181.0.150,259.0,port_trm,-1,9009,250329786,CREDIT,1,active,2028-04-11,2023-10-22 14:02:58,744.34,bad,553603.0
47584,6367649,85.140.0.240,1271.0,ATM,20,9048,250329786,CREDIT,0,active,2028-04-11,2023-11-04 13:51:41,743.78,out,552859.22
47585,6556398,188.43.0.15,1405.0,Portable term,30,4021,250329786,CREDIT,0,active,2028-04-11,2023-11-11 05:50:08,744.28,transfer,552114.94
47586,6816105,37.0.124.120,729.0,atm,10,6218,250329786,CREDIT,0,active,2028-04-11,2023-12-06 05:36:21,743.89,in,552858.83
47587,7024549,188.128.16.91,1190.0,pos trm,25,5199,250329786,CREDIT,0,active,2028-04-11,2023-12-20 16:39:16,743.97,diff_cntry,552114.86
47588,7088239,95.181.0.240,267.0,ATM,25,4256,250329786,CREDIT,0,active,2028-04-11,2024-02-03 22:40:00,743.75,country_transfer,551371.11
47589,7093266,5.189.0.240,877.0,cash_out,451,6218,250329786,CREDIT,0,active,2028-04-11,2024-02-17 12:49:47,743.85,payment,550627.26
47590,7140043,188.43.0.15,1405.0,Portable term,30,4967,250329786,CREDIT,0,active,2028-04-11,2024-03-15 05:44:03,743.75,transfer,549883.51
47591,7171978,5.189.0.240,877.0,cash_out,25,7537,250329786,CREDIT,0,active,2028-04-11,2024-03-16 02:28:44,744.05,country_transfer,549139.46
47592,7446883,194.87.0.165,577.0,atm,20,4522,250329786,CREDIT,0,active,2028-04-11,2024-03-25 11:25:11,743.78,out,548395.68
47593,7513573,195.58.0.105,1434.0,ATM,10,1383,250329786,CREDIT,0,active,2028-04-11,2024-04-12 03:20:52,744.14,in,549139.82
47594,7571213,5.189.0.180,871.0,ATM,10,4487,250329786,CREDIT,0,active,2028-04-11,2024-04-19 04:34:32,743.79,in_acc,549883.61
47595,8124667,185.233.0.15,78.0,pos trm,25,8502,250329786,CREDIT,0,active,2028-04-11,2024-04-25 11:36:10,744.12,country_transfer,549139.49
47596,8591523,188.43.0.75,1409.0,cash_in,30,5937,250329786,CREDIT,0,active,2028-04-11,2024-04-28 07:26:11,744.23,transfer,548395.26
47597,8833959,188.128.16.91,1190.0,pos trm,-1,4967,250329786,CREDIT,1,active,2028-04-11,2024-06-02 08:10:07,744.09,err_code,548395.26
47598,8867694,128.0.94.60,1101.0,cash_out,25,1601,250329786,CREDIT,0,active,2028-04-11,2024-09-02 16:15:09,743.94,country_transfer,547651.32
47599,9113475,95.181.0.240,267.0,ATM,451,4487,250329786,CREDIT,0,active,2028-04-11,2024-09-03 14:48:02,743.79,payment,546907.53
47600,9532542,195.161.0.0,1162.0,cash_out,30,4021,250329786,CREDIT,0,active,2028-04-11,2024-09-16 22:59:32,744.05,transfer,546163.48
47601,9604251,46.0.8.225,155.0,cash_in,10,3103,250329786,CREDIT,0,active,2028-04-11,2024-09-23 12:51:55,744.07,add_on_acc,546907.55
47602,9659557,185.233.0.15,78.0,pos trm,451,4487,250329786,CREDIT,0,active,2028-04-11,2024-10-06 20:36:04,744.09,payment,546163.46
47603,9728355,185.233.0.15,78.0,pos trm,451,1383,250329786,CREDIT,0,active,2028-04-11,2024-11-06 10:46:51,744.18,payment,545419.28
47604,9959303,46.0.9.60,1321.0,ATM,20,8140,250329786,CREDIT,0,active,2028-04-11,2024-11-10 23:18:20,744.08,decrease_on_acc,544675.2
47605,1051567,195.143.0.150,1377.0,ATM,30,5958,388241689,DEBIT,0,active,2029-04-18,2022-01-05 14:25:18,503.39,transfer,315381.61
47606,1603581,31.134.0.105,1123.0,cash_out,451,4121,388241689,DEBIT,0,active,2029-04-18,2022-01-15 06:21:55,502.84,payment,314878.77
47607,2502741,62.118.0.210,537.0,ATM,10,5722,388241689,DEBIT,0,active,2029-04-18,2022-01-27 18:30:48,502.85,in_acc,315381.62
47608,2547627,46.0.123.210,928.0,pos trm,451,8127,388241689,DEBIT,0,active,2029-04-18,2022-03-02 02:54:11,502.64,payment,314878.98
47609,2972373,46.0.2.180,194.0,cash_in,25,9497,388241689,DEBIT,0,active,2029-04-18,2022-03-23 03:21:45,503.1,country_transfer,314375.88
47610,3141315,195.143.0.150,1377.0,ATM,25,1355,388241689,DEBIT,0,active,2029-04-18,2022-04-17 05:42:06,502.99,diff_cntry,313872.89
47611,3379918,134.0.98.210,807.0,atm,30,6976,388241689,DEBIT,0,active,2029-04-18,2022-06-02 06:29:36,503.13,transfer,313369.76
47612,3391121,195.143.0.150,1377.0,ATM,451,3458,388241689,DEBIT,0,active,2029-04-18,2022-06-04 20:36:31,503.05,payment,312866.71
47613,3601835,194.87.0.225,584.0,atm,20,8625,388241689,DEBIT,0,active,2029-04-18,2022-06-19 17:51:54,503.15,from_acc,312363.56
47614,3748755,95.181.0.15,249.0,ATM,451,1355,388241689,DEBIT,0,active,2029-04-18,2022-07-24 16:55:20,502.82,payment,311860.74
47615,3789398,188.191.0.225,1159.0,atm,20,9249,388241689,DEBIT,0,active,2029-04-18,2022-08-08 09:41:00,503.08,from_acc,311357.66
47616,3805046,46.173.0.75,498.0,ATM,451,6523,388241689,DEBIT,0,active,2029-04-18,2022-08-11 22:51:44,502.75,payment,310854.91
47617,4312648,46.173.0.75,498.0,ATM,451,9497,388241689,DEBIT,0,active,2029-04-18,2022-08-19 05:01:25,503.0,payment,310351.91
47618,4487096,46.173.0.75,498.0,ATM,25,3458,388241689,DEBIT,0,active,2029-04-18,2022-08-30 10:10:26,503.07,country_transfer,309848.84
47619,4609732,195.143.0.150,1377.0,ATM,25,3635,388241689,DEBIT,0,active,2029-04-18,2022-09-25 17:40:29,503.05,diff_cntry,309345.79
47620,4687756,195.143.0.150,1377.0,ATM,25,5292,388241689,DEBIT,0,active,2029-04-18,2022-11-30 03:53:24,503.12,diff_cntry,308842.67
47621,4714234,31.134.0.105,1123.0,cash_out,451,8625,388241689,DEBIT,0,active,2029-04-18,2022-12-05 19:42:10,502.72,payment,308339.95
47622,4755183,134.0.98.210,807.0,atm,30,8685,388241689,DEBIT,0,active,2029-04-18,2022-12-06 14:22:09,502.82,transfer,307837.13
47623,4954267,46.173.0.75,498.0,ATM,451,3458,388241689,DEBIT,0,active,2029-04-18,2022-12-18 19:06:05,503.24,payment,307333.89
47624,5143638,46.0.2.180,194.0,cash_in,451,2450,388241689,DEBIT,0,active,2029-04-18,2022-12-29 13:42:45,503.06,payment,306830.83
47625,5180801,194.87.0.180,579.0,atm,10,5722,388241689,DEBIT,0,active,2029-04-18,2023-01-11 10:37:33,503.33,in_acc,307334.16
47626,5251882,128.0.82.15,611.0,ATM,20,2450,388241689,DEBIT,0,active,2029-04-18,2023-02-12 00:03:06,503.24,out,306830.92
47627,5263765,46.0.2.180,194.0,cash_in,30,3458,388241689,DEBIT,0,active,2029-04-18,2023-02-17 09:15:28,502.89,transfer,306328.03
47628,5597560,46.0.123.210,928.0,pos trm,25,2691,388241689,DEBIT,0,active,2029-04-18,2023-02-24 06:01:47,502.78,diff_cntry,305825.25
47629,5723372,31.134.0.105,1123.0,cash_out,30,3629,388241689,DEBIT,0,active,2029-04-18,2023-04-01 12:11:53,503.06,transfer,305322.19
47630,6248449,46.0.9.90,1323.0,port_trm,30,1355,388241689,DEBIT,0,active,2029-04-18,2023-05-18 21:07:28,503.03,transfer,304819.16
47631,6540188,194.0.144.90,167.0,cash_out,20,5722,388241689,DEBIT,0,active,2029-04-18,2023-05-25 18:33:45,503.22,out,304315.94
47632,6540782,88.210.0.120,350.0,atm,20,9993,388241689,DEBIT,0,active,2029-04-18,2023-05-27 23:16:37,502.9,from_acc,303813.04
47633,6541340,213.151.0.195,1015.0,atm,10,6523,388241689,DEBIT,0,active,2029-04-18,2023-05-30 07:23:37,502.82,in_acc,304315.86
47634,7004021,188.128.16.241,1205.0,atm,10,1432,388241689,DEBIT,0,active,2029-04-18,2023-06-06 07:58:06,503.34,in_acc,304819.2
47635,7055683,46.173.0.75,498.0,ATM,451,2691,388241689,DEBIT,0,active,2029-04-18,2023-06-23 14:46:22,502.79,payment,304316.41
47636,7125676,46.0.2.45,184.0,ATM,10,5292,388241689,DEBIT,0,active,2029-04-18,2023-08-21 21:49:42,503.06,in_acc,304819.47
47637,7497976,46.0.123.210,928.0,pos trm,30,5958,388241689,DEBIT,0,active,2029-04-18,2023-08-25 22:47:59,503.19,transfer,304316.28
47638,7579183,95.181.0.15,249.0,ATM,-1,6523,388241689,DEBIT,1,active,2029-04-18,2023-08-28 03:30:44,503.14,err,304316.28
47639,7581039,95.181.0.15,249.0,ATM,-1,6523,388241689,DEBIT,2,active,2029-04-18,2023-08-30 10:26:22,502.94,bad,304316.28
47640,7655504,31.134.0.105,1123.0,cash_out,30,9497,388241689,DEBIT,0,active,2029-04-18,2023-09-06 22:53:16,502.92,transfer,303813.36
47641,7677300,188.244.0.15,1449.0,ATM,20,8127,388241689,DEBIT,0,active,2029-04-18,2023-09-20 05:07:50,503.06,out,303310.3
47642,7870265,46.0.2.180,194.0,cash_in,25,5958,388241689,DEBIT,0,active,2029-04-18,2023-09-25 23:14:17,502.95,country_transfer,302807.35
47643,8343346,194.87.0.150,576.0,cash_out,20,8597,388241689,DEBIT,0,active,2029-04-18,2023-10-29 23:11:52,502.98,from_acc,302304.37
47644,8509438,128.0.24.90,889.0,ATM,10,2857,388241689,DEBIT,0,active,2029-04-18,2023-11-29 23:38:18,503.08,in,302807.45
47645,8517037,46.0.123.210,928.0,pos trm,30,3629,388241689,DEBIT,0,active,2029-04-18,2023-12-04 06:47:17,503.05,transfer,302304.4
47646,8521391,194.156.0.105,29.0,ATM,20,6523,388241689,DEBIT,0,active,2029-04-18,2023-12-19 10:51:25,503.02,out,301801.38
47647,8623656,195.143.0.150,1377.0,ATM,30,6976,388241689,DEBIT,0,active,2029-04-18,2023-12-24 20:36:15,503.08,transfer,301298.3
47648,8790150,37.0.124.45,723.0,cash_in,10,3458,388241689,DEBIT,0,active,2029-04-18,2024-01-23 01:00:38,502.83,in,301801.13
47649,8801391,46.0.9.90,1323.0,port_trm,451,9993,388241689,DEBIT,0,active,2029-04-18,2024-02-29 08:44:30,502.95,payment,301298.18
47650,8816244,95.181.0.15,249.0,ATM,451,1432,388241689,DEBIT,0,active,2029-04-18,2024-03-05 08:30:19,503.06,payment,300795.12
47651,8925155,46.0.123.210,928.0,pos trm,451,5664,388241689,DEBIT,0,active,2029-04-18,2024-03-11 04:05:24,503.0,payment,300292.12
47652,8945366,134.0.98.210,807.0,atm,-1,1432,388241689,DEBIT,1,active,2029-04-18,2024-03-24 10:55:21,502.94,err,300292.12
47653,9117055,194.87.0.225,584.0,atm,20,6976,388241689,DEBIT,0,active,2029-04-18,2024-03-29 02:42:18,502.95,out,299789.17
47654,9140290,134.0.98.240,809.0,pos trm,451,8597,388241689,DEBIT,0,active,2029-04-18,2024-05-01 01:23:23,503.01,payment,299286.16
47655,9315095,188.18.0.15,222.0,cash_out,20,5664,388241689,DEBIT,0,active,2029-04-18,2024-05-08 05:34:28,503.04,from_acc,298783.12
47656,9489559,46.173.0.75,498.0,ATM,-1,2450,388241689,DEBIT,1,active,2029-04-18,2024-05-10 05:02:29,503.15,err_code,298783.12
47657,9529676,79.104.60.240,444.0,cash_out,20,9139,388241689,DEBIT,0,active,2029-04-18,2024-05-13 12:04:59,503.1,from_acc,298280.02
47658,9633406,31.134.0.105,1123.0,cash_out,451,3635,388241689,DEBIT,0,active,2029-04-18,2024-05-19 19:53:54,503.07,payment,297776.95
47659,9732682,46.0.9.90,1323.0,port_trm,25,3458,388241689,DEBIT,0,active,2029-04-18,2024-05-25 20:30:07,502.87,diff_cntry,297274.08
47660,9784208,134.0.98.240,809.0,pos trm,30,6206,388241689,DEBIT,0,active,2029-04-18,2024-08-06 16:24:22,502.99,transfer,296771.09
47661,9899282,193.0.151.105,59.0,ATM,10,9139,388241689,DEBIT,0,active,2029-04-18,2024-10-25 05:42:24,502.56,add_on_acc,297273.65
47662,9924206,134.0.98.210,807.0,atm,30,5722,388241689,DEBIT,0,active,2029-04-18,2024-11-05 13:22:53,503.15,transfer,296770.5
47663,1009494,5.189.0.0,854.0,atm,451,3553,582783010,CREDIT,0,act,2028-04-22,2022-01-25 15:33:49,293.97,payment,214381.03
47664,1094964,77.242.0.75,276.0,ATM,20,9504,582783010,CREDIT,0,act,2028-04-22,2022-02-03 15:03:10,293.79,out,214087.24
47665,1333597,46.0.128.150,711.0,cash_out,30,5868,582783010,CREDIT,0,act,2028-04-22,2022-02-27 14:39:13,293.69,transfer,213793.55
47666,1371183,94.243.0.210,114.0,atm,451,8185,582783010,CREDIT,0,act,2028-04-22,2022-03-24 14:06:12,293.88,payment,213499.67
47667,1621203,212.20.0.30,448.0,ATM,10,6784,582783010,CREDIT,0,act,2028-04-22,2022-04-03 10:46:09,294.25,in_acc,213793.92
47668,1670181,46.0.128.150,711.0,cash_out,451,6715,582783010,CREDIT,0,act,2028-04-22,2022-05-19 07:42:25,294.13,payment,213499.79
47669,1907281,134.0.98.75,796.0,cash_out,20,5868,582783010,CREDIT,0,act,2028-04-22,2022-06-18 15:31:11,294.13,out,213205.66
47670,2117605,91.107.0.165,989.0,cash_in,10,7060,582783010,CREDIT,0,act,2028-04-22,2022-06-28 01:08:31,294.15,add_on_acc,213499.81
47671,2154732,46.0.54.45,1072.0,atm,20,3553,582783010,CREDIT,0,act,2028-04-22,2022-08-05 06:51:18,293.93,decrease_on_acc,213205.88
47672,2304263,94.243.0.210,114.0,atm,451,4367,582783010,CREDIT,0,act,2028-04-22,2022-08-27 08:04:30,293.97,payment,212911.91
47673,2888697,94.243.0.210,114.0,atm,-1,9504,582783010,CREDIT,1,act,2028-04-22,2022-09-11 04:14:37,293.7,err,212911.91
47674,2939085,94.243.0.210,114.0,atm,30,9896,582783010,CREDIT,0,act,2028-04-22,2022-10-31 00:31:24,293.94,transfer,212617.97
47675,3071611,5.189.0.0,854.0,atm,30,9474,582783010,CREDIT,0,act,2028-04-22,2022-11-16 08:42:44,293.99,transfer,212323.98
47676,3109053,46.0.54.0,1068.0,cash_out,451,7060,582783010,CREDIT,0,act,2028-04-22,2022-11-17 04:32:40,294.07,payment,212029.91
47677,3761399,194.87.0.90,572.0,atm,10,5490,582783010,CREDIT,0,act,2028-04-22,2022-12-09 19:33:01,294.14,add_on_acc,212324.05
47678,4025353,46.0.9.165,1328.0,port_trm,-1,5990,582783010,CREDIT,1,act,2028-04-22,2022-12-25 08:10:41,293.95,bad,212324.05
47679,4056005,188.191.0.195,1155.0,atm,451,8185,582783010,CREDIT,0,act,2028-04-22,2022-12-27 07:55:37,294.36,payment,212029.69
47680,4461986,46.0.128.150,711.0,cash_out,-1,7060,582783010,CREDIT,1,act,2028-04-22,2023-02-08 07:56:13,293.95,err,212029.69
47681,4768870,5.189.0.0,854.0,atm,451,5990,582783010,CREDIT,0,act,2028-04-22,2023-02-16 10:21:15,294.24,payment,211735.45
47682,5140629,46.0.0.105,662.0,cash_in,30,7497,582783010,CREDIT,0,act,2028-04-22,2023-02-20 04:07:52,293.78,transfer,211441.67
47683,5148837,188.191.0.195,1155.0,atm,451,8828,582783010,CREDIT,0,act,2028-04-22,2023-03-21 14:15:19,293.98,payment,211147.69
47684,5149979,46.0.9.165,1328.0,port_trm,451,8882,582783010,CREDIT,0,act,2028-04-22,2023-05-07 12:05:03,293.93,payment,210853.76
47685,5229811,94.243.0.210,114.0,atm,25,6784,582783010,CREDIT,0,act,2028-04-22,2023-05-09 06:11:49,294.14,diff_cntry,210559.62
47686,5464764,5.189.0.0,854.0,atm,30,3553,582783010,CREDIT,0,act,2028-04-22,2023-05-23 08:51:19,294.15,transfer,210265.47
47687,5842479,37.0.127.210,1037.0,ATM,20,7060,582783010,CREDIT,0,act,2028-04-22,2023-06-08 09:09:51,294.14,decrease_on_acc,209971.33
47688,5880314,46.0.0.105,662.0,cash_in,451,2184,582783010,CREDIT,0,act,2028-04-22,2023-07-10 15:27:33,293.86,payment,209677.47
47689,5965949,128.0.94.165,1110.0,atm,10,6014,582783010,CREDIT,0,act,2028-04-22,2023-07-11 10:13:23,293.87,add_on_acc,209971.34
47690,6001627,46.0.0.105,662.0,cash_in,25,7060,582783010,CREDIT,0,act,2028-04-22,2023-07-26 07:17:22,294.01,country_transfer,209677.33
47691,6211906,94.243.0.210,114.0,atm,451,7497,582783010,CREDIT,0,act,2028-04-22,2023-08-10 13:42:11,294.03,payment,209383.3
47692,6353413,188.191.0.195,1155.0,atm,-1,6784,582783010,CREDIT,1,act,2028-04-22,2023-08-26 12:58:09,294.02,bad,209383.3
47693,6453942,109.126.0.150,376.0,atm,10,6715,582783010,CREDIT,0,act,2028-04-22,2023-08-28 23:18:26,293.83,add_on_acc,209677.13
47694,6457799,46.0.54.0,1068.0,cash_out,-1,9504,582783010,CREDIT,1,act,2028-04-22,2023-08-30 05:04:07,293.96,err,209677.13
47695,6493345,5.189.0.0,854.0,atm,25,8882,582783010,CREDIT,0,act,2028-04-22,2023-09-01 21:46:00,293.81,diff_cntry,209383.32
47696,6582353,128.0.94.195,1112.0,cash_in,10,6784,582783010,CREDIT,0,act,2028-04-22,2023-09-03 09:11:27,293.91,in_acc,209677.23
47697,6705975,91.107.0.60,979.0,ATM,10,7497,582783010,CREDIT,0,act,2028-04-22,2023-09-27 02:04:27,294.09,add_on_acc,209971.32
47698,6719979,94.243.0.210,114.0,atm,451,5868,582783010,CREDIT,0,act,2028-04-22,2023-10-31 14:23:06,293.94,payment,209677.38
47699,6756095,5.189.0.0,854.0,atm,25,8828,582783010,CREDIT,0,act,2028-04-22,2023-11-21 20:43:11,294.34,country_transfer,209383.04
47700,6897911,46.0.0.105,662.0,cash_in,25,8882,582783010,CREDIT,0,act,2028-04-22,2024-01-04 19:47:55,294.01,diff_cntry,209089.03
47701,7187826,95.167.0.225,218.0,ATM,10,8828,582783010,CREDIT,0,act,2028-04-22,2024-01-06 08:40:08,293.74,in_acc,209382.77
47702,7796478,46.0.54.0,1068.0,cash_out,25,7497,582783010,CREDIT,0,act,2028-04-22,2024-01-07 21:16:22,294.03,country_transfer,209088.74
47703,7834652,88.210.0.75,346.0,atm,10,9504,582783010,CREDIT,0,act,2028-04-22,2024-01-25 17:04:17,294.12,add_on_acc,209382.86
47704,7956986,188.18.0.0,220.0,atm,20,8882,582783010,CREDIT,0,act,2028-04-22,2024-01-28 06:47:54,294.01,out,209088.85
47705,8005615,94.243.0.210,114.0,atm,-1,5666,582783010,CREDIT,1,act,2028-04-22,2024-02-03 10:09:04,294.13,err,209088.85
47706,8451813,188.191.0.195,1155.0,atm,30,6715,582783010,CREDIT,0,act,2028-04-22,2024-02-23 06:14:22,293.84,transfer,208795.01
47707,8483766,185.173.0.75,1278.0,ATM,10,5990,582783010,CREDIT,0,act,2028-04-22,2024-02-28 01:59:50,293.68,in_acc,209088.69
47708,8502311,46.0.0.105,662.0,cash_in,451,4882,582783010,CREDIT,0,act,2028-04-22,2024-03-13 12:45:51,293.82,payment,208794.87
47709,8506497,94.243.0.0,97.0,atm,10,6715,582783010,CREDIT,0,act,2028-04-22,2024-03-16 15:27:42,293.86,add_on_acc,209088.73
47710,8652648,5.189.0.0,854.0,atm,-1,6784,582783010,CREDIT,1,act,2028-04-22,2024-03-31 00:48:49,293.85,err_code,209088.73
47711,8726051,85.140.0.15,1247.0,atm,10,3553,582783010,CREDIT,0,act,2028-04-22,2024-04-24 01:55:19,293.73,in_acc,209382.46
47712,9022851,5.189.0.0,854.0,atm,-1,9896,582783010,CREDIT,1,act,2028-04-22,2024-05-03 01:31:12,294.15,err_code,209382.46
47713,9108955,212.20.0.75,454.0,cash_in,10,5868,582783010,CREDIT,0,act,2028-04-22,2024-05-03 12:41:22,293.92,in_acc,209676.38
47714,9138957,188.244.0.105,1459.0,cash_in,10,9474,582783010,CREDIT,0,act,2028-04-22,2024-05-22 04:35:19,294.2,in,209970.58
47715,9323390,46.0.128.150,711.0,cash_out,-1,8828,582783010,CREDIT,1,act,2028-04-22,2024-06-14 00:54:42,293.92,err,209970.58
47716,9344571,5.189.0.0,854.0,atm,451,4367,582783010,CREDIT,0,act,2028-04-22,2024-07-30 21:31:41,294.07,payment,209676.51
47717,9390532,188.191.0.195,1155.0,atm,-1,2184,582783010,CREDIT,1,act,2028-04-22,2024-08-18 08:07:55,293.96,err,209676.51
47718,9507844,5.189.0.0,854.0,atm,451,9896,582783010,CREDIT,0,act,2028-04-22,2024-09-08 00:39:53,293.99,payment,209382.52
47719,9660631,46.0.9.165,1328.0,port_trm,25,4367,582783010,CREDIT,0,act,2028-04-22,2024-11-01 09:08:15,293.6,diff_cntry,209088.92
47720,9848260,5.189.0.0,854.0,atm,451,4882,582783010,CREDIT,0,act,2028-04-22,2024-11-06 23:37:39,293.97,payment,208794.95
47721,9881359,46.0.54.0,1068.0,cash_out,30,2184,582783010,CREDIT,0,act,2028-04-22,2024-11-08 16:04:54,294.11,transfer,208500.84
47722,1170226,128.0.24.75,887.0,cash_out,451,4985,339231358,DEBIT,0,active,2030-03-30,2022-01-19 13:02:06,1023.97,payment,559166.03
47723,1340940,194.87.0.195,580.0,ATM,20,2500,339231358,DEBIT,0,active,2030-03-30,2022-01-24 07:15:24,1024.12,out,558141.91
47724,1903313,188.0.166.225,1315.0,atm,30,9223,339231358,DEBIT,0,active,2030-03-30,2022-02-16 00:40:34,1023.98,transfer,557117.93
47725,1975670,188.0.166.225,1315.0,atm,451,2538,339231358,DEBIT,0,active,2030-03-30,2022-03-07 00:02:02,1024.03,payment,556093.9
47726,1986147,128.0.24.75,887.0,cash_out,30,2538,339231358,DEBIT,0,active,2030-03-30,2022-03-10 16:30:00,1023.77,transfer,555070.13
47727,2159720,188.0.166.225,1315.0,atm,10,1858,339231358,DEBIT,0,active,2030-03-30,2022-03-30 12:23:38,1024.15,in_acc,556094.28
47728,2365803,81.17.0.0,1384.0,prtbl trm,-1,9060,339231358,DEBIT,1,active,2030-03-30,2022-04-16 06:25:33,1024.0,bad,556094.28
47729,3032603,81.17.0.0,1384.0,prtbl trm,451,9060,339231358,DEBIT,0,active,2030-03-30,2022-04-17 01:53:31,1023.79,payment,555070.49
47730,3062716,188.0.166.225,1315.0,atm,30,1657,339231358,DEBIT,0,active,2030-03-30,2022-05-29 09:32:36,1024.03,transfer,554046.46
47731,3155061,195.161.0.120,1172.0,pos trm,451,2278,339231358,DEBIT,0,active,2030-03-30,2022-06-13 03:28:53,1023.86,payment,553022.6
47732,3408649,195.58.0.120,1435.0,cash_out,20,8872,339231358,DEBIT,0,active,2030-03-30,2022-06-14 10:47:17,1024.15,from_acc,551998.45
47733,3492472,128.0.94.75,1102.0,cash_out,20,3957,339231358,DEBIT,0,active,2030-03-30,2022-06-23 07:40:16,1023.81,out,550974.64
47734,3561649,46.0.54.45,1072.0,atm,20,8872,339231358,DEBIT,0,active,2030-03-30,2022-07-14 14:51:56,1024.06,from_acc,549950.58
47735,4194101,46.0.0.150,665.0,cash_out,20,7464,339231358,DEBIT,0,active,2030-03-30,2022-09-08 22:09:57,1023.99,out,548926.59
47736,4251365,46.0.9.120,1325.0,ATM,20,3957,339231358,DEBIT,0,active,2030-03-30,2022-09-15 02:29:11,1024.15,decrease_on_acc,547902.44
47737,4323888,188.43.0.90,1410.0,cash_in,25,1657,339231358,DEBIT,0,active,2030-03-30,2022-10-27 00:04:51,1024.06,diff_cntry,546878.38
47738,4476434,188.0.166.225,1315.0,atm,451,8812,339231358,DEBIT,0,active,2030-03-30,2022-11-04 14:34:07,1023.81,payment,545854.57
47739,4700644,37.0.127.210,1037.0,ATM,10,9223,339231358,DEBIT,0,active,2030-03-30,2022-12-14 17:50:39,1024.12,add_on_acc,546878.69
47740,4797011,188.0.166.225,1315.0,atm,451,8456,339231358,DEBIT,0,active,2030-03-30,2022-12-23 16:41:51,1024.03,payment,545854.66
47741,4856804,81.17.0.0,1384.0,prtbl trm,451,4985,339231358,DEBIT,0,active,2030-03-30,2023-01-04 16:25:03,1023.89,payment,544830.77
47742,4947628,185.17.0.150,1061.0,cash_out,20,3957,339231358,DEBIT,0,active,2030-03-30,2023-01-18 00:48:44,1024.07,out,543806.7
47743,4948484,188.0.166.225,1315.0,atm,30,7464,339231358,DEBIT,0,active,2030-03-30,2023-02-20 14:42:29,1023.97,transfer,542782.73
47744,5041617,188.43.0.90,1410.0,cash_in,451,7464,339231358,DEBIT,0,active,2030-03-30,2023-03-23 00:59:28,1024.1,payment,541758.63
47745,5155372,128.0.24.75,887.0,cash_out,30,1657,339231358,DEBIT,0,active,2030-03-30,2023-05-15 22:28:00,1024.34,transfer,540734.29
47746,5193151,46.0.2.225,198.0,ATM,10,8872,339231358,DEBIT,0,active,2030-03-30,2023-06-12 17:46:48,1024.22,in,541758.51
47747,5245337,95.167.0.240,219.0,ATM,10,2538,339231358,DEBIT,0,active,2030-03-30,2023-07-17 10:09:18,1024.18,in,542782.69
47748,5989731,213.151.0.195,1015.0,atm,20,2278,339231358,DEBIT,0,active,2030-03-30,2023-08-16 04:24:21,1023.97,decrease_on_acc,541758.72
47749,6003965,188.244.0.105,1459.0,cash_in,10,2278,339231358,DEBIT,0,active,2030-03-30,2023-10-11 14:57:26,1023.85,in,542782.57
47750,6035031,128.0.24.75,887.0,cash_out,451,9060,339231358,DEBIT,0,active,2030-03-30,2024-02-01 23:24:22,1024.02,payment,541758.55
47751,6745176,195.161.0.120,1172.0,pos trm,30,9060,339231358,DEBIT,0,active,2030-03-30,2024-02-02 15:17:42,1024.16,transfer,540734.39
47752,6816802,195.161.0.120,1172.0,pos trm,451,7203,339231358,DEBIT,0,active,2030-03-30,2024-02-09 19:57:04,1024.12,payment,539710.27
47753,7037164,81.17.0.0,1384.0,prtbl trm,25,9223,339231358,DEBIT,0,active,2030-03-30,2024-02-12 17:17:22,1023.99,diff_cntry,538686.28
47754,7522566,37.0.127.210,1037.0,ATM,10,9223,339231358,DEBIT,0,active,2030-03-30,2024-02-24 03:43:11,1024.0,in,539710.28
47755,7581886,195.161.0.120,1172.0,pos trm,451,1858,339231358,DEBIT,0,active,2030-03-30,2024-02-25 20:17:38,1024.13,payment,538686.15
47756,7931198,128.0.24.75,887.0,cash_out,30,2500,339231358,DEBIT,0,active,2030-03-30,2024-03-14 15:58:26,1023.89,transfer,537662.26
47757,7979114,195.161.0.120,1172.0,pos trm,451,2538,339231358,DEBIT,0,active,2030-03-30,2024-03-15 07:26:01,1024.03,payment,536638.23
47758,8156640,188.191.0.135,1150.0,atm,10,8812,339231358,DEBIT,0,active,2030-03-30,2024-03-15 21:50:20,1023.86,add_on_acc,537662.09
47759,8369270,128.0.24.75,887.0,cash_out,451,2538,339231358,DEBIT,0,active,2030-03-30,2024-04-14 02:21:01,1024.04,payment,536638.05
47760,8511630,78.24.158.69,937.0,atm,10,6490,339231358,DEBIT,0,active,2030-03-30,2024-06-02 08:18:07,1024.04,add_on_acc,537662.09
47761,8566299,188.43.0.90,1410.0,cash_in,-1,2278,339231358,DEBIT,1,active,2030-03-30,2024-06-07 22:49:23,1024.14,bad,537662.09
47762,8588319,188.0.166.225,1315.0,atm,-1,2538,339231358,DEBIT,2,active,2030-03-30,2024-06-16 15:27:49,1023.83,err_code,537662.09
47763,8896350,188.43.0.90,1410.0,cash_in,25,9223,339231358,DEBIT,0,active,2030-03-30,2024-06-26 09:53:23,1024.07,diff_cntry,536638.02
47764,8905902,195.161.0.120,1172.0,pos trm,451,1858,339231358,DEBIT,0,active,2030-03-30,2024-07-15 14:58:49,1024.04,payment,535613.98
47765,9070641,195.161.0.120,1172.0,pos trm,-1,7203,339231358,DEBIT,1,active,2030-03-30,2024-08-27 14:51:06,1023.74,err_code,535613.98
47766,9273748,195.161.0.120,1172.0,pos trm,-1,3760,339231358,DEBIT,2,active,2030-03-30,2024-08-27 18:24:44,1023.96,err_code,535613.98
47767,9361583,128.0.24.75,887.0,cash_out,25,2500,339231358,DEBIT,0,active,2030-03-30,2024-09-17 14:27:45,1024.25,diff_cntry,534589.73
47768,9442256,188.43.0.90,1410.0,cash_in,25,6689,339231358,DEBIT,0,active,2030-03-30,2024-09-21 23:40:29,1024.22,diff_cntry,533565.51
47769,9561492,77.242.0.15,269.0,atm,20,8854,339231358,DEBIT,0,active,2030-03-30,2024-10-08 06:14:59,1023.93,from_acc,532541.58
47770,9675171,81.17.0.0,1384.0,prtbl trm,30,9223,339231358,DEBIT,0,active,2030-03-30,2024-10-24 13:07:03,1023.8,transfer,531517.78
47771,9977325,81.17.0.0,1384.0,prtbl trm,451,1858,339231358,DEBIT,0,active,2030-03-30,2024-11-19 10:16:35,1024.16,payment,530493.62
47772,9984648,37.0.123.15,319.0,atm,10,7464,339231358,DEBIT,0,active,2030-03-30,2024-11-19 13:16:34,1023.79,in,531517.41
47773,1244588,91.107.0.45,977.0,Portable term,25,7695,541574267,DEBIT,0,act,2026-11-11,2022-01-02 11:39:42,1180.13,diff_cntry,982076.87
47774,1271407,188.0.169.120,476.0,cash_in,451,9941,541574267,DEBIT,0,act,2026-11-11,2022-01-05 17:13:57,1180.3,payment,980896.57
47775,1387398,194.0.144.90,167.0,cash_out,20,7008,541574267,DEBIT,0,act,2026-11-11,2022-01-12 01:07:37,1180.16,decrease_on_acc,979716.41
47776,1738439,91.107.0.45,977.0,Portable term,451,9941,541574267,DEBIT,0,act,2026-11-11,2022-01-16 20:44:47,1179.99,payment,978536.42
47777,1857554,188.0.169.120,476.0,cash_in,30,3908,541574267,DEBIT,0,act,2026-11-11,2022-02-22 10:37:38,1180.18,transfer,977356.24
47778,1972253,46.0.143.105,819.0,cash_out,451,8486,541574267,DEBIT,0,act,2026-11-11,2022-03-07 21:19:15,1179.95,payment,976176.29
47779,2532879,195.161.0.90,1169.0,ATM,20,6007,541574267,DEBIT,0,act,2026-11-11,2022-03-11 15:41:29,1180.02,from_acc,974996.27
47780,2633032,128.0.82.90,618.0,pos trm,451,9941,541574267,DEBIT,0,act,2026-11-11,2022-03-16 01:13:02,1179.98,payment,973816.29
47781,2760654,46.0.143.105,819.0,cash_out,25,9267,541574267,DEBIT,0,act,2026-11-11,2022-04-05 02:22:29,1180.21,diff_cntry,972636.08
47782,2790161,46.0.8.90,144.0,cash_in,10,9941,541574267,DEBIT,0,act,2026-11-11,2022-05-10 07:52:06,1180.12,in,973816.2
47783,2991330,46.0.143.105,819.0,cash_out,30,3908,541574267,DEBIT,0,act,2026-11-11,2022-05-22 17:08:31,1179.83,transfer,972636.37
47784,3156088,46.0.123.0,909.0,cash_out,20,2893,541574267,DEBIT,0,act,2026-11-11,2022-06-06 11:12:50,1180.09,decrease_on_acc,971456.28
47785,3185036,85.140.0.90,1255.0,ATM,10,3520,541574267,DEBIT,0,act,2026-11-11,2022-06-29 23:22:12,1180.02,in,972636.3
47786,3289237,46.0.123.45,913.0,atm,10,5761,541574267,DEBIT,0,act,2026-11-11,2022-07-09 12:58:37,1179.88,in_acc,973816.18
47787,3336485,193.31.0.45,589.0,cash_in,10,3520,541574267,DEBIT,0,act,2026-11-11,2022-07-15 22:12:20,1180.07,add_on_acc,974996.25
47788,3784396,46.0.9.225,1338.0,ATM,10,9941,541574267,DEBIT,0,act,2026-11-11,2022-07-21 01:12:20,1179.63,in,976175.88
47789,3853177,46.173.0.120,503.0,ATM,25,8486,541574267,DEBIT,0,act,2026-11-11,2022-07-23 20:43:01,1180.24,country_transfer,974995.64
47790,3866662,46.0.143.105,819.0,cash_out,-1,3908,541574267,DEBIT,1,act,2026-11-11,2022-08-31 07:30:52,1179.88,err,974995.64
47791,3906380,46.173.0.120,503.0,ATM,-1,3908,541574267,DEBIT,2,act,2026-11-11,2022-09-30 09:17:18,1179.82,err_code,974995.64
47792,3995795,46.173.0.120,503.0,ATM,25,3090,541574267,DEBIT,0,act,2026-11-11,2022-10-07 03:57:23,1180.08,diff_cntry,973815.56
47793,4516128,217.26.0.150,689.0,ATM,10,5761,541574267,DEBIT,0,act,2026-11-11,2022-10-30 16:47:04,1180.0,add_on_acc,974995.56
47794,4998375,95.167.0.15,201.0,cash_in,10,4965,541574267,DEBIT,0,act,2026-11-11,2022-11-05 03:02:41,1179.97,in,976175.53
47795,5018099,95.167.0.60,204.0,ATM,20,3908,541574267,DEBIT,0,act,2026-11-11,2022-11-11 13:50:18,1179.99,from_acc,974995.54
47796,5216094,194.156.0.240,41.0,cash_out,20,2112,541574267,DEBIT,0,act,2026-11-11,2022-12-02 08:53:29,1179.98,decrease_on_acc,973815.56
47797,5254740,46.0.143.105,819.0,cash_out,30,9192,541574267,DEBIT,0,act,2026-11-11,2023-01-10 22:11:39,1179.86,transfer,972635.7
47798,5382230,91.107.0.45,977.0,Portable term,451,2072,541574267,DEBIT,0,act,2026-11-11,2023-02-18 13:59:07,1179.96,payment,971455.74
47799,5550054,91.107.0.45,977.0,Portable term,25,7008,541574267,DEBIT,0,act,2026-11-11,2023-02-23 15:48:30,1180.1,diff_cntry,970275.64
47800,5585565,188.43.0.60,1408.0,cash_in,10,6007,541574267,DEBIT,0,act,2026-11-11,2023-02-25 17:57:44,1180.14,add_on_acc,971455.78
47801,5684361,46.0.143.105,819.0,cash_out,30,3090,541574267,DEBIT,0,act,2026-11-11,2023-02-27 02:20:50,1179.83,transfer,970275.95
47802,6285093,46.0.143.105,819.0,cash_out,-1,5761,541574267,DEBIT,1,act,2026-11-11,2023-03-21 23:00:39,1180.05,err_code,970275.95
47803,6461176,128.0.24.15,880.0,cash_in,10,9306,541574267,DEBIT,0,act,2026-11-11,2023-04-05 18:14:26,1180.07,in,971456.02
47804,6538862,46.0.143.105,819.0,cash_out,25,9192,541574267,DEBIT,0,act,2026-11-11,2023-04-07 20:59:18,1179.91,country_transfer,970276.11
47805,6753023,46.173.0.120,503.0,ATM,30,4482,541574267,DEBIT,0,act,2026-11-11,2023-04-20 16:59:06,1179.93,transfer,969096.18
47806,6769861,46.0.143.105,819.0,cash_out,-1,2668,541574267,DEBIT,1,act,2026-11-11,2023-06-19 23:48:39,1180.34,bad,969096.18
47807,6916324,188.0.169.120,476.0,cash_in,451,4965,541574267,DEBIT,0,act,2026-11-11,2023-07-17 23:02:01,1180.0,payment,967916.18
47808,7074517,46.173.0.120,503.0,ATM,451,2072,541574267,DEBIT,0,act,2026-11-11,2023-08-01 04:11:11,1179.87,payment,966736.31
47809,7074797,195.161.0.90,1169.0,ATM,20,9941,541574267,DEBIT,0,act,2026-11-11,2023-08-10 19:23:14,1180.06,out,965556.25
47810,7110549,194.87.0.180,579.0,atm,20,3675,541574267,DEBIT,0,act,2026-11-11,2023-08-13 05:14:44,1179.9,decrease_on_acc,964376.35
47811,7450532,213.151.0.195,1015.0,atm,10,2668,541574267,DEBIT,0,act,2026-11-11,2023-09-18 05:18:13,1179.75,in_acc,965556.1
47812,7612116,46.0.143.90,818.0,cash_in,10,2893,541574267,DEBIT,0,act,2026-11-11,2023-09-29 15:20:18,1180.18,in_acc,966736.28
47813,7639266,31.134.0.120,1124.0,ATM,20,9192,541574267,DEBIT,0,act,2026-11-11,2023-10-04 21:03:08,1179.93,from_acc,965556.35
47814,7664171,188.0.169.120,476.0,cash_in,451,6007,541574267,DEBIT,0,act,2026-11-11,2023-10-13 04:31:16,1179.72,payment,964376.63
47815,7691290,46.0.143.105,819.0,cash_out,25,3520,541574267,DEBIT,0,act,2026-11-11,2023-10-25 17:18:02,1179.99,country_transfer,963196.64
47816,8095607,31.134.0.195,1132.0,atm,10,2893,541574267,DEBIT,0,act,2026-11-11,2024-03-06 01:24:27,1180.05,in_acc,964376.69
47817,8149997,46.0.54.225,1092.0,cash_in,10,3908,541574267,DEBIT,0,act,2026-11-11,2024-03-06 07:55:39,1179.79,add_on_acc,965556.48
47818,8177085,46.0.143.105,819.0,cash_out,25,6105,541574267,DEBIT,0,act,2026-11-11,2024-03-18 04:39:38,1180.07,diff_cntry,964376.41
47819,8220831,128.0.82.90,618.0,pos trm,25,3908,541574267,DEBIT,0,act,2026-11-11,2024-03-26 10:04:15,1180.02,diff_cntry,963196.39
47820,8231949,46.0.143.105,819.0,cash_out,30,4965,541574267,DEBIT,0,act,2026-11-11,2024-04-04 08:39:24,1179.82,transfer,962016.57
47821,8457656,128.0.82.90,618.0,pos trm,-1,9306,541574267,DEBIT,1,act,2026-11-11,2024-04-16 12:25:03,1180.07,err_code,962016.57
47822,8598369,45.154.0.210,314.0,atm,10,3675,541574267,DEBIT,0,act,2026-11-11,2024-04-19 21:33:34,1180.23,add_on_acc,963196.8
47823,8661055,128.0.82.90,618.0,pos trm,30,4965,541574267,DEBIT,0,act,2026-11-11,2024-04-27 04:32:14,1179.85,transfer,962016.95
47824,8847823,128.0.82.90,618.0,pos trm,30,7695,541574267,DEBIT,0,act,2026-11-11,2024-05-26 02:04:46,1179.96,transfer,960836.99
47825,8974268,91.107.0.45,977.0,Portable term,-1,6007,541574267,DEBIT,1,act,2026-11-11,2024-08-11 10:25:08,1180.13,err_code,960836.99
47826,9008744,128.0.82.90,618.0,pos trm,451,9267,541574267,DEBIT,0,act,2026-11-11,2024-08-21 18:01:56,1179.81,payment,959657.18
47827,9064901,91.107.0.45,977.0,Portable term,-1,9941,541574267,DEBIT,1,act,2026-11-11,2024-08-31 18:53:19,1180.22,bad,959657.18
47828,9209317,91.107.0.45,977.0,Portable term,451,2188,541574267,DEBIT,0,act,2026-11-11,2024-10-22 08:23:28,1179.81,payment,958477.37
47829,9406310,188.0.169.120,476.0,cash_in,451,6007,541574267,DEBIT,0,act,2026-11-11,2024-10-30 12:20:19,1180.02,payment,957297.35
47830,9762236,128.0.82.90,618.0,pos trm,25,3090,541574267,DEBIT,0,act,2026-11-11,2024-11-07 13:24:35,1179.96,diff_cntry,956117.39
47831,9956458,37.0.124.240,738.0,cash_out,20,2188,541574267,DEBIT,0,act,2026-11-11,2024-11-08 01:01:08,1180.15,decrease_on_acc,954937.24
47832,1006874,134.0.98.75,796.0,cash_out,25,5993,703914321,DEBIT,0,active,2025-02-06,2022-01-25 09:47:50,1169.88,country_transfer,458757.12
47833,1242683,194.87.0.15,567.0,cash_in,451,8168,703914321,DEBIT,0,active,2025-02-06,2022-02-05 10:37:11,1169.81,payment,457587.31
47834,1421606,195.161.0.180,1176.0,port_trm,30,7980,703914321,DEBIT,0,active,2025-02-06,2022-03-08 22:20:16,1170.06,transfer,456417.25
47835,1471412,195.161.0.180,1176.0,port_trm,-1,8887,703914321,DEBIT,1,active,2025-02-06,2022-03-22 01:41:14,1170.15,err_code,456417.25
47836,1530641,31.134.0.45,1119.0,atm,30,8168,703914321,DEBIT,0,active,2025-02-06,2022-05-11 00:27:20,1170.29,transfer,455246.96
47837,1585812,46.0.143.90,818.0,cash_in,10,7574,703914321,DEBIT,0,active,2025-02-06,2022-06-26 14:12:59,1170.04,in,456417.0
47838,1835738,37.0.127.240,1039.0,cash_in,25,8793,703914321,DEBIT,0,active,2025-02-06,2022-08-03 11:03:36,1170.1,country_transfer,455246.9
47839,1861353,194.87.0.15,567.0,cash_in,451,7980,703914321,DEBIT,0,active,2025-02-06,2022-08-31 14:34:23,1170.08,payment,454076.82
47840,1916224,79.104.0.240,653.0,cash_in,30,6494,703914321,DEBIT,0,active,2025-02-06,2022-09-18 12:30:44,1170.06,transfer,452906.76
47841,1922579,134.0.98.75,796.0,cash_out,30,2472,703914321,DEBIT,0,active,2025-02-06,2022-10-10 07:30:01,1169.8,transfer,451736.96
47842,1968975,79.104.60.225,443.0,cash_out,30,3008,703914321,DEBIT,0,active,2025-02-06,2022-11-04 00:00:39,1170.28,transfer,450566.68
47843,2182358,188.43.0.135,1413.0,ATM,20,9587,703914321,DEBIT,0,active,2025-02-06,2022-11-28 15:31:35,1170.1,from_acc,449396.58
47844,2183782,134.0.98.75,796.0,cash_out,451,7214,703914321,DEBIT,0,active,2025-02-06,2022-12-08 05:59:40,1169.93,payment,448226.65
47845,2313704,195.161.0.180,1176.0,port_trm,30,1111,703914321,DEBIT,0,active,2025-02-06,2023-01-23 02:50:51,1169.76,transfer,447056.89
47846,2337210,79.104.0.240,653.0,cash_in,451,6494,703914321,DEBIT,0,active,2025-02-06,2023-01-29 17:50:55,1170.23,payment,445886.66
47847,2667292,79.104.0.240,653.0,cash_in,30,4550,703914321,DEBIT,0,active,2025-02-06,2023-02-17 01:11:31,1169.97,transfer,444716.69
47848,2673171,79.104.60.225,443.0,cash_out,30,7768,703914321,DEBIT,0,active,2025-02-06,2023-04-06 07:21:50,1170.03,transfer,443546.66
47849,2983130,31.134.0.45,1119.0,atm,30,7980,703914321,DEBIT,0,active,2025-02-06,2023-04-12 15:58:54,1170.12,transfer,442376.54
47850,3105789,31.134.0.45,1119.0,atm,-1,3008,703914321,DEBIT,1,active,2025-02-06,2023-04-23 14:39:41,1169.78,err,442376.54
47851,3525729,195.161.0.180,1176.0,port_trm,30,4550,703914321,DEBIT,0,active,2025-02-06,2023-05-07 21:18:53,1169.99,transfer,441206.55
47852,3916064,31.134.0.90,1122.0,cash_in,10,3599,703914321,DEBIT,0,active,2025-02-06,2023-05-13 04:13:41,1169.96,in,442376.51
47853,3940008,91.107.0.180,990.0,atm,10,7574,703914321,DEBIT,0,active,2025-02-06,2023-05-19 19:33:53,1169.95,in_acc,443546.46
47854,4284495,151.0.38.225,406.0,cash_in,10,5839,703914321,DEBIT,0,active,2025-02-06,2023-06-16 04:52:30,1169.91,in_acc,444716.37
47855,4319438,88.210.0.120,350.0,atm,20,8168,703914321,DEBIT,0,active,2025-02-06,2023-06-26 19:26:31,1170.03,from_acc,443546.34
47856,4569897,194.87.0.15,567.0,cash_in,25,4008,703914321,DEBIT,0,active,2025-02-06,2023-08-02 02:37:34,1170.43,country_transfer,442375.91
47857,4585201,134.0.98.75,796.0,cash_out,451,5918,703914321,DEBIT,0,active,2025-02-06,2023-08-15 23:11:09,1170.12,payment,441205.79
47858,4595500,46.0.2.0,180.0,atm,20,5918,703914321,DEBIT,0,active,2025-02-06,2023-08-30 05:07:15,1170.01,from_acc,440035.78
47859,4801005,79.104.0.240,653.0,cash_in,25,2257,703914321,DEBIT,0,active,2025-02-06,2023-09-08 01:13:46,1170.05,diff_cntry,438865.73
47860,5009002,79.104.60.225,443.0,cash_out,30,8887,703914321,DEBIT,0,active,2025-02-06,2023-09-14 20:57:15,1169.95,transfer,437695.78
47861,5016376,5.189.0.180,871.0,ATM,10,5993,703914321,DEBIT,0,active,2025-02-06,2023-10-01 20:47:14,1169.83,in_acc,438865.61
47862,5102745,134.0.98.75,796.0,cash_out,25,7980,703914321,DEBIT,0,active,2025-02-06,2023-10-17 15:06:45,1170.06,country_transfer,437695.55
47863,5126426,134.0.98.75,796.0,cash_out,451,7768,703914321,DEBIT,0,active,2025-02-06,2023-11-09 21:09:30,1169.85,payment,436525.7
47864,5689243,46.0.128.90,705.0,cash_in,10,8309,703914321,DEBIT,0,active,2025-02-06,2023-11-15 16:07:33,1170.08,add_on_acc,437695.78
47865,5737381,46.0.123.225,929.0,ATM,20,4550,703914321,DEBIT,0,active,2025-02-06,2023-11-17 19:58:56,1169.81,decrease_on_acc,436525.97
47866,5784277,37.0.124.75,726.0,ATM,10,2595,703914321,DEBIT,0,active,2025-02-06,2023-12-22 01:22:47,1169.73,in,437695.7
47867,6050600,128.0.82.15,611.0,ATM,20,9231,703914321,DEBIT,0,active,2025-02-06,2024-01-21 01:10:16,1170.13,from_acc,436525.57
47868,6053717,5.189.0.60,860.0,cash_in,10,5839,703914321,DEBIT,0,active,2025-02-06,2024-02-07 09:06:53,1170.08,add_on_acc,437695.65
47869,6514877,79.104.60.225,443.0,cash_out,25,8793,703914321,DEBIT,0,active,2025-02-06,2024-02-07 13:36:21,1170.16,diff_cntry,436525.49
47870,6630387,194.87.0.15,567.0,cash_in,25,3599,703914321,DEBIT,0,active,2025-02-06,2024-02-19 21:05:22,1169.86,diff_cntry,435355.63
47871,7408845,194.87.0.15,567.0,cash_in,25,2257,703914321,DEBIT,0,active,2025-02-06,2024-02-22 11:33:58,1170.14,country_transfer,434185.49
47872,7625376,134.0.98.75,796.0,cash_out,-1,7574,703914321,DEBIT,1,active,2025-02-06,2024-03-11 02:00:01,1169.85,err_code,434185.49
47873,7817905,195.161.0.180,1176.0,port_trm,451,7980,703914321,DEBIT,0,active,2025-02-06,2024-04-26 02:54:22,1170.06,payment,433015.43
47874,7863475,195.161.0.180,1176.0,port_trm,451,2595,703914321,DEBIT,0,active,2025-02-06,2024-05-10 16:09:42,1170.04,payment,431845.39
47875,8038395,194.87.0.15,567.0,cash_in,451,9231,703914321,DEBIT,0,active,2025-02-06,2024-05-12 05:52:52,1170.11,payment,430675.28
47876,8394917,79.104.0.240,653.0,cash_in,25,2257,703914321,DEBIT,0,active,2025-02-06,2024-05-13 05:59:57,1169.96,country_transfer,429505.32
47877,8536350,212.20.0.150,459.0,cash_in,10,8887,703914321,DEBIT,0,active,2025-02-06,2024-06-21 16:25:12,1170.09,add_on_acc,430675.41
47878,8539550,185.17.0.135,1060.0,cash_in,10,5918,703914321,DEBIT,0,active,2025-02-06,2024-06-22 00:24:54,1170.09,in_acc,431845.5
47879,8648733,37.0.127.240,1039.0,cash_in,451,5839,703914321,DEBIT,0,active,2025-02-06,2024-10-04 12:09:05,1170.15,payment,430675.35
47880,8880383,79.104.60.225,443.0,cash_out,25,5839,703914321,DEBIT,0,active,2025-02-06,2024-10-09 09:29:02,1169.79,diff_cntry,429505.56
47881,9346835,79.104.60.225,443.0,cash_out,451,5417,703914321,DEBIT,0,active,2025-02-06,2024-10-24 06:54:10,1170.12,payment,428335.44
47882,9572967,79.104.60.225,443.0,cash_out,451,5417,703914321,DEBIT,0,active,2025-02-06,2024-11-09 00:09:07,1170.17,payment,427165.27
47883,9648144,79.104.60.225,443.0,cash_out,25,6718,703914321,DEBIT,0,active,2025-02-06,2024-11-13 13:44:15,1169.88,country_transfer,425995.39
47884,9895722,195.161.0.180,1176.0,port_trm,30,8793,703914321,DEBIT,0,active,2025-02-06,2024-11-21 09:51:47,1169.95,transfer,424825.44
47885,1028226,86.111.0.105,1351.0,Portable term,451,6514,841284706,CREDIT,0,active,2026-06-11,2022-01-04 13:08:00,122.0,payment,572433.0
47886,1154368,195.143.0.210,1381.0,port_trm,451,9758,841284706,CREDIT,0,active,2026-06-11,2022-02-15 02:20:29,121.87,payment,572311.13
47887,1239193,79.104.0.90,642.0,ATM,25,4834,841284706,CREDIT,0,active,2026-06-11,2022-02-23 18:22:31,122.11,diff_cntry,572189.02
47888,1318544,85.140.0.240,1271.0,ATM,30,7691,841284706,CREDIT,0,active,2026-06-11,2022-03-03 10:22:56,121.9,transfer,572067.12
47889,1443962,95.167.0.210,217.0,prtbl trm,451,8677,841284706,CREDIT,0,active,2026-06-11,2022-03-09 22:55:05,121.92,payment,571945.2
47890,1583243,95.167.0.210,217.0,prtbl trm,451,2102,841284706,CREDIT,0,active,2026-06-11,2022-03-18 06:26:15,122.18,payment,571823.02
47891,1682161,85.140.0.240,1271.0,ATM,25,8199,841284706,CREDIT,0,active,2026-06-11,2022-03-24 09:49:53,121.85,diff_cntry,571701.17
47892,1806525,79.104.0.90,642.0,ATM,25,5444,841284706,CREDIT,0,active,2026-06-11,2022-04-08 06:04:35,121.86,diff_cntry,571579.31
47893,1890164,94.243.0.180,112.0,prtbl trm,451,8199,841284706,CREDIT,0,active,2026-06-11,2022-04-09 19:11:06,121.9,payment,571457.41
47894,2150836,86.111.0.105,1351.0,Portable term,25,1444,841284706,CREDIT,0,active,2026-06-11,2022-05-29 09:44:29,122.13,diff_cntry,571335.28
47895,2536085,85.140.0.240,1271.0,ATM,-1,6362,841284706,CREDIT,1,active,2026-06-11,2022-06-20 13:26:07,121.89,err,571335.28
47896,2713315,217.112.0.30,1474.0,ATM,20,6514,841284706,CREDIT,0,active,2026-06-11,2022-08-15 07:00:10,122.05,decrease_on_acc,571213.23
47897,2791472,94.243.0.180,112.0,prtbl trm,451,6362,841284706,CREDIT,0,active,2026-06-11,2022-08-18 13:04:30,121.84,payment,571091.39
47898,2826838,86.111.0.105,1351.0,Portable term,-1,9084,841284706,CREDIT,1,active,2026-06-11,2022-08-27 15:10:59,121.91,bad,571091.39
47899,3222491,86.111.0.105,1351.0,Portable term,451,5444,841284706,CREDIT,0,active,2026-06-11,2022-09-03 23:45:23,122.08,payment,570969.31
47900,3397482,195.143.0.210,1381.0,port_trm,25,9084,841284706,CREDIT,0,active,2026-06-11,2022-10-23 17:40:47,121.81,country_transfer,570847.5
47901,3541001,45.154.0.240,317.0,port_trm,25,6563,841284706,CREDIT,0,active,2026-06-11,2023-01-28 20:56:58,121.67,diff_cntry,570725.83
47902,3874932,95.167.0.210,217.0,prtbl trm,451,5973,841284706,CREDIT,0,active,2026-06-11,2023-02-13 02:31:10,121.86,payment,570603.97
47903,4027158,45.154.0.240,317.0,port_trm,451,3692,841284706,CREDIT,0,active,2026-06-11,2023-02-15 05:14:07,122.11,payment,570481.86
47904,4082374,77.242.0.15,269.0,atm,30,6514,841284706,CREDIT,0,active,2026-06-11,2023-02-15 18:36:08,121.9,transfer,570359.96
47905,4090223,46.0.123.45,913.0,atm,10,6362,841284706,CREDIT,0,active,2026-06-11,2023-02-16 17:53:14,121.8,in,570481.76
47906,4457078,94.243.0.180,112.0,prtbl trm,451,6563,841284706,CREDIT,0,active,2026-06-11,2023-04-07 09:28:55,122.15,payment,570359.61
47907,4649196,134.0.98.210,807.0,atm,10,9084,841284706,CREDIT,0,active,2026-06-11,2023-04-12 05:43:58,122.12,add_on_acc,570481.73
47908,4775063,94.243.0.180,112.0,prtbl trm,30,5533,841284706,CREDIT,0,active,2026-06-11,2023-04-16 09:32:22,121.94,transfer,570359.79
47909,4841439,45.154.0.240,317.0,port_trm,-1,7691,841284706,CREDIT,1,active,2026-06-11,2023-05-05 01:42:32,122.12,err_code,570359.79
47910,4871012,85.140.0.240,1271.0,ATM,451,7691,841284706,CREDIT,0,active,2026-06-11,2023-05-15 16:25:55,121.96,payment,570237.83
47911,5090676,95.167.0.210,217.0,prtbl trm,451,9084,841284706,CREDIT,0,active,2026-06-11,2023-05-19 10:11:56,122.02,payment,570115.81
47912,5332369,195.143.0.210,1381.0,port_trm,-1,1312,841284706,CREDIT,1,active,2026-06-11,2023-06-03 04:08:01,121.8,err_code,570115.81
47913,5452991,77.242.0.15,269.0,atm,451,6514,841284706,CREDIT,0,active,2026-06-11,2023-06-04 20:12:50,122.03,payment,569993.78
47914,5480575,193.0.151.45,53.0,ATM,10,5533,841284706,CREDIT,0,active,2026-06-11,2023-06-18 03:37:34,122.09,in,570115.87
47915,5530671,45.154.0.240,317.0,port_trm,30,1444,841284706,CREDIT,0,active,2026-06-11,2023-06-24 12:44:05,121.9,transfer,569993.97
47916,5584389,85.140.0.240,1271.0,ATM,451,9758,841284706,CREDIT,0,active,2026-06-11,2023-08-29 14:25:45,121.8,payment,569872.17
47917,5686556,85.140.0.240,1271.0,ATM,451,9084,841284706,CREDIT,0,active,2026-06-11,2023-09-17 05:25:02,122.1,payment,569750.07
47918,5851264,77.242.0.15,269.0,atm,451,1969,841284706,CREDIT,0,active,2026-06-11,2023-11-26 23:19:51,121.86,payment,569628.21
47919,5903220,45.154.0.240,317.0,port_trm,30,7166,841284706,CREDIT,0,active,2026-06-11,2024-01-16 14:12:30,122.28,transfer,569505.93
47920,5942629,94.243.0.180,112.0,prtbl trm,451,2259,841284706,CREDIT,0,active,2026-06-11,2024-01-31 03:04:59,122.13,payment,569383.8
47921,6346946,77.242.0.15,269.0,atm,451,9758,841284706,CREDIT,0,active,2026-06-11,2024-02-24 12:06:58,121.84,payment,569261.96
47922,6352619,94.243.0.180,112.0,prtbl trm,25,3692,841284706,CREDIT,0,active,2026-06-11,2024-02-24 19:17:21,122.16,country_transfer,569139.8
47923,6808368,188.43.0.120,1412.0,cash_out,20,2259,841284706,CREDIT,0,active,2026-06-11,2024-02-29 04:00:06,122.06,from_acc,569017.74
47924,6821683,77.242.0.15,269.0,atm,451,2259,841284706,CREDIT,0,active,2026-06-11,2024-03-13 08:50:06,121.99,payment,568895.75
47925,6840814,188.244.0.195,1467.0,atm,10,5495,841284706,CREDIT,0,active,2026-06-11,2024-04-02 22:25:43,122.06,in_acc,569017.81
47926,6841884,128.0.94.210,1113.0,cash_in,10,5973,841284706,CREDIT,0,active,2026-06-11,2024-04-07 23:57:42,121.86,in,569139.67
47927,7463799,109.126.0.105,372.0,ATM,20,2102,841284706,CREDIT,0,active,2026-06-11,2024-04-27 10:06:43,122.05,out,569017.62
47928,7766074,45.154.0.240,317.0,port_trm,30,9758,841284706,CREDIT,0,active,2026-06-11,2024-05-11 00:14:36,121.85,transfer,568895.77
47929,7924117,85.140.0.240,1271.0,ATM,451,4834,841284706,CREDIT,0,active,2026-06-11,2024-07-04 07:01:27,121.8,payment,568773.97
47930,8093048,128.0.94.60,1101.0,cash_out,20,9085,841284706,CREDIT,0,active,2026-06-11,2024-07-08 02:17:48,122.08,from_acc,568651.89
47931,8106786,195.143.0.210,1381.0,port_trm,451,6049,841284706,CREDIT,0,active,2026-06-11,2024-07-18 12:58:33,122.21,payment,568529.68
47932,8221274,79.104.0.90,642.0,ATM,451,4429,841284706,CREDIT,0,active,2026-06-11,2024-08-05 22:19:01,122.1,payment,568407.58
47933,8556536,79.104.0.90,642.0,ATM,451,3692,841284706,CREDIT,0,active,2026-06-11,2024-09-03 18:35:51,122.01,payment,568285.57
47934,8878725,85.140.0.240,1271.0,ATM,25,2102,841284706,CREDIT,0,active,2026-06-11,2024-09-28 22:32:05,122.25,country_transfer,568163.32
47935,8943650,79.104.0.90,642.0,ATM,25,1312,841284706,CREDIT,0,active,2026-06-11,2024-10-07 06:11:10,122.08,diff_cntry,568041.24
47936,8945443,79.104.60.240,444.0,cash_out,20,6514,841284706,CREDIT,0,active,2026-06-11,2024-10-09 09:16:48,122.12,from_acc,567919.12
47937,9165060,86.111.0.105,1351.0,Portable term,25,6514,841284706,CREDIT,0,active,2026-06-11,2024-10-17 19:26:53,122.11,diff_cntry,567797.01
47938,9400458,195.143.0.210,1381.0,port_trm,25,4429,841284706,CREDIT,0,active,2026-06-11,2024-11-04 07:39:07,121.83,diff_cntry,567675.18
47939,9611163,79.104.0.90,642.0,ATM,-1,3692,841284706,CREDIT,1,active,2026-06-11,2024-11-08 10:16:13,122.0,bad,567675.18
47940,9874238,45.154.0.240,317.0,port_trm,451,9084,841284706,CREDIT,0,active,2026-06-11,2024-11-23 16:17:11,121.89,payment,567553.29
47941,9949323,151.0.38.90,394.0,ATM,20,5533,841284706,CREDIT,0,active,2026-06-11,2024-11-25 16:06:20,121.82,decrease_on_acc,567431.47
47942,1013772,46.0.143.195,826.0,cash_in,10,3497,514990118,DEBIT,0,active,2027-04-30,2022-01-19 02:06:24,661.11,add_on_acc,751032.11
47943,1244801,185.233.0.165,89.0,pos trm,-1,7056,514990118,DEBIT,1,active,2027-04-30,2022-02-05 05:35:36,661.12,bad,751032.11
47944,1442144,188.18.0.165,235.0,port_trm,451,4875,514990118,DEBIT,0,active,2027-04-30,2022-02-08 21:41:12,661.08,payment,750371.03
47945,1622383,88.210.0.150,355.0,cash_in,30,6482,514990118,DEBIT,0,active,2027-04-30,2022-03-11 17:21:10,660.98,transfer,749710.05
47946,1624930,188.18.0.165,235.0,port_trm,-1,3825,514990118,DEBIT,1,active,2027-04-30,2022-03-21 14:49:22,661.01,err,749710.05
47947,1664129,46.0.123.90,917.0,atm,20,9724,514990118,DEBIT,0,active,2027-04-30,2022-04-04 10:29:00,660.96,from_acc,749049.09
47948,1891052,88.210.0.150,355.0,cash_in,451,3825,514990118,DEBIT,0,active,2027-04-30,2022-04-21 23:28:53,661.01,payment,748388.08
47949,1987979,31.134.0.45,1119.0,atm,10,7725,514990118,DEBIT,0,active,2027-04-30,2022-04-30 12:39:02,660.96,in_acc,749049.04
47950,2232882,151.0.0.90,20.0,ATM,10,5193,514990118,DEBIT,0,active,2027-04-30,2022-05-05 19:06:45,661.2,add_on_acc,749710.24
47951,2270176,188.0.0.180,1218.0,port_trm,-1,3868,514990118,DEBIT,1,active,2027-04-30,2022-05-13 19:33:23,661.44,err,749710.24
47952,2756141,213.151.0.120,1009.0,ATM,451,8031,514990118,DEBIT,0,active,2027-04-30,2022-05-16 12:43:45,660.72,payment,749049.52
47953,2914791,188.0.0.180,1218.0,port_trm,451,2679,514990118,DEBIT,0,active,2027-04-30,2022-05-27 00:58:44,660.93,payment,748388.59
47954,3240220,88.210.0.150,355.0,cash_in,30,5193,514990118,DEBIT,0,active,2027-04-30,2022-06-03 02:02:45,660.96,transfer,747727.63
47955,3314228,88.210.0.150,355.0,cash_in,451,8730,514990118,DEBIT,0,active,2027-04-30,2022-07-29 11:28:42,660.99,payment,747066.64
47956,3388823,46.0.9.60,1321.0,ATM,20,9914,514990118,DEBIT,0,active,2027-04-30,2022-08-01 12:48:27,661.04,decrease_on_acc,746405.6
47957,3414324,213.151.0.120,1009.0,ATM,25,6482,514990118,DEBIT,0,active,2027-04-30,2022-08-11 05:43:04,660.87,country_transfer,745744.73
47958,3534982,88.210.0.15,341.0,atm,20,4063,514990118,DEBIT,0,active,2027-04-30,2022-09-10 04:26:16,661.01,out,745083.72
47959,3728942,46.0.188.60,1232.0,cash_in,10,4063,514990118,DEBIT,0,active,2027-04-30,2022-09-21 03:02:57,660.91,in_acc,745744.63
47960,3779329,185.233.0.165,89.0,pos trm,451,9987,514990118,DEBIT,0,active,2027-04-30,2022-10-07 19:54:28,660.98,payment,745083.65
47961,3802001,217.112.0.225,1493.0,prtbl trm,25,8127,514990118,DEBIT,0,active,2027-04-30,2022-10-11 02:50:12,661.1,diff_cntry,744422.55
47962,3934189,188.0.0.180,1218.0,port_trm,30,5409,514990118,DEBIT,0,active,2027-04-30,2022-10-31 01:28:40,660.99,transfer,743761.56
47963,4330911,188.18.0.165,235.0,port_trm,451,3825,514990118,DEBIT,0,active,2027-04-30,2022-11-10 21:09:37,660.96,payment,743100.6
47964,4334757,217.112.0.225,1493.0,prtbl trm,451,4619,514990118,DEBIT,0,active,2027-04-30,2022-11-26 22:36:29,661.17,payment,742439.43
47965,4742913,88.210.0.150,355.0,cash_in,451,4875,514990118,DEBIT,0,active,2027-04-30,2022-12-14 13:15:42,661.26,payment,741778.17
47966,4804502,46.0.123.45,913.0,atm,10,9914,514990118,DEBIT,0,active,2027-04-30,2023-01-11 18:26:38,660.96,in_acc,742439.13
47967,4880729,188.18.0.165,235.0,port_trm,451,8127,514990118,DEBIT,0,active,2027-04-30,2023-02-10 00:57:40,661.11,payment,741778.02
47968,5092318,217.112.0.225,1493.0,prtbl trm,451,8127,514990118,DEBIT,0,active,2027-04-30,2023-03-04 19:15:15,661.1,payment,741116.92
47969,5125933,188.0.0.180,1218.0,port_trm,25,4980,514990118,DEBIT,0,active,2027-04-30,2023-03-19 20:54:33,660.95,diff_cntry,740455.97
47970,5201664,195.58.0.135,1436.0,atm,25,8440,514990118,DEBIT,0,active,2027-04-30,2023-04-15 07:55:17,661.03,diff_cntry,739794.94
47971,5202882,46.0.176.180,130.0,ATM,10,4875,514990118,DEBIT,0,active,2027-04-30,2023-04-17 01:14:44,660.81,add_on_acc,740455.75
47972,5396539,185.233.0.165,89.0,pos trm,451,7056,514990118,DEBIT,0,active,2027-04-30,2023-05-02 23:57:14,660.89,payment,739794.86
47973,5622008,217.112.0.225,1493.0,prtbl trm,451,4063,514990118,DEBIT,0,active,2027-04-30,2023-07-01 18:24:53,661.23,payment,739133.63
47974,5659732,185.233.0.165,89.0,pos trm,25,4875,514990118,DEBIT,0,active,2027-04-30,2023-07-18 17:46:55,661.09,country_transfer,738472.54
47975,5876883,80.234.0.240,428.0,ATM,10,9668,514990118,DEBIT,0,active,2027-04-30,2023-07-22 03:36:45,660.7,in_acc,739133.24
47976,5919709,88.210.0.150,355.0,cash_in,30,8107,514990118,DEBIT,0,active,2027-04-30,2023-07-28 10:35:21,660.75,transfer,738472.49
47977,5976933,91.107.0.240,995.0,cash_in,10,3868,514990118,DEBIT,0,active,2027-04-30,2023-08-16 13:39:34,660.88,add_on_acc,739133.37
47978,6092021,195.58.0.135,1436.0,atm,-1,8699,514990118,DEBIT,1,active,2027-04-30,2023-10-23 00:53:17,660.96,err_code,739133.37
47979,6092362,217.112.0.225,1493.0,prtbl trm,25,8699,514990118,DEBIT,0,active,2027-04-30,2023-11-08 03:31:38,661.12,diff_cntry,738472.25
47980,6177405,188.18.0.165,235.0,port_trm,30,8031,514990118,DEBIT,0,active,2027-04-30,2023-11-29 10:31:47,660.97,transfer,737811.28
47981,6250497,195.58.0.135,1436.0,atm,-1,9987,514990118,DEBIT,1,active,2027-04-30,2024-01-07 10:51:45,661.03,err_code,737811.28
47982,6511533,213.151.0.120,1009.0,ATM,-1,3825,514990118,DEBIT,2,active,2027-04-30,2024-01-15 16:44:25,661.01,err,737811.28
47983,6564706,77.242.0.15,269.0,atm,10,8031,514990118,DEBIT,0,active,2027-04-30,2024-01-21 15:58:58,660.86,in_acc,738472.14
47984,6583121,188.18.0.165,235.0,port_trm,451,8699,514990118,DEBIT,0,active,2027-04-30,2024-03-13 23:50:34,661.12,payment,737811.02
47985,7202393,188.128.16.136,1195.0,cash_in,10,8031,514990118,DEBIT,0,active,2027-04-30,2024-04-21 04:53:32,660.67,in_acc,738471.69
47986,7286844,46.0.176.150,128.0,atm,10,4875,514990118,DEBIT,0,active,2027-04-30,2024-06-04 19:48:42,661.11,in_acc,739132.8
47987,7421907,188.18.0.165,235.0,port_trm,451,9900,514990118,DEBIT,0,active,2027-04-30,2024-06-07 07:55:24,661.02,payment,738471.78
47988,7472291,46.0.0.0,654.0,cash_in,10,9900,514990118,DEBIT,0,active,2027-04-30,2024-06-11 22:43:30,661.19,add_on_acc,739132.97
47989,7670095,195.58.0.135,1436.0,atm,451,4980,514990118,DEBIT,0,active,2027-04-30,2024-07-25 04:55:35,661.14,payment,738471.83
47990,7893086,88.210.0.150,355.0,cash_in,-1,8107,514990118,DEBIT,1,active,2027-04-30,2024-08-06 13:39:19,661.32,err,738471.83
47991,8349418,151.0.38.195,404.0,cash_in,10,4619,514990118,DEBIT,0,active,2027-04-30,2024-08-26 12:41:55,661.01,in,739132.84
47992,8366277,217.112.0.225,1493.0,prtbl trm,451,8127,514990118,DEBIT,0,active,2027-04-30,2024-09-03 00:39:32,661.12,payment,738471.72
47993,8370168,217.112.0.150,1483.0,ATM,20,7056,514990118,DEBIT,0,active,2027-04-30,2024-09-03 08:07:21,660.91,from_acc,737810.81
47994,8451026,195.58.0.135,1436.0,atm,451,5193,514990118,DEBIT,0,active,2027-04-30,2024-09-22 07:51:04,660.79,payment,737150.02
47995,8538782,88.210.0.150,355.0,cash_in,25,9914,514990118,DEBIT,0,active,2027-04-30,2024-09-30 12:10:20,661.21,diff_cntry,736488.81
47996,8716665,217.112.0.225,1493.0,prtbl trm,451,3497,514990118,DEBIT,0,active,2027-04-30,2024-10-19 22:07:40,661.22,payment,735827.59
47997,9567697,185.233.0.165,89.0,pos trm,30,3825,514990118,DEBIT,0,active,2027-04-30,2024-10-22 01:52:55,660.89,transfer,735166.7
47998,9667783,88.210.0.150,355.0,cash_in,30,4980,514990118,DEBIT,0,active,2027-04-30,2024-11-03 15:56:39,661.27,transfer,734505.43
47999,9944817,88.210.0.150,355.0,cash_in,451,3868,514990118,DEBIT,0,active,2027-04-30,2024-11-17 19:48:42,660.95,payment,733844.48
48000,1071393,188.18.0.210,240.0,Portable term,30,8994,138843487,CREDIT,0,act,2024-11-29,2022-01-13 10:23:50,328.05,transfer,447708.95
48001,1092683,188.18.0.45,224.0,pos trm,25,7591,138843487,CREDIT,0,act,2024-11-29,2022-06-09 00:18:53,327.98,country_transfer,447380.97
48002,1238947,81.17.0.135,1393.0,pos trm,451,2723,138843487,CREDIT,0,act,2024-11-29,2022-07-04 10:29:41,327.94,payment,447053.03
48003,1472789,185.173.0.75,1278.0,ATM,20,9122,138843487,CREDIT,0,act,2024-11-29,2022-12-28 12:22:53,327.77,out,446725.26
48004,1773671,185.17.0.135,1060.0,cash_in,451,8994,138843487,CREDIT,0,act,2024-11-29,2023-01-17 08:20:10,327.99,payment,446397.27
48005,1864805,188.43.0.180,1418.0,pos trm,25,4608,138843487,CREDIT,0,act,2024-11-29,2023-03-28 10:32:50,327.83,country_transfer,446069.44
48006,1935181,185.17.0.135,1060.0,cash_in,451,9321,138843487,CREDIT,0,act,2024-11-29,2023-07-19 11:31:20,328.2,payment,445741.24
48007,2126971,185.17.0.135,1060.0,cash_in,25,9511,138843487,CREDIT,0,act,2024-11-29,2023-09-17 03:30:20,328.09,diff_cntry,445413.15
48008,2130837,188.43.0.180,1418.0,pos trm,451,8994,138843487,CREDIT,0,act,2024-11-29,2023-11-01 21:22:01,328.19,payment,445084.96
48009,2153356,188.162.0.105,961.0,prtbl trm,451,2523,138843487,CREDIT,0,act,2024-11-29,2024-01-05 16:24:26,327.8,payment,444757.16
48010,2264047,188.162.0.105,961.0,prtbl trm,451,5637,138843487,CREDIT,0,act,2024-11-29,2024-01-25 11:54:28,328.37,payment,444428.79
48011,2458932,81.17.0.135,1393.0,pos trm,991,4608,138843487,CREDIT,0,blk,2024-11-29,2024-08-17 00:39:56,328.02,blocked,0.0
48012,1005987,195.161.0.105,1170.0,atm,30,7496,418851665,DEBIT,0,act,2030-12-15,2022-01-07 20:02:03,897.92,transfer,991908.08
48013,1213131,46.0.54.0,1068.0,cash_out,20,9195,418851665,DEBIT,0,act,2030-12-15,2022-01-19 17:59:24,897.99,decrease_on_acc,991010.09
48014,1283695,195.58.0.180,1443.0,port_trm,30,4090,418851665,DEBIT,0,act,2030-12-15,2022-02-17 14:05:19,897.91,transfer,990112.18
48015,1474249,188.0.166.15,1297.0,ATM,451,9899,418851665,DEBIT,0,act,2030-12-15,2022-02-27 22:16:22,897.99,payment,989214.19
48016,1523561,79.104.0.90,642.0,ATM,20,9337,418851665,DEBIT,0,act,2030-12-15,2022-03-13 00:00:50,898.03,decrease_on_acc,988316.16
48017,1533800,195.161.0.105,1170.0,atm,451,1554,418851665,DEBIT,0,act,2030-12-15,2022-04-20 06:38:02,898.16,payment,987418.0
48018,1783988,195.58.0.30,1426.0,cash_in,25,6058,418851665,DEBIT,0,act,2030-12-15,2022-05-08 18:16:25,897.95,country_transfer,986520.05
48019,1934694,194.0.144.30,160.0,atm,20,1756,418851665,DEBIT,0,act,2030-12-15,2022-05-08 19:38:00,897.88,out,985622.17
48020,2046841,46.173.0.45,496.0,cash_in,10,1756,418851665,DEBIT,0,act,2030-12-15,2022-05-12 17:02:58,898.12,in_acc,986520.29
48021,2072809,188.0.166.15,1297.0,ATM,-1,8483,418851665,DEBIT,1,act,2030-12-15,2022-05-26 16:29:55,898.11,err_code,986520.29
48022,2294922,195.161.0.105,1170.0,atm,25,9164,418851665,DEBIT,0,act,2030-12-15,2022-08-01 03:24:38,897.9,country_transfer,985622.39
48023,2718801,46.0.9.60,1321.0,ATM,10,8131,418851665,DEBIT,0,act,2030-12-15,2022-08-30 00:48:56,897.92,in_acc,986520.31
48024,2828039,185.233.0.240,96.0,atm,-1,1752,418851665,DEBIT,1,act,2030-12-15,2022-09-01 09:56:17,897.91,err_code,986520.31
48025,2923242,195.58.0.180,1443.0,port_trm,25,1748,418851665,DEBIT,0,act,2030-12-15,2022-09-06 17:34:46,898.01,diff_cntry,985622.3
48026,3106569,128.0.82.0,610.0,atm,10,1453,418851665,DEBIT,0,act,2030-12-15,2022-09-26 02:59:56,897.79,in_acc,986520.09
48027,3188751,195.161.0.105,1170.0,atm,-1,9899,418851665,DEBIT,1,act,2030-12-15,2022-10-24 21:17:25,897.83,err_code,986520.09
48028,3626220,188.0.166.15,1297.0,ATM,451,3571,418851665,DEBIT,0,act,2030-12-15,2022-11-16 18:55:44,898.17,payment,985621.92
48029,3930834,188.0.166.15,1297.0,ATM,-1,1453,418851665,DEBIT,1,act,2030-12-15,2022-12-29 08:43:41,898.14,err,985621.92
48030,3959979,188.244.0.135,1461.0,atm,20,1756,418851665,DEBIT,0,act,2030-12-15,2023-01-06 14:53:17,897.78,out,984724.14
48031,4174986,195.58.0.180,1443.0,port_trm,-1,9195,418851665,DEBIT,1,act,2030-12-15,2023-02-05 19:59:07,898.01,err_code,984724.14
48032,4368651,134.0.98.210,807.0,atm,10,6058,418851665,DEBIT,0,act,2030-12-15,2023-04-01 14:12:55,898.0,in_acc,985622.14
48033,4539649,195.161.0.105,1170.0,atm,30,6920,418851665,DEBIT,0,act,2030-12-15,2023-04-06 00:15:58,897.88,transfer,984724.26
48034,4549750,188.0.166.15,1297.0,ATM,25,7950,418851665,DEBIT,0,act,2030-12-15,2023-04-20 06:17:44,897.95,country_transfer,983826.31
48035,4585412,5.189.0.135,866.0,ATM,20,6757,418851665,DEBIT,0,act,2030-12-15,2023-05-30 01:06:53,897.79,from_acc,982928.52
48036,4781563,46.173.0.75,498.0,ATM,20,7807,418851665,DEBIT,0,act,2030-12-15,2023-05-30 04:27:19,897.83,decrease_on_acc,982030.69
48037,4908906,185.233.0.240,96.0,atm,-1,4090,418851665,DEBIT,1,act,2030-12-15,2023-06-06 09:29:00,897.88,bad,982030.69
48038,5006163,195.161.0.105,1170.0,atm,-1,6757,418851665,DEBIT,2,act,2030-12-15,2023-06-25 08:21:00,897.79,err_code,982030.69
48039,5156602,195.58.0.180,1443.0,port_trm,25,9568,418851665,DEBIT,0,act,2030-12-15,2023-07-15 19:14:19,898.02,country_transfer,981132.67
48040,5226153,195.58.0.30,1426.0,cash_in,25,3446,418851665,DEBIT,0,act,2030-12-15,2023-07-15 22:06:30,897.91,diff_cntry,980234.76
48041,5344185,188.0.166.15,1297.0,ATM,451,9164,418851665,DEBIT,0,act,2030-12-15,2023-07-26 22:04:04,897.76,payment,979337.0
48042,5778320,185.173.0.210,1288.0,atm,10,9568,418851665,DEBIT,0,act,2030-12-15,2023-08-09 15:33:41,897.74,add_on_acc,980234.74
48043,5780670,188.0.166.15,1297.0,ATM,30,6058,418851665,DEBIT,0,act,2030-12-15,2023-08-25 13:08:59,898.12,transfer,979336.62
48044,6018828,195.58.0.180,1443.0,port_trm,30,6058,418851665,DEBIT,0,act,2030-12-15,2023-10-14 09:16:33,897.81,transfer,978438.81
48045,6046961,80.234.0.75,416.0,cash_out,20,6058,418851665,DEBIT,0,act,2030-12-15,2023-10-18 03:38:54,898.06,decrease_on_acc,977540.75
48046,6052913,195.161.0.105,1170.0,atm,25,1748,418851665,DEBIT,0,act,2030-12-15,2023-10-21 23:43:50,897.9,diff_cntry,976642.85
48047,6513848,79.104.0.15,635.0,cash_out,20,3446,418851665,DEBIT,0,act,2030-12-15,2023-10-30 07:03:08,898.23,out,975744.62
48048,6664370,188.0.166.15,1297.0,ATM,451,6757,418851665,DEBIT,0,act,2030-12-15,2023-11-17 17:55:19,897.85,payment,974846.77
48049,6790787,46.0.8.150,148.0,cash_in,10,6058,418851665,DEBIT,0,act,2030-12-15,2023-11-19 01:25:52,897.9,in,975744.67
48050,6826470,195.161.0.105,1170.0,atm,451,6058,418851665,DEBIT,0,act,2030-12-15,2023-12-18 09:44:00,898.24,payment,974846.43
48051,6934532,185.233.0.240,96.0,atm,30,6757,418851665,DEBIT,0,act,2030-12-15,2024-01-18 00:29:43,897.71,transfer,973948.72
48052,6987048,195.58.0.180,1443.0,port_trm,451,9337,418851665,DEBIT,0,act,2030-12-15,2024-01-24 04:49:32,898.21,payment,973050.51
48053,7139539,185.233.0.240,96.0,atm,451,6655,418851665,DEBIT,0,act,2030-12-15,2024-02-08 07:38:28,898.28,payment,972152.23
48054,7177393,188.0.166.15,1297.0,ATM,451,6641,418851665,DEBIT,0,act,2030-12-15,2024-04-09 11:42:21,898.09,payment,971254.14
48055,7221142,195.58.0.180,1443.0,port_trm,-1,6655,418851665,DEBIT,1,act,2030-12-15,2024-04-29 16:13:54,898.11,err_code,971254.14
48056,7221226,195.58.0.180,1443.0,port_trm,-1,9337,418851665,DEBIT,2,act,2030-12-15,2024-05-01 06:59:51,898.08,err_code,971254.14
48057,7680812,195.58.0.105,1434.0,ATM,10,1453,418851665,DEBIT,0,act,2030-12-15,2024-06-08 13:09:22,897.78,in,972151.92
48058,7859522,195.58.0.180,1443.0,port_trm,30,9669,418851665,DEBIT,0,act,2030-12-15,2024-06-21 22:10:02,897.87,transfer,971254.05
48059,8403109,213.151.0.165,1012.0,atm,20,1756,418851665,DEBIT,0,act,2030-12-15,2024-07-20 00:04:44,897.93,decrease_on_acc,970356.12
48060,8434805,185.233.0.240,96.0,atm,-1,6920,418851665,DEBIT,1,act,2030-12-15,2024-08-13 13:32:36,898.01,err,970356.12
48061,8614245,46.8.0.105,774.0,cash_out,20,9669,418851665,DEBIT,0,act,2030-12-15,2024-08-16 16:34:05,898.1,from_acc,969458.02
48062,8922435,188.0.166.15,1297.0,ATM,451,8483,418851665,DEBIT,0,act,2030-12-15,2024-08-27 16:30:29,898.08,payment,968559.94
48063,9088387,185.233.0.240,96.0,atm,25,6757,418851665,DEBIT,0,act,2030-12-15,2024-08-29 20:25:29,898.18,diff_cntry,967661.76
48064,9302647,194.87.0.165,577.0,atm,10,6920,418851665,DEBIT,0,act,2030-12-15,2024-09-02 03:04:28,897.84,add_on_acc,968559.6
48065,9452052,195.58.0.30,1426.0,cash_in,451,6655,418851665,DEBIT,0,act,2030-12-15,2024-09-06 04:05:51,898.03,payment,967661.57
48066,9515245,85.140.0.225,1270.0,cash_in,10,9297,418851665,DEBIT,0,act,2030-12-15,2024-09-23 02:01:03,897.81,in,968559.38
48067,9580394,195.58.0.30,1426.0,cash_in,25,1756,418851665,DEBIT,0,act,2030-12-15,2024-09-30 19:02:14,898.12,diff_cntry,967661.26
48068,9969456,195.58.0.180,1443.0,port_trm,451,1554,418851665,DEBIT,0,act,2030-12-15,2024-10-22 15:42:23,898.05,payment,966763.21
48069,1168521,217.26.0.210,695.0,cash_out,-1,2299,254699086,DEBIT,1,active,2026-08-03,2022-01-10 06:18:27,1161.04,err_code,421019.0
48070,1173594,212.20.0.90,455.0,Portable term,25,2639,254699086,DEBIT,0,active,2026-08-03,2022-03-17 13:16:40,1160.93,country_transfer,419858.07
48071,1245335,46.0.143.45,814.0,prtbl trm,451,2002,254699086,DEBIT,0,active,2026-08-03,2022-03-21 20:33:41,1160.8,payment,418697.27
48072,1381911,46.0.143.45,814.0,prtbl trm,25,9141,254699086,DEBIT,0,active,2026-08-03,2022-03-24 03:41:29,1160.88,country_transfer,417536.39
48073,1460639,188.0.0.90,1212.0,atm,20,6822,254699086,DEBIT,0,active,2026-08-03,2022-04-04 14:01:08,1160.72,out,416375.67
48074,1506941,37.0.123.0,318.0,ATM,451,4719,254699086,DEBIT,0,active,2026-08-03,2022-05-08 09:11:47,1160.94,payment,415214.73
48075,1507957,217.26.0.210,695.0,cash_out,30,4465,254699086,DEBIT,0,active,2026-08-03,2022-05-26 21:51:08,1160.95,transfer,414053.78
48076,1645263,212.20.0.90,455.0,Portable term,25,3104,254699086,DEBIT,0,active,2026-08-03,2022-06-02 04:09:38,1161.16,diff_cntry,412892.62
48077,2099732,46.0.143.45,814.0,prtbl trm,25,4764,254699086,DEBIT,0,active,2026-08-03,2022-06-19 20:50:47,1161.13,country_transfer,411731.49
48078,2467256,46.0.143.90,818.0,cash_in,451,7028,254699086,DEBIT,0,active,2026-08-03,2022-07-17 20:53:58,1161.13,payment,410570.36
48079,2511520,85.140.0.45,1250.0,cash_in,10,7748,254699086,DEBIT,0,active,2026-08-03,2022-12-28 19:14:45,1160.79,add_on_acc,411731.15
48080,2533516,46.0.188.210,1243.0,cash_out,20,3525,254699086,DEBIT,0,active,2026-08-03,2023-03-14 16:48:53,1161.05,from_acc,410570.1
48081,2568313,185.173.0.105,1280.0,pos trm,451,4465,254699086,DEBIT,0,active,2026-08-03,2023-03-18 01:13:10,1160.85,payment,409409.25
48082,2633976,46.0.8.180,151.0,port_trm,25,4668,254699086,DEBIT,0,active,2026-08-03,2023-03-22 09:49:11,1160.85,country_transfer,408248.4
48083,3001680,128.0.82.180,628.0,atm,20,4764,254699086,DEBIT,0,active,2026-08-03,2023-04-02 11:01:15,1160.96,out,407087.44
48084,3001730,185.173.0.105,1280.0,pos trm,30,7748,254699086,DEBIT,0,active,2026-08-03,2023-05-08 13:53:29,1160.98,transfer,405926.46
48085,3007647,46.0.8.180,151.0,port_trm,25,2549,254699086,DEBIT,0,active,2026-08-03,2023-05-10 03:28:06,1160.69,country_transfer,404765.77
48086,3025976,37.0.123.0,318.0,ATM,451,3525,254699086,DEBIT,0,active,2026-08-03,2023-06-12 20:54:08,1160.88,payment,403604.89
48087,3300560,80.234.0.75,416.0,cash_out,20,2639,254699086,DEBIT,0,active,2026-08-03,2023-06-20 06:03:42,1160.98,decrease_on_acc,402443.91
48088,3474561,46.0.8.180,151.0,port_trm,-1,2549,254699086,DEBIT,1,active,2026-08-03,2023-06-20 23:49:59,1161.17,bad,402443.91
48089,3551857,46.0.143.90,818.0,cash_in,-1,2639,254699086,DEBIT,2,active,2026-08-03,2023-07-07 03:02:30,1160.89,err,402443.91
48090,4491578,46.0.8.180,151.0,port_trm,451,9141,254699086,DEBIT,0,active,2026-08-03,2023-07-12 09:57:05,1161.0,payment,401282.91
48091,4674724,46.0.143.15,811.0,atm,-1,2639,254699086,DEBIT,1,active,2026-08-03,2023-07-14 03:53:48,1160.71,err,401282.91
48092,4978512,31.134.0.165,1127.0,atm,20,2639,254699086,DEBIT,0,active,2026-08-03,2023-07-16 05:50:26,1161.09,out,400121.82
48093,5117734,46.0.8.180,151.0,port_trm,25,7322,254699086,DEBIT,0,active,2026-08-03,2023-07-19 22:27:10,1160.99,diff_cntry,398960.83
48094,5127418,77.242.0.15,269.0,atm,20,3681,254699086,DEBIT,0,active,2026-08-03,2023-08-27 15:17:30,1161.32,decrease_on_acc,397799.51
48095,5752452,46.0.143.90,818.0,cash_in,25,3104,254699086,DEBIT,0,active,2026-08-03,2023-09-08 15:59:00,1161.02,country_transfer,396638.49
48096,5868312,94.243.0.15,98.0,ATM,20,3525,254699086,DEBIT,0,active,2026-08-03,2023-09-10 16:36:12,1160.73,from_acc,395477.76
48097,6127066,95.167.0.75,205.0,ATM,20,4668,254699086,DEBIT,0,active,2026-08-03,2023-09-30 10:54:04,1160.9,from_acc,394316.86
48098,6192755,46.0.8.180,151.0,port_trm,25,6102,254699086,DEBIT,0,active,2026-08-03,2023-10-18 10:02:15,1161.03,diff_cntry,393155.83
48099,6636217,46.0.143.90,818.0,cash_in,451,4190,254699086,DEBIT,0,active,2026-08-03,2023-11-07 12:24:10,1161.03,payment,391994.8
48100,6695871,46.0.143.45,814.0,prtbl trm,30,3104,254699086,DEBIT,0,active,2026-08-03,2023-11-12 03:28:00,1161.05,transfer,390833.75
48101,7331321,194.0.162.210,757.0,ATM,10,3681,254699086,DEBIT,0,active,2026-08-03,2023-12-02 20:02:13,1160.98,in_acc,391994.73
48102,7533676,217.26.0.210,695.0,cash_out,30,2639,254699086,DEBIT,0,active,2026-08-03,2023-12-15 12:45:11,1160.96,transfer,390833.77
48103,7611844,217.26.0.210,695.0,cash_out,-1,1331,254699086,DEBIT,1,active,2026-08-03,2024-01-06 17:54:03,1161.11,err,390833.77
48104,7729717,212.20.0.225,465.0,atm,20,5251,254699086,DEBIT,0,active,2026-08-03,2024-01-07 13:43:25,1160.99,out,389672.78
48105,7783788,134.0.98.0,790.0,atm,20,1331,254699086,DEBIT,0,active,2026-08-03,2024-01-16 05:44:11,1160.84,out,388511.94
48106,7955486,188.18.0.150,234.0,atm,20,4719,254699086,DEBIT,0,active,2026-08-03,2024-03-06 19:45:01,1161.14,from_acc,387350.8
48107,8080911,37.0.123.0,318.0,ATM,451,4668,254699086,DEBIT,0,active,2026-08-03,2024-05-06 23:10:02,1160.81,payment,386189.99
48108,8198629,37.0.123.0,318.0,ATM,451,2775,254699086,DEBIT,0,active,2026-08-03,2024-05-07 08:48:51,1160.88,payment,385029.11
48109,8409503,188.18.0.150,234.0,atm,20,7748,254699086,DEBIT,0,active,2026-08-03,2024-05-19 10:07:48,1161.05,decrease_on_acc,383868.06
48110,8593274,46.0.143.15,811.0,atm,-1,4190,254699086,DEBIT,1,active,2026-08-03,2024-05-23 07:52:23,1161.13,bad,383868.06
48111,8753215,212.20.0.90,455.0,Portable term,30,4719,254699086,DEBIT,0,active,2026-08-03,2024-06-06 06:47:25,1161.06,transfer,382707.0
48112,8764562,46.0.8.180,151.0,port_trm,30,7748,254699086,DEBIT,0,active,2026-08-03,2024-08-07 10:27:20,1160.82,transfer,381546.18
48113,8781205,79.104.0.0,634.0,cash_in,10,6102,254699086,DEBIT,0,active,2026-08-03,2024-08-16 20:36:06,1160.99,in_acc,382707.17
48114,8784207,46.0.143.90,818.0,cash_in,451,2775,254699086,DEBIT,0,active,2026-08-03,2024-08-19 15:02:26,1161.14,payment,381546.03
48115,8964476,188.43.0.105,1411.0,ATM,20,2549,254699086,DEBIT,0,active,2026-08-03,2024-08-23 01:01:29,1161.27,out,380384.76
48116,9124013,46.0.143.15,811.0,atm,451,7322,254699086,DEBIT,0,active,2026-08-03,2024-08-28 11:26:40,1160.95,payment,379223.81
48117,9311452,46.0.9.60,1321.0,ATM,20,6822,254699086,DEBIT,0,active,2026-08-03,2024-09-08 18:25:13,1161.21,out,378062.6
48118,9579583,46.0.143.15,811.0,atm,30,7322,254699086,DEBIT,0,active,2026-08-03,2024-09-11 03:15:31,1160.96,transfer,376901.64
48119,9657494,128.0.94.165,1110.0,atm,10,1765,254699086,DEBIT,0,active,2026-08-03,2024-10-12 11:07:27,1160.91,in_acc,378062.55
48120,9782653,91.107.0.75,980.0,cash_in,10,1765,254699086,DEBIT,0,active,2026-08-03,2024-10-14 08:03:37,1161.0,in_acc,379223.55
48121,9911055,37.0.123.0,318.0,ATM,30,2639,254699086,DEBIT,0,active,2026-08-03,2024-10-17 20:54:13,1160.83,transfer,378062.72
48122,9934704,46.0.143.90,818.0,cash_in,-1,2110,254699086,DEBIT,1,active,2026-08-03,2024-11-21 13:55:11,1161.08,err_code,378062.72
48123,1088466,128.0.24.60,885.0,pos trm,25,5298,607981614,CREDIT,0,active,2025-08-08,2022-03-12 17:53:25,448.94,country_transfer,393878.06
48124,1579759,81.17.0.225,1402.0,Portable term,451,1349,607981614,CREDIT,0,active,2025-08-08,2022-03-28 07:06:28,449.12,payment,393428.94
48125,1956108,128.0.24.60,885.0,pos trm,451,8191,607981614,CREDIT,0,active,2025-08-08,2022-04-03 12:16:13,449.1,payment,392979.84
48126,2087744,188.18.0.195,239.0,cash_in,30,8191,607981614,CREDIT,0,active,2025-08-08,2022-04-13 05:30:43,448.98,transfer,392530.86
48127,2202703,45.154.0.225,316.0,cash_out,20,8444,607981614,CREDIT,0,active,2025-08-08,2022-04-18 05:34:21,448.7,decrease_on_acc,392082.16
48128,2608070,188.18.0.195,239.0,cash_in,-1,8544,607981614,CREDIT,1,active,2025-08-08,2022-05-19 22:00:17,448.89,err_code,392082.16
48129,2706670,46.0.9.195,1334.0,pos trm,25,5702,607981614,CREDIT,0,active,2025-08-08,2022-07-22 17:42:56,449.03,country_transfer,391633.13
48130,2921995,45.154.0.105,303.0,ATM,30,8191,607981614,CREDIT,0,active,2025-08-08,2022-07-29 14:19:34,449.04,transfer,391184.09
48131,3054114,45.154.0.105,303.0,ATM,30,8191,607981614,CREDIT,0,active,2025-08-08,2022-08-23 09:32:36,449.04,transfer,390735.05
48132,3141811,128.0.24.60,885.0,pos trm,30,1555,607981614,CREDIT,0,active,2025-08-08,2022-09-17 14:31:57,449.23,transfer,390285.82
48133,3232573,128.0.24.60,885.0,pos trm,451,4299,607981614,CREDIT,0,active,2025-08-08,2022-09-18 06:17:16,449.14,payment,389836.68
48134,3531126,188.18.0.195,239.0,cash_in,30,8544,607981614,CREDIT,0,active,2025-08-08,2022-12-26 20:52:12,448.81,transfer,389387.87
48135,3589426,45.154.0.105,303.0,ATM,-1,7708,607981614,CREDIT,1,active,2025-08-08,2023-01-23 07:57:52,448.86,err_code,389387.87
48136,3772383,46.0.188.75,1233.0,ATM,-1,4436,607981614,CREDIT,2,active,2025-08-08,2023-03-02 00:40:18,448.73,bad,389387.87
48137,3775504,185.173.0.75,1278.0,ATM,30,5960,607981614,CREDIT,0,active,2025-08-08,2023-04-26 19:12:59,448.99,transfer,388938.88
48138,3837552,46.0.9.195,1334.0,pos trm,25,8634,607981614,CREDIT,0,active,2025-08-08,2023-06-09 22:06:53,448.83,country_transfer,388490.05
48139,3907323,188.18.0.195,239.0,cash_in,-1,2252,607981614,CREDIT,1,active,2025-08-08,2023-06-20 01:58:48,448.82,err_code,388490.05
48140,4018060,88.210.0.210,360.0,atm,10,5055,607981614,CREDIT,0,active,2025-08-08,2023-07-12 06:24:48,449.06,in,388939.11
48141,4284850,81.17.0.225,1402.0,Portable term,451,2252,607981614,CREDIT,0,active,2025-08-08,2023-08-03 23:45:10,449.06,payment,388490.05
48142,4360562,45.154.0.105,303.0,ATM,25,1349,607981614,CREDIT,0,active,2025-08-08,2023-08-11 07:15:06,448.75,diff_cntry,388041.3
48143,4561814,128.0.24.60,885.0,pos trm,30,1349,607981614,CREDIT,0,active,2025-08-08,2023-08-19 21:57:57,448.81,transfer,387592.49
48144,4577858,45.154.0.105,303.0,ATM,-1,8634,607981614,CREDIT,1,active,2025-08-08,2023-08-20 17:17:46,449.08,err_code,387592.49
48145,4602948,46.0.188.75,1233.0,ATM,451,5298,607981614,CREDIT,0,active,2025-08-08,2023-08-24 18:27:37,448.74,payment,387143.75
48146,5121965,193.31.0.150,600.0,Portable term,451,3524,607981614,CREDIT,0,active,2025-08-08,2023-09-13 17:42:31,449.08,payment,386694.67
48147,5471406,81.17.0.225,1402.0,Portable term,451,3746,607981614,CREDIT,0,active,2025-08-08,2023-09-25 23:13:26,449.11,payment,386245.56
48148,5666734,45.154.0.105,303.0,ATM,25,2304,607981614,CREDIT,0,active,2025-08-08,2023-10-11 19:45:10,449.2,diff_cntry,385796.36
48149,6063509,185.233.0.60,81.0,ATM,20,2252,607981614,CREDIT,0,active,2025-08-08,2023-10-17 16:57:31,449.02,decrease_on_acc,385347.34
48150,6148239,185.173.0.75,1278.0,ATM,25,7202,607981614,CREDIT,0,active,2025-08-08,2023-11-03 16:41:38,449.01,diff_cntry,384898.33
48151,6244373,188.0.166.60,1303.0,atm,20,7202,607981614,CREDIT,0,active,2025-08-08,2023-12-03 06:31:36,449.06,from_acc,384449.27
48152,6379551,81.17.0.225,1402.0,Portable term,-1,4402,607981614,CREDIT,1,active,2025-08-08,2023-12-21 06:35:05,449.19,err,384449.27
48153,6422989,95.106.0.60,548.0,cash_out,20,1349,607981614,CREDIT,0,active,2025-08-08,2023-12-22 04:06:07,448.62,from_acc,384000.65
48154,6437751,217.112.0.165,1485.0,ATM,20,7708,607981614,CREDIT,0,active,2025-08-08,2023-12-28 05:27:21,449.11,from_acc,383551.54
48155,6678409,194.0.162.165,752.0,atm,10,3524,607981614,CREDIT,0,active,2025-08-08,2024-01-07 17:48:37,448.98,in_acc,384000.52
48156,7089078,151.0.38.75,393.0,cash_in,10,8444,607981614,CREDIT,0,active,2025-08-08,2024-01-19 11:11:35,448.75,add_on_acc,384449.27
48157,7310804,5.189.0.120,865.0,ATM,20,8634,607981614,CREDIT,0,active,2025-08-08,2024-01-26 16:00:06,449.31,from_acc,383999.96
48158,7395878,81.17.0.225,1402.0,Portable term,451,8444,607981614,CREDIT,0,active,2025-08-08,2024-02-04 09:05:49,449.01,payment,383550.95
48159,7466068,46.0.123.45,913.0,atm,20,1555,607981614,CREDIT,0,active,2025-08-08,2024-02-05 05:45:33,448.98,from_acc,383101.97
48160,7923263,95.181.0.15,249.0,ATM,20,5298,607981614,CREDIT,0,active,2025-08-08,2024-04-14 00:18:24,449.34,out,382652.63
48161,8072943,193.0.151.150,64.0,ATM,10,4843,607981614,CREDIT,0,active,2025-08-08,2024-04-16 07:12:20,448.92,in,383101.55
48162,8145312,188.18.0.195,239.0,cash_in,25,3834,607981614,CREDIT,0,active,2025-08-08,2024-06-05 21:55:11,448.87,diff_cntry,382652.68
48163,8452629,81.17.0.225,1402.0,Portable term,451,3746,607981614,CREDIT,0,active,2025-08-08,2024-07-24 09:09:22,449.0,payment,382203.68
48164,8459545,45.154.0.105,303.0,ATM,451,8544,607981614,CREDIT,0,active,2025-08-08,2024-08-06 13:48:58,449.31,payment,381754.37
48165,8755781,188.191.0.195,1155.0,atm,10,7202,607981614,CREDIT,0,active,2025-08-08,2024-08-19 20:16:06,449.2,in,382203.57
48166,8869307,45.154.0.105,303.0,ATM,20,1967,607981614,CREDIT,0,active,2025-08-08,2024-09-03 09:53:36,448.9,from_acc,381754.67
48167,8909257,185.173.0.75,1278.0,ATM,25,4299,607981614,CREDIT,0,active,2025-08-08,2024-09-23 11:21:40,449.25,diff_cntry,381305.42
48168,8974020,188.0.166.165,1311.0,cash_out,20,1555,607981614,CREDIT,0,active,2025-08-08,2024-09-30 18:54:01,448.95,out,380856.47
48169,9059857,46.0.8.0,137.0,cash_out,20,3524,607981614,CREDIT,0,active,2025-08-08,2024-10-14 14:44:44,448.94,from_acc,380407.53
48170,9222470,81.17.0.225,1402.0,Portable term,30,2304,607981614,CREDIT,0,active,2025-08-08,2024-10-22 12:44:14,448.7,transfer,379958.83
48171,9516816,81.17.0.225,1402.0,Portable term,451,1349,607981614,CREDIT,0,active,2025-08-08,2024-11-05 06:07:34,448.81,payment,379510.02
48172,9684713,46.0.188.75,1233.0,ATM,451,4843,607981614,CREDIT,0,active,2025-08-08,2024-11-23 21:27:37,449.15,payment,379060.87
48173,1073195,46.0.0.45,658.0,port_trm,451,9770,327114013,DEBIT,0,act,2028-06-30,2022-02-09 23:38:29,395.22,payment,365475.78
48174,1100735,37.0.123.195,334.0,ATM,10,3256,327114013,DEBIT,0,act,2028-06-30,2022-02-15 05:47:34,394.84,add_on_acc,365870.62
48175,1224562,188.162.0.75,958.0,cash_out,25,3256,327114013,DEBIT,0,act,2028-06-30,2022-03-20 19:00:19,394.99,diff_cntry,365475.63
48176,1286269,185.17.0.30,1044.0,ATM,-1,1935,327114013,DEBIT,1,act,2028-06-30,2022-04-07 00:16:17,395.14,err,365475.63
48177,1305763,185.17.0.30,1044.0,ATM,-1,3664,327114013,DEBIT,2,act,2028-06-30,2022-04-13 08:46:33,395.35,err_code,365475.63
48178,1323300,91.107.0.210,993.0,atm,20,5249,327114013,DEBIT,0,act,2028-06-30,2022-04-18 02:57:25,395.0,out,365080.63
48179,1502120,213.151.0.90,1004.0,Portable term,30,8662,327114013,DEBIT,0,act,2028-06-30,2022-05-26 15:03:00,395.31,transfer,364685.32
48180,1624659,46.0.0.45,658.0,port_trm,30,1619,327114013,DEBIT,0,act,2028-06-30,2022-06-16 04:45:24,394.64,transfer,364290.68
48181,1777739,188.0.0.195,1219.0,cash_in,451,1619,327114013,DEBIT,0,act,2028-06-30,2022-06-25 22:47:51,394.89,payment,363895.79
48182,1848508,37.0.123.90,327.0,atm,20,2186,327114013,DEBIT,0,act,2028-06-30,2022-06-28 00:25:25,394.89,out,363500.9
48183,2240750,46.0.0.45,658.0,port_trm,30,5249,327114013,DEBIT,0,act,2028-06-30,2022-07-14 02:30:41,395.3,transfer,363105.6
48184,2290852,85.140.0.150,1262.0,atm,20,2745,327114013,DEBIT,0,act,2028-06-30,2022-07-15 08:01:17,394.86,from_acc,362710.74
48185,2342474,188.162.0.150,965.0,Portable term,30,2166,327114013,DEBIT,0,act,2028-06-30,2022-07-30 21:45:20,395.16,transfer,362315.58
48186,2493577,188.162.0.150,965.0,Portable term,30,4154,327114013,DEBIT,0,act,2028-06-30,2022-09-02 18:35:46,394.78,transfer,361920.8
48187,2503762,188.162.0.75,958.0,cash_out,451,4632,327114013,DEBIT,0,act,2028-06-30,2022-09-29 12:40:55,395.22,payment,361525.58
48188,2778581,185.17.0.30,1044.0,ATM,451,2186,327114013,DEBIT,0,act,2028-06-30,2023-01-03 21:17:23,395.02,payment,361130.56
48189,2842025,185.17.0.30,1044.0,ATM,25,5522,327114013,DEBIT,0,act,2028-06-30,2023-01-04 12:39:54,395.0,country_transfer,360735.56
48190,2933625,46.0.0.45,658.0,port_trm,-1,9251,327114013,DEBIT,1,act,2028-06-30,2023-01-27 07:32:35,395.01,err,360735.56
48191,3197479,46.0.0.45,658.0,port_trm,-1,1619,327114013,DEBIT,2,act,2028-06-30,2023-02-02 23:25:23,394.94,err_code,360735.56
48192,3232959,46.0.0.45,658.0,port_trm,25,4632,327114013,DEBIT,0,act,2028-06-30,2023-02-05 14:03:40,395.0,country_transfer,360340.56
48193,3264628,185.17.0.0,1041.0,atm,25,9794,327114013,DEBIT,0,act,2028-06-30,2023-02-23 16:29:13,394.89,country_transfer,359945.67
48194,3379049,188.162.0.75,958.0,cash_out,451,1935,327114013,DEBIT,0,act,2028-06-30,2023-03-09 21:06:41,395.41,payment,359550.26
48195,3402178,185.17.0.30,1044.0,ATM,451,4213,327114013,DEBIT,0,act,2028-06-30,2023-03-10 21:35:14,395.0,payment,359155.26
48196,3510443,46.0.8.90,144.0,cash_in,10,9770,327114013,DEBIT,0,act,2028-06-30,2023-03-11 16:49:15,395.14,add_on_acc,359550.4
48197,3815549,188.0.0.195,1219.0,cash_in,451,2385,327114013,DEBIT,0,act,2028-06-30,2023-03-30 20:56:57,395.18,payment,359155.22
48198,3991684,188.162.0.150,965.0,Portable term,-1,1935,327114013,DEBIT,1,act,2028-06-30,2023-05-03 04:53:47,394.87,bad,359155.22
48199,4106003,185.17.0.0,1041.0,atm,-1,1935,327114013,DEBIT,2,act,2028-06-30,2023-06-29 23:21:03,394.94,err_code,359155.22
48200,4257797,185.17.0.30,1044.0,ATM,30,5249,327114013,DEBIT,0,act,2028-06-30,2023-07-02 11:55:40,394.95,transfer,358760.27
48201,4390874,46.0.0.45,658.0,port_trm,30,5465,327114013,DEBIT,0,act,2028-06-30,2023-07-02 12:19:35,394.85,transfer,358365.42
48202,4742740,213.151.0.90,1004.0,Portable term,25,1619,327114013,DEBIT,0,act,2028-06-30,2023-07-13 08:44:54,394.94,diff_cntry,357970.48
48203,4765281,185.17.0.0,1041.0,atm,25,3256,327114013,DEBIT,0,act,2028-06-30,2023-07-17 21:31:35,394.89,country_transfer,357575.59
48204,5779055,188.162.0.150,965.0,Portable term,30,9705,327114013,DEBIT,0,act,2028-06-30,2023-08-07 16:21:27,395.05,transfer,357180.54
48205,5885507,188.162.0.150,965.0,Portable term,451,7520,327114013,DEBIT,0,act,2028-06-30,2023-09-19 20:38:54,394.99,payment,356785.55
48206,6145691,79.104.0.210,651.0,Portable term,25,3256,327114013,DEBIT,0,act,2028-06-30,2023-10-31 08:39:38,394.92,diff_cntry,356390.63
48207,6146238,188.0.0.195,1219.0,cash_in,30,4154,327114013,DEBIT,0,act,2028-06-30,2023-11-04 11:02:37,395.24,transfer,355995.39
48208,6313080,212.20.0.75,454.0,cash_in,10,9794,327114013,DEBIT,0,act,2028-06-30,2023-11-20 22:50:44,394.95,in,356390.34
48209,6384571,185.17.0.30,1044.0,ATM,-1,4213,327114013,DEBIT,1,act,2028-06-30,2023-11-29 17:47:18,395.03,bad,356390.34
48210,6522771,188.43.0.30,1406.0,atm,10,4213,327114013,DEBIT,0,act,2028-06-30,2023-12-23 13:08:37,395.32,in_acc,356785.66
48211,6569599,46.173.0.120,503.0,ATM,20,3256,327114013,DEBIT,0,act,2028-06-30,2023-12-24 12:11:21,395.12,from_acc,356390.54
48212,6710762,213.151.0.90,1004.0,Portable term,25,6460,327114013,DEBIT,0,act,2028-06-30,2024-01-07 10:02:46,395.04,country_transfer,355995.5
48213,6935848,79.104.0.210,651.0,Portable term,451,9705,327114013,DEBIT,0,act,2028-06-30,2024-01-17 21:02:24,394.9,payment,355600.6
48214,7071874,185.17.0.0,1041.0,atm,451,1935,327114013,DEBIT,0,act,2028-06-30,2024-01-26 13:55:41,394.77,payment,355205.83
48215,7181896,185.17.0.30,1044.0,ATM,25,9754,327114013,DEBIT,0,act,2028-06-30,2024-01-31 13:55:00,395.13,country_transfer,354810.7
48216,7297300,188.0.0.195,1219.0,cash_in,30,2166,327114013,DEBIT,0,act,2028-06-30,2024-02-20 00:31:55,394.79,transfer,354415.91
48217,7315884,62.118.0.210,537.0,ATM,10,1619,327114013,DEBIT,0,act,2028-06-30,2024-03-11 07:22:14,395.01,in_acc,354810.92
48218,7518789,188.162.0.150,965.0,Portable term,451,9754,327114013,DEBIT,0,act,2028-06-30,2024-03-20 05:39:10,394.9,payment,354416.02
48219,8111138,185.17.0.0,1041.0,atm,451,2385,327114013,DEBIT,0,act,2028-06-30,2024-05-04 15:52:21,395.15,payment,354020.87
48220,8382865,188.162.0.75,958.0,cash_out,30,4213,327114013,DEBIT,0,act,2028-06-30,2024-05-22 13:10:58,395.08,transfer,353625.79
48221,8808404,79.104.0.210,651.0,Portable term,451,6850,327114013,DEBIT,0,act,2028-06-30,2024-07-31 15:04:47,394.97,payment,353230.82
48222,8860414,188.162.0.75,958.0,cash_out,451,3256,327114013,DEBIT,0,act,2028-06-30,2024-08-01 20:47:50,394.81,payment,352836.01
48223,9246352,31.134.0.135,1125.0,cash_in,10,1935,327114013,DEBIT,0,act,2028-06-30,2024-08-06 03:36:16,394.73,in_acc,353230.74
48224,9265892,85.140.0.135,1260.0,ATM,10,7520,327114013,DEBIT,0,act,2028-06-30,2024-09-09 08:56:39,395.15,add_on_acc,353625.89
48225,9513155,95.181.0.225,266.0,cash_out,20,6460,327114013,DEBIT,0,act,2028-06-30,2024-11-03 18:32:00,394.93,out,353230.96
48226,1072158,5.189.0.135,866.0,ATM,-1,3903,918561795,CREDIT,1,active,2030-05-29,2022-01-10 19:20:46,1087.87,err,616458.0
48227,1115651,80.234.0.90,417.0,pos trm,-1,4397,918561795,CREDIT,2,active,2030-05-29,2022-01-15 12:33:06,1087.82,err,616458.0
48228,1129767,80.234.0.90,417.0,pos trm,30,5837,918561795,CREDIT,0,active,2030-05-29,2022-01-23 06:12:27,1087.91,transfer,615370.09
48229,1181862,46.0.54.120,1082.0,pos trm,30,5895,918561795,CREDIT,0,active,2030-05-29,2022-02-14 17:09:36,1088.16,transfer,614281.93
48230,1256713,88.210.0.135,353.0,cash_in,30,3645,918561795,CREDIT,0,active,2030-05-29,2022-03-02 18:29:25,1087.81,transfer,613194.12
48231,1791080,194.87.0.120,574.0,cash_out,20,2664,918561795,CREDIT,0,active,2030-05-29,2022-03-22 16:12:00,1088.09,from_acc,612106.03
48232,1974890,188.244.0.105,1459.0,cash_in,25,7637,918561795,CREDIT,0,active,2030-05-29,2022-03-30 04:34:22,1087.87,country_transfer,611018.16
48233,2087449,109.126.0.105,372.0,ATM,20,9397,918561795,CREDIT,0,active,2030-05-29,2022-04-15 14:49:32,1087.97,from_acc,609930.19
48234,2093638,185.17.0.195,1064.0,ATM,10,9602,918561795,CREDIT,0,active,2030-05-29,2022-04-25 16:26:58,1088.05,add_on_acc,611018.24
48235,2116890,188.0.169.0,467.0,atm,20,9242,918561795,CREDIT,0,active,2030-05-29,2022-07-01 06:39:20,1087.84,from_acc,609930.4
48236,2266887,81.17.0.195,1400.0,pos trm,451,1801,918561795,CREDIT,0,active,2030-05-29,2022-07-05 05:47:05,1087.84,payment,608842.56
48237,2329434,81.17.0.195,1400.0,pos trm,30,4241,918561795,CREDIT,0,active,2030-05-29,2022-07-16 14:56:14,1087.9,transfer,607754.66
48238,2355993,188.244.0.105,1459.0,cash_in,451,3574,918561795,CREDIT,0,active,2030-05-29,2022-09-19 02:20:54,1088.22,payment,606666.44
48239,2379521,37.0.124.240,738.0,cash_out,20,4241,918561795,CREDIT,0,active,2030-05-29,2022-10-08 15:03:25,1087.93,out,605578.51
48240,2477202,37.0.127.150,1033.0,port_trm,451,9008,918561795,CREDIT,0,active,2030-05-29,2022-10-08 20:41:39,1087.83,payment,604490.68
48241,2498713,188.128.16.121,1192.0,cash_out,20,4241,918561795,CREDIT,0,active,2030-05-29,2022-10-15 05:13:48,1087.96,from_acc,603402.72
48242,2754421,37.0.127.150,1033.0,port_trm,451,3259,918561795,CREDIT,0,active,2030-05-29,2022-11-13 20:47:52,1088.13,payment,602314.59
48243,3064345,37.0.123.195,334.0,ATM,20,9008,918561795,CREDIT,0,active,2030-05-29,2023-01-01 04:45:00,1088.07,out,601226.52
48244,3087473,194.87.0.90,572.0,atm,10,8423,918561795,CREDIT,0,active,2030-05-29,2023-01-03 02:17:52,1088.16,in,602314.68
48245,3276851,5.189.0.45,859.0,cash_out,451,6361,918561795,CREDIT,0,active,2030-05-29,2023-01-06 09:05:56,1088.24,payment,601226.44
48246,3474150,5.189.0.135,866.0,ATM,451,7370,918561795,CREDIT,0,active,2030-05-29,2023-02-16 01:50:24,1088.05,payment,600138.39
48247,3564919,80.234.0.90,417.0,pos trm,25,9810,918561795,CREDIT,0,active,2030-05-29,2023-02-26 21:17:09,1088.01,diff_cntry,599050.38
48248,3609223,46.0.54.120,1082.0,pos trm,451,3903,918561795,CREDIT,0,active,2030-05-29,2023-03-06 21:55:51,1088.15,payment,597962.23
48249,3985377,188.0.166.75,1304.0,atm,20,9008,918561795,CREDIT,0,active,2030-05-29,2023-04-18 23:53:01,1088.07,from_acc,596874.16
48250,4219890,46.0.54.195,1089.0,atm,20,4460,918561795,CREDIT,0,active,2030-05-29,2023-05-21 07:40:54,1087.83,out,595786.33
48251,4494092,5.189.0.135,866.0,ATM,451,3470,918561795,CREDIT,0,active,2030-05-29,2023-07-04 20:07:18,1088.23,payment,594698.1
48252,4702953,188.0.169.0,467.0,atm,20,2664,918561795,CREDIT,0,active,2030-05-29,2023-07-11 00:25:40,1088.12,out,593609.98
48253,4721066,88.210.0.135,353.0,cash_in,451,4717,918561795,CREDIT,0,active,2030-05-29,2023-07-14 21:10:30,1087.96,payment,592522.02
48254,4949378,109.126.0.30,366.0,atm,10,6361,918561795,CREDIT,0,active,2030-05-29,2023-07-15 18:54:36,1087.96,in,593609.98
48255,4979775,80.234.0.90,417.0,pos trm,30,4460,918561795,CREDIT,0,active,2030-05-29,2023-07-15 19:17:43,1087.77,transfer,592522.21
48256,5054825,95.167.0.75,205.0,ATM,10,4717,918561795,CREDIT,0,active,2030-05-29,2023-09-09 04:36:09,1087.97,in_acc,593610.18
48257,5118562,37.0.127.150,1033.0,port_trm,30,3470,918561795,CREDIT,0,active,2030-05-29,2023-09-11 19:27:21,1087.9,transfer,592522.28
48258,5164038,88.210.0.135,353.0,cash_in,451,3903,918561795,CREDIT,0,active,2030-05-29,2023-09-12 02:58:26,1088.17,payment,591434.11
48259,5376316,188.244.0.105,1459.0,cash_in,451,3903,918561795,CREDIT,0,active,2030-05-29,2023-09-26 23:25:27,1087.88,payment,590346.23
48260,5494524,188.128.16.211,1201.0,ATM,20,3645,918561795,CREDIT,0,active,2030-05-29,2023-10-10 03:55:59,1087.89,out,589258.34
48261,5720534,37.0.127.150,1033.0,port_trm,-1,4717,918561795,CREDIT,1,active,2030-05-29,2023-10-26 00:13:52,1087.9,err_code,589258.34
48262,5745087,195.161.0.210,1179.0,atm,10,3470,918561795,CREDIT,0,active,2030-05-29,2023-12-08 08:58:51,1087.9,in_acc,590346.24
48263,5899256,46.0.9.120,1325.0,ATM,30,5837,918561795,CREDIT,0,active,2030-05-29,2024-01-01 06:53:15,1087.95,transfer,589258.29
48264,5987472,88.210.0.135,353.0,cash_in,451,9008,918561795,CREDIT,0,active,2030-05-29,2024-01-05 17:07:45,1087.98,payment,588170.31
48265,6237176,46.0.54.120,1082.0,pos trm,30,5736,918561795,CREDIT,0,active,2030-05-29,2024-01-17 03:58:00,1087.9,transfer,587082.41
48266,6428682,128.0.94.225,1114.0,cash_in,10,9008,918561795,CREDIT,0,active,2030-05-29,2024-01-25 02:06:18,1087.93,in,588170.34
48267,6507668,46.0.54.120,1082.0,pos trm,30,3645,918561795,CREDIT,0,active,2030-05-29,2024-02-20 08:46:08,1087.9,transfer,587082.44
48268,6555072,5.189.0.45,859.0,cash_out,451,5895,918561795,CREDIT,0,active,2030-05-29,2024-04-02 05:52:04,1087.86,payment,585994.58
48269,6848070,94.243.0.135,108.0,cash_out,20,9397,918561795,CREDIT,0,active,2030-05-29,2024-04-15 04:13:20,1088.07,decrease_on_acc,584906.51
48270,6918496,46.0.54.120,1082.0,pos trm,451,9003,918561795,CREDIT,0,active,2030-05-29,2024-04-22 20:55:30,1088.06,payment,583818.45
48271,6939324,88.210.0.135,353.0,cash_in,30,9602,918561795,CREDIT,0,active,2030-05-29,2024-04-28 03:38:06,1087.97,transfer,582730.48
48272,7167338,46.0.123.75,916.0,ATM,10,7370,918561795,CREDIT,0,active,2030-05-29,2024-05-06 13:39:53,1087.97,add_on_acc,583818.45
48273,7216340,81.17.0.195,1400.0,pos trm,25,4397,918561795,CREDIT,0,active,2030-05-29,2024-05-07 16:32:15,1088.11,diff_cntry,582730.34
48274,7514965,188.0.169.60,471.0,atm,10,4241,918561795,CREDIT,0,active,2030-05-29,2024-05-20 21:29:17,1087.93,in_acc,583818.27
48275,7947107,188.244.0.105,1459.0,cash_in,451,7637,918561795,CREDIT,0,active,2030-05-29,2024-06-02 10:03:21,1088.07,payment,582730.2
48276,8153591,78.24.158.159,944.0,cash_out,20,5895,918561795,CREDIT,0,active,2030-05-29,2024-06-20 18:48:27,1088.12,decrease_on_acc,581642.08
48277,8287353,46.173.0.105,502.0,atm,10,3903,918561795,CREDIT,0,active,2030-05-29,2024-08-15 02:22:57,1088.15,add_on_acc,582730.23
48278,8409341,188.244.0.105,1459.0,cash_in,451,9789,918561795,CREDIT,0,active,2030-05-29,2024-08-26 19:23:45,1088.13,payment,581642.1
48279,9172001,5.189.0.45,859.0,cash_out,25,3645,918561795,CREDIT,0,active,2030-05-29,2024-09-15 16:43:06,1088.17,country_transfer,580553.93
48280,9504992,188.244.0.105,1459.0,cash_in,-1,9789,918561795,CREDIT,1,active,2030-05-29,2024-09-28 04:20:47,1087.84,bad,580553.93
48281,9539638,37.0.127.210,1037.0,ATM,20,6585,918561795,CREDIT,0,active,2030-05-29,2024-10-07 07:12:17,1088.1,from_acc,579465.83
48282,9755368,80.234.0.90,417.0,pos trm,451,4019,918561795,CREDIT,0,active,2030-05-29,2024-10-07 09:41:08,1088.09,payment,578377.74
48283,9794185,46.0.54.120,1082.0,pos trm,451,7370,918561795,CREDIT,0,active,2030-05-29,2024-10-23 01:43:22,1087.88,payment,577289.86
48284,9969987,37.0.127.150,1033.0,port_trm,451,1801,918561795,CREDIT,0,active,2030-05-29,2024-10-31 03:27:30,1087.99,payment,576201.87
48285,1199206,46.0.176.195,131.0,prtbl trm,30,3780,747551031,CREDIT,0,act,2025-03-12,2022-02-15 00:16:35,674.01,transfer,719450.99
48286,1428878,46.0.176.180,130.0,ATM,10,8877,747551031,CREDIT,0,act,2025-03-12,2022-03-06 17:23:10,673.91,in,720124.9
48287,1549947,213.151.0.30,998.0,ATM,20,5712,747551031,CREDIT,0,act,2025-03-12,2022-05-02 22:36:40,674.1,decrease_on_acc,719450.8
48288,1775332,46.0.176.195,131.0,prtbl trm,25,9453,747551031,CREDIT,0,act,2025-03-12,2022-06-20 06:09:32,673.99,country_transfer,718776.81
48289,1919918,46.0.176.195,131.0,prtbl trm,30,7183,747551031,CREDIT,0,act,2025-03-12,2022-07-18 18:08:49,673.99,transfer,718102.82
48290,2342628,188.128.16.61,1187.0,prtbl trm,25,5712,747551031,CREDIT,0,act,2025-03-12,2022-08-14 06:41:13,674.06,country_transfer,717428.76
48291,2361867,86.111.0.0,1341.0,prtbl trm,451,1113,747551031,CREDIT,0,act,2025-03-12,2022-08-19 00:02:53,674.28,payment,716754.48
48292,2621013,46.0.176.195,131.0,prtbl trm,451,1113,747551031,CREDIT,0,act,2025-03-12,2022-08-20 13:27:50,674.02,payment,716080.46
48293,2642742,188.128.16.61,1187.0,prtbl trm,451,3780,747551031,CREDIT,0,act,2025-03-12,2022-09-25 06:49:05,674.21,payment,715406.25
48294,2789083,79.104.0.195,650.0,pos trm,-1,1683,747551031,CREDIT,1,act,2025-03-12,2022-10-03 23:33:46,674.15,err,715406.25
48295,2864114,46.0.176.195,131.0,prtbl trm,451,4565,747551031,CREDIT,0,act,2025-03-12,2022-11-06 07:41:56,674.13,payment,714732.12
48296,3323059,188.128.16.61,1187.0,prtbl trm,30,5404,747551031,CREDIT,0,act,2025-03-12,2022-12-27 13:51:13,673.84,transfer,714058.28
48297,3540275,188.128.16.61,1187.0,prtbl trm,451,4378,747551031,CREDIT,0,act,2025-03-12,2023-01-24 11:44:36,673.95,payment,713384.33
48298,3561183,46.8.0.45,767.0,atm,451,4549,747551031,CREDIT,0,act,2025-03-12,2023-01-26 07:37:59,674.02,payment,712710.31
48299,4160503,188.128.16.61,1187.0,prtbl trm,-1,7388,747551031,CREDIT,1,act,2025-03-12,2023-03-06 01:11:18,674.03,err,712710.31
48300,4334746,128.0.82.75,616.0,cash_in,10,2574,747551031,CREDIT,0,act,2025-03-12,2023-04-20 09:35:47,673.95,in,713384.26
48301,4708428,194.87.0.165,577.0,atm,-1,7388,747551031,CREDIT,1,act,2025-03-12,2023-05-09 21:12:42,673.99,err_code,713384.26
48302,5018265,46.0.176.195,131.0,prtbl trm,-1,8739,747551031,CREDIT,2,act,2025-03-12,2023-05-14 01:00:36,673.95,err,713384.26
48303,5132317,46.8.0.165,780.0,ATM,20,7183,747551031,CREDIT,0,act,2025-03-12,2023-05-17 11:38:22,673.9,from_acc,712710.36
48304,5405533,88.210.0.210,360.0,atm,10,7183,747551031,CREDIT,0,act,2025-03-12,2023-06-04 21:30:49,674.27,in,713384.63
48305,5440959,194.87.0.165,577.0,atm,30,5419,747551031,CREDIT,0,act,2025-03-12,2023-06-05 21:02:19,674.01,transfer,712710.62
48306,5502234,46.8.0.45,767.0,atm,451,9210,747551031,CREDIT,0,act,2025-03-12,2023-07-10 12:56:47,674.17,payment,712036.45
48307,5502972,188.128.16.61,1187.0,prtbl trm,451,9685,747551031,CREDIT,0,act,2025-03-12,2023-07-18 18:36:39,674.13,payment,711362.32
48308,5901631,46.8.0.45,767.0,atm,30,8877,747551031,CREDIT,0,act,2025-03-12,2023-08-13 16:00:40,674.13,transfer,710688.19
48309,5982334,79.104.0.195,650.0,pos trm,25,7183,747551031,CREDIT,0,act,2025-03-12,2023-08-20 22:18:32,674.06,country_transfer,710014.13
48310,6103298,193.0.151.15,51.0,ATM,20,4623,747551031,CREDIT,0,act,2025-03-12,2023-09-26 01:28:38,673.85,out,709340.28
48311,6115803,86.111.0.0,1341.0,prtbl trm,451,4623,747551031,CREDIT,0,act,2025-03-12,2023-09-30 08:37:22,674.18,payment,708666.1
48312,6142854,86.111.0.0,1341.0,prtbl trm,30,5419,747551031,CREDIT,0,act,2025-03-12,2023-10-30 17:15:15,674.15,transfer,707991.95
48313,6220377,95.181.0.90,254.0,atm,10,3499,747551031,CREDIT,0,act,2025-03-12,2023-10-31 03:25:53,674.01,in,708665.96
48314,6229196,46.8.0.45,767.0,atm,-1,4623,747551031,CREDIT,1,act,2025-03-12,2023-11-02 19:08:35,673.95,err_code,708665.96
48315,6297218,46.8.0.45,767.0,atm,-1,7388,747551031,CREDIT,2,act,2025-03-12,2023-11-28 04:21:56,674.26,err,708665.96
48316,6336185,46.0.176.195,131.0,prtbl trm,30,4642,747551031,CREDIT,0,act,2025-03-12,2023-11-29 23:31:21,673.95,transfer,707992.01
48317,6458792,79.104.0.195,650.0,pos trm,-1,2574,747551031,CREDIT,1,act,2025-03-12,2024-01-24 11:04:54,673.92,err_code,707992.01
48318,6593992,79.104.0.195,650.0,pos trm,451,1113,747551031,CREDIT,0,act,2025-03-12,2024-01-27 11:36:26,674.26,payment,707317.75
48319,6769333,86.111.0.0,1341.0,prtbl trm,-1,7388,747551031,CREDIT,1,act,2025-03-12,2024-02-04 09:56:55,674.07,bad,707317.75
48320,7202214,79.104.0.195,650.0,pos trm,30,7183,747551031,CREDIT,0,act,2025-03-12,2024-02-19 21:00:45,674.19,transfer,706643.56
48321,7275576,46.8.0.45,767.0,atm,25,9453,747551031,CREDIT,0,act,2025-03-12,2024-02-25 01:56:41,673.94,country_transfer,705969.62
48322,7556932,79.104.0.195,650.0,pos trm,-1,4270,747551031,CREDIT,1,act,2025-03-12,2024-03-17 21:58:02,674.1,err_code,705969.62
48323,7741510,79.104.60.240,444.0,cash_out,20,8877,747551031,CREDIT,0,act,2025-03-12,2024-03-18 16:06:36,674.2,out,705295.42
48324,7865298,188.128.16.61,1187.0,prtbl trm,451,4642,747551031,CREDIT,0,act,2025-03-12,2024-03-28 20:30:24,673.92,payment,704621.5
48325,7983416,194.87.0.165,577.0,atm,30,5712,747551031,CREDIT,0,act,2025-03-12,2024-04-23 06:23:21,674.04,transfer,703947.46
48326,8329039,79.104.0.195,650.0,pos trm,30,9685,747551031,CREDIT,0,act,2025-03-12,2024-06-06 10:17:20,673.78,transfer,703273.68
48327,8403875,194.87.0.165,577.0,atm,30,5419,747551031,CREDIT,0,act,2025-03-12,2024-07-29 20:17:50,673.83,transfer,702599.85
48328,8459435,79.104.0.195,650.0,pos trm,-1,5712,747551031,CREDIT,1,act,2025-03-12,2024-08-08 22:21:30,674.06,err_code,702599.85
48329,8474100,188.128.16.61,1187.0,prtbl trm,451,3499,747551031,CREDIT,0,act,2025-03-12,2024-08-28 05:18:39,674.1,payment,701925.75
48330,8790000,79.104.0.195,650.0,pos trm,25,8877,747551031,CREDIT,0,act,2025-03-12,2024-09-08 19:59:43,674.06,country_transfer,701251.69
48331,8869900,79.104.0.195,650.0,pos trm,30,4378,747551031,CREDIT,0,act,2025-03-12,2024-09-10 21:00:50,673.89,transfer,700577.8
48332,8954749,79.104.0.195,650.0,pos trm,30,4270,747551031,CREDIT,0,act,2025-03-12,2024-09-15 13:30:14,673.68,transfer,699904.12
48333,9173996,134.0.98.195,806.0,cash_in,10,7388,747551031,CREDIT,0,act,2025-03-12,2024-09-27 23:58:00,674.24,add_on_acc,700578.36
48334,9709213,46.8.0.45,767.0,atm,25,4549,747551031,CREDIT,0,act,2025-03-12,2024-10-29 04:34:17,674.07,diff_cntry,699904.29
48335,1243806,188.128.16.211,1201.0,ATM,10,8317,150978640,CREDIT,0,active,2030-05-09,2022-02-03 00:04:06,677.79,in,875475.79
48336,1420037,128.0.24.30,882.0,atm,30,6949,150978640,CREDIT,0,active,2030-05-09,2022-02-13 00:23:36,678.06,transfer,874797.73
48337,1500048,194.156.0.75,27.0,atm,25,8317,150978640,CREDIT,0,active,2030-05-09,2022-02-19 05:02:50,677.85,country_transfer,874119.88
48338,1504147,88.210.0.75,346.0,atm,451,6697,150978640,CREDIT,0,active,2030-05-09,2022-02-24 09:48:51,678.27,payment,873441.61
48339,1515156,46.0.176.165,129.0,ATM,20,1823,150978640,CREDIT,0,active,2030-05-09,2022-03-17 05:33:11,677.73,out,872763.88
48340,1537961,134.0.98.45,794.0,cash_out,20,9253,150978640,CREDIT,0,active,2030-05-09,2022-05-01 17:21:53,678.25,from_acc,872085.63
48341,1702938,128.0.24.30,882.0,atm,451,8583,150978640,CREDIT,0,active,2030-05-09,2022-05-04 04:34:34,678.12,payment,871407.51
48342,1772110,212.20.0.180,462.0,Portable term,-1,1496,150978640,CREDIT,1,active,2030-05-09,2022-05-28 06:05:22,678.05,err_code,871407.51
48343,2029034,88.210.0.75,346.0,atm,451,6919,150978640,CREDIT,0,active,2030-05-09,2022-05-29 10:48:02,678.05,payment,870729.46
48344,2309452,188.128.16.61,1187.0,prtbl trm,-1,6903,150978640,CREDIT,1,active,2030-05-09,2022-06-21 15:28:54,678.04,err,870729.46
48345,2390238,88.210.0.75,346.0,atm,451,4778,150978640,CREDIT,0,active,2030-05-09,2022-07-06 03:52:35,678.08,payment,870051.38
48346,2581188,188.128.16.61,1187.0,prtbl trm,25,2883,150978640,CREDIT,0,active,2030-05-09,2022-08-05 02:25:36,677.97,country_transfer,869373.41
48347,2972573,194.0.144.135,170.0,prtbl trm,30,6903,150978640,CREDIT,0,active,2030-05-09,2022-10-14 10:08:40,677.9,transfer,868695.51
48348,3577515,88.210.0.75,346.0,atm,30,6949,150978640,CREDIT,0,active,2030-05-09,2022-10-30 10:35:42,678.07,transfer,868017.44
48349,3625259,185.17.0.180,1063.0,atm,20,6949,150978640,CREDIT,0,active,2030-05-09,2022-11-07 14:11:58,678.11,from_acc,867339.33
48350,4004630,195.143.0.150,1377.0,ATM,10,4114,150978640,CREDIT,0,active,2030-05-09,2022-11-11 11:36:59,677.92,add_on_acc,868017.25
48351,4084122,88.210.0.75,346.0,atm,25,2800,150978640,CREDIT,0,active,2030-05-09,2022-11-16 16:26:07,678.16,diff_cntry,867339.09
48352,4211813,194.156.0.75,27.0,atm,30,2800,150978640,CREDIT,0,active,2030-05-09,2022-12-05 18:02:11,678.03,transfer,866661.06
48353,4340810,188.128.16.61,1187.0,prtbl trm,-1,3994,150978640,CREDIT,1,active,2030-05-09,2022-12-07 01:05:15,677.89,err,866661.06
48354,4436038,46.0.188.15,1227.0,atm,10,3994,150978640,CREDIT,0,active,2030-05-09,2023-01-14 00:54:13,677.93,in_acc,867338.99
48355,4534204,188.128.16.61,1187.0,prtbl trm,30,3994,150978640,CREDIT,0,active,2030-05-09,2023-01-31 03:46:30,678.24,transfer,866660.75
48356,4574982,5.189.0.0,854.0,atm,20,8206,150978640,CREDIT,0,active,2030-05-09,2023-02-01 11:06:14,677.99,out,865982.76
48357,5005739,188.128.16.61,1187.0,prtbl trm,451,5164,150978640,CREDIT,0,active,2030-05-09,2023-02-13 19:05:08,678.0,payment,865304.76
48358,5085998,194.156.0.75,27.0,atm,451,9230,150978640,CREDIT,0,active,2030-05-09,2023-02-24 09:12:04,678.0,payment,864626.76
48359,5157913,134.0.98.45,794.0,cash_out,20,9253,150978640,CREDIT,0,active,2030-05-09,2023-03-22 01:58:45,677.88,from_acc,863948.88
48360,5205757,188.128.16.61,1187.0,prtbl trm,30,6919,150978640,CREDIT,0,active,2030-05-09,2023-04-09 04:27:53,678.02,transfer,863270.86
48361,5289643,45.154.0.105,303.0,ATM,10,1496,150978640,CREDIT,0,active,2030-05-09,2023-04-12 02:38:01,678.08,in,863948.94
48362,5309366,195.58.0.225,1446.0,cash_in,10,3709,150978640,CREDIT,0,active,2030-05-09,2023-04-13 19:50:17,678.17,add_on_acc,864627.11
48363,5374714,78.24.158.99,939.0,atm,10,9253,150978640,CREDIT,0,active,2030-05-09,2023-05-11 10:42:44,678.02,in,865305.13
48364,5700813,188.0.166.75,1304.0,atm,20,2670,150978640,CREDIT,0,active,2030-05-09,2023-05-21 12:06:23,678.35,from_acc,864626.78
48365,5969205,188.128.16.211,1201.0,ATM,10,8583,150978640,CREDIT,0,active,2030-05-09,2023-06-12 00:04:28,677.93,add_on_acc,865304.71
48366,6043703,88.210.0.75,346.0,atm,25,9253,150978640,CREDIT,0,active,2030-05-09,2023-06-14 08:54:03,677.94,diff_cntry,864626.77
48367,6083196,185.233.0.60,81.0,ATM,20,4778,150978640,CREDIT,0,active,2030-05-09,2023-06-15 21:06:06,678.08,from_acc,863948.69
48368,6187309,88.210.0.75,346.0,atm,25,6919,150978640,CREDIT,0,active,2030-05-09,2023-07-08 01:18:42,678.02,diff_cntry,863270.67
48369,6941904,128.0.24.30,882.0,atm,451,9230,150978640,CREDIT,0,active,2030-05-09,2023-07-23 08:06:01,677.9,payment,862592.77
48370,7081328,194.156.0.165,34.0,cash_in,10,6697,150978640,CREDIT,0,active,2030-05-09,2023-07-28 23:14:28,678.24,in_acc,863271.01
48371,7403029,188.128.16.61,1187.0,prtbl trm,30,9253,150978640,CREDIT,0,active,2030-05-09,2023-09-07 17:09:17,678.01,transfer,862593.0
48372,7405429,188.128.16.61,1187.0,prtbl trm,30,4114,150978640,CREDIT,0,active,2030-05-09,2023-09-29 13:30:48,677.94,transfer,861915.06
48373,7474910,194.156.0.75,27.0,atm,451,4114,150978640,CREDIT,0,active,2030-05-09,2023-10-30 10:40:05,678.14,payment,861236.92
48374,7580954,194.156.0.75,27.0,atm,25,9230,150978640,CREDIT,0,active,2030-05-09,2023-11-04 10:59:46,677.85,country_transfer,860559.07
48375,7776600,128.0.24.30,882.0,atm,25,5164,150978640,CREDIT,0,active,2030-05-09,2023-11-12 23:35:48,677.81,diff_cntry,859881.26
48376,7790161,37.0.123.15,319.0,atm,10,2670,150978640,CREDIT,0,active,2030-05-09,2023-11-21 08:49:12,678.06,in_acc,860559.32
48377,8102371,88.210.0.75,346.0,atm,25,4169,150978640,CREDIT,0,active,2030-05-09,2023-12-01 17:11:56,677.97,country_transfer,859881.35
48378,8183512,212.20.0.180,462.0,Portable term,25,8317,150978640,CREDIT,0,active,2030-05-09,2023-12-05 01:49:11,678.08,country_transfer,859203.27
48379,8294611,128.0.24.30,882.0,atm,451,9250,150978640,CREDIT,0,active,2030-05-09,2023-12-13 04:25:33,678.14,payment,858525.13
48380,8383824,194.156.0.75,27.0,atm,30,6697,150978640,CREDIT,0,active,2030-05-09,2023-12-20 07:08:53,677.71,transfer,857847.42
48381,8433238,85.140.0.150,1262.0,atm,20,3709,150978640,CREDIT,0,active,2030-05-09,2024-01-08 20:12:09,677.93,from_acc,857169.49
48382,8530305,195.143.0.150,1377.0,ATM,10,8206,150978640,CREDIT,0,active,2030-05-09,2024-03-13 14:53:07,678.24,in,857847.73
48383,8607944,212.20.0.180,462.0,Portable term,-1,2800,150978640,CREDIT,1,active,2030-05-09,2024-05-07 08:48:01,678.18,err_code,857847.73
48384,8759317,188.43.0.0,1404.0,cash_out,20,9253,150978640,CREDIT,0,active,2030-05-09,2024-05-14 06:06:12,677.93,from_acc,857169.8
48385,8817354,88.210.0.75,346.0,atm,30,2800,150978640,CREDIT,0,active,2030-05-09,2024-06-20 08:38:28,678.19,transfer,856491.61
48386,9019973,194.0.144.135,170.0,prtbl trm,25,2883,150978640,CREDIT,0,active,2030-05-09,2024-06-30 06:54:13,678.01,diff_cntry,855813.6
48387,9291890,194.0.162.105,747.0,cash_in,10,6903,150978640,CREDIT,0,active,2030-05-09,2024-07-07 20:18:55,677.77,in,856491.37
48388,9354510,88.210.0.75,346.0,atm,25,4778,150978640,CREDIT,0,active,2030-05-09,2024-08-03 08:34:47,677.9,diff_cntry,855813.47
48389,9382280,194.156.0.75,27.0,atm,451,6949,150978640,CREDIT,0,active,2030-05-09,2024-08-14 09:48:51,678.1,payment,855135.37
48390,9456152,194.0.144.135,170.0,prtbl trm,25,6697,150978640,CREDIT,0,active,2030-05-09,2024-08-24 16:42:49,677.95,country_transfer,854457.42
48391,9694097,194.156.0.75,27.0,atm,451,4169,150978640,CREDIT,0,active,2030-05-09,2024-10-04 15:36:06,677.91,payment,853779.51
48392,9838782,128.0.24.30,882.0,atm,451,6697,150978640,CREDIT,0,active,2030-05-09,2024-11-26 09:10:23,678.2,payment,853101.31
48393,1071178,81.17.0.180,1399.0,ATM,25,1282,171487032,DEBIT,0,act,2030-12-27,2022-02-01 05:16:26,1142.95,country_transfer,462404.05
48394,1324098,62.118.0.195,535.0,atm,10,8872,171487032,DEBIT,0,act,2030-12-27,2022-04-05 11:28:39,1143.18,add_on_acc,463547.23
48395,1478366,193.31.0.90,594.0,ATM,-1,1526,171487032,DEBIT,1,act,2030-12-27,2022-04-26 09:46:56,1142.83,err,463547.23
48396,1545758,194.0.162.45,743.0,prtbl trm,451,5341,171487032,DEBIT,0,act,2030-12-27,2022-04-26 09:47:11,1142.94,payment,462404.29
48397,1662181,81.17.0.180,1399.0,ATM,451,2557,171487032,DEBIT,0,act,2030-12-27,2022-07-17 23:30:18,1143.02,payment,461261.27
48398,1781627,81.17.0.180,1399.0,ATM,30,1282,171487032,DEBIT,0,act,2030-12-27,2022-07-26 20:59:54,1142.99,transfer,460118.28
48399,1827375,91.107.0.120,986.0,prtbl trm,25,4328,171487032,DEBIT,0,act,2030-12-27,2022-08-04 01:07:58,1143.16,diff_cntry,458975.12
48400,1911559,193.31.0.90,594.0,ATM,-1,5341,171487032,DEBIT,1,act,2030-12-27,2022-08-12 19:30:44,1143.01,bad,458975.12
48401,2436891,91.107.0.120,986.0,prtbl trm,30,6574,171487032,DEBIT,0,act,2030-12-27,2022-08-24 20:04:33,1143.15,transfer,457831.97
48402,2582083,128.0.24.195,898.0,cash_in,10,1526,171487032,DEBIT,0,act,2030-12-27,2022-09-01 05:50:01,1142.92,in,458974.89
48403,2724933,194.0.162.45,743.0,prtbl trm,-1,1341,171487032,DEBIT,1,act,2030-12-27,2022-09-08 10:54:47,1143.12,bad,458974.89
48404,2897803,37.0.127.180,1035.0,atm,20,6023,171487032,DEBIT,0,act,2030-12-27,2022-09-26 22:56:26,1142.82,decrease_on_acc,457832.07
48405,3101997,193.0.151.45,53.0,ATM,30,6023,171487032,DEBIT,0,act,2030-12-27,2022-10-02 23:23:48,1143.03,transfer,456689.04
48406,3185938,79.104.0.75,641.0,atm,10,4441,171487032,DEBIT,0,act,2030-12-27,2022-10-03 17:04:29,1142.98,add_on_acc,457832.02
48407,3583442,81.17.0.75,1389.0,Portable term,451,5341,171487032,DEBIT,0,act,2030-12-27,2022-10-07 19:11:06,1142.89,payment,456689.13
48408,3767468,81.17.0.180,1399.0,ATM,451,6762,171487032,DEBIT,0,act,2030-12-27,2022-10-16 12:38:38,1143.0,payment,455546.13
48409,3829551,81.17.0.75,1389.0,Portable term,30,6537,171487032,DEBIT,0,act,2030-12-27,2022-11-25 19:51:04,1143.06,transfer,454403.07
48410,4201231,193.31.0.90,594.0,ATM,30,1282,171487032,DEBIT,0,act,2030-12-27,2022-12-18 00:38:49,1143.25,transfer,453259.82
48411,4434015,193.31.0.90,594.0,ATM,451,1282,171487032,DEBIT,0,act,2030-12-27,2023-01-24 03:55:38,1142.55,payment,452117.27
48412,4515231,81.17.0.75,1389.0,Portable term,451,6537,171487032,DEBIT,0,act,2030-12-27,2023-01-25 09:38:43,1143.03,payment,450974.24
48413,5015464,46.8.0.150,779.0,prtbl trm,30,4250,171487032,DEBIT,0,act,2030-12-27,2023-02-07 01:30:59,1143.19,transfer,449831.05
48414,5057261,81.17.0.75,1389.0,Portable term,25,5341,171487032,DEBIT,0,act,2030-12-27,2023-04-19 15:36:32,1142.76,country_transfer,448688.29
48415,5081722,188.191.0.15,1140.0,ATM,10,6762,171487032,DEBIT,0,act,2030-12-27,2023-05-27 02:25:08,1143.13,in_acc,449831.42
48416,5381995,194.156.0.165,34.0,cash_in,10,7285,171487032,DEBIT,0,act,2030-12-27,2023-05-30 04:56:35,1142.72,in_acc,450974.14
48417,5468373,46.8.0.150,779.0,prtbl trm,-1,7285,171487032,DEBIT,1,act,2030-12-27,2023-06-27 22:26:56,1142.87,bad,450974.14
48418,5474484,193.31.0.180,603.0,ATM,20,3867,171487032,DEBIT,0,act,2030-12-27,2023-07-12 12:50:22,1142.92,out,449831.22
48419,5521898,217.26.0.120,687.0,atm,10,8872,171487032,DEBIT,0,act,2030-12-27,2023-07-20 02:32:49,1143.27,add_on_acc,450974.49
48420,5542375,91.107.0.120,986.0,prtbl trm,451,4328,171487032,DEBIT,0,act,2030-12-27,2023-08-13 01:05:05,1143.0,payment,449831.49
48421,5909503,193.0.151.45,53.0,ATM,451,6023,171487032,DEBIT,0,act,2030-12-27,2023-08-21 11:00:15,1143.03,payment,448688.46
48422,6094101,91.107.0.120,986.0,prtbl trm,-1,4441,171487032,DEBIT,1,act,2030-12-27,2023-08-27 14:11:17,1142.91,err_code,448688.46
48423,6164726,193.0.151.45,53.0,ATM,-1,1526,171487032,DEBIT,2,act,2030-12-27,2023-09-25 22:54:52,1142.86,bad,448688.46
48424,6313710,193.0.151.45,53.0,ATM,451,9144,171487032,DEBIT,0,act,2030-12-27,2023-11-01 07:20:10,1142.86,payment,447545.6
48425,6390941,194.0.162.45,743.0,prtbl trm,-1,6574,171487032,DEBIT,1,act,2030-12-27,2023-11-29 08:29:46,1143.33,err,447545.6
48426,6423038,46.0.54.45,1072.0,atm,20,5973,171487032,DEBIT,0,act,2030-12-27,2023-12-28 08:54:34,1143.25,decrease_on_acc,446402.35
48427,6490926,81.17.0.180,1399.0,ATM,30,8872,171487032,DEBIT,0,act,2030-12-27,2024-01-08 01:44:07,1143.05,transfer,445259.3
48428,6930156,193.31.0.90,594.0,ATM,451,1341,171487032,DEBIT,0,act,2030-12-27,2024-01-24 16:29:12,1143.02,payment,444116.28
48429,7195253,81.17.0.180,1399.0,ATM,451,7285,171487032,DEBIT,0,act,2030-12-27,2024-01-28 17:08:07,1143.02,payment,442973.26
48430,7299758,81.17.0.75,1389.0,Portable term,30,7285,171487032,DEBIT,0,act,2030-12-27,2024-02-14 18:09:05,1143.0,transfer,441830.26
48431,7338679,193.0.151.45,53.0,ATM,451,6762,171487032,DEBIT,0,act,2030-12-27,2024-02-20 11:13:49,1143.12,payment,440687.14
48432,7439383,193.31.0.90,594.0,ATM,25,4328,171487032,DEBIT,0,act,2030-12-27,2024-03-01 14:01:42,1143.13,diff_cntry,439544.01
48433,7458387,194.87.0.105,573.0,atm,10,6537,171487032,DEBIT,0,act,2030-12-27,2024-04-04 17:13:44,1142.82,in_acc,440686.83
48434,7469369,81.17.0.180,1399.0,ATM,25,1282,171487032,DEBIT,0,act,2030-12-27,2024-04-20 11:03:31,1143.06,country_transfer,439543.77
48435,8007770,193.31.0.90,594.0,ATM,30,6877,171487032,DEBIT,0,act,2030-12-27,2024-05-23 07:34:55,1143.01,transfer,438400.76
48436,8013526,37.0.123.15,319.0,atm,10,5341,171487032,DEBIT,0,act,2030-12-27,2024-06-20 23:57:16,1142.96,in_acc,439543.72
48437,8701753,193.0.151.45,53.0,ATM,451,8872,171487032,DEBIT,0,act,2030-12-27,2024-06-21 08:37:50,1142.89,payment,438400.83
48438,8752914,151.0.38.225,406.0,cash_in,10,6537,171487032,DEBIT,0,act,2030-12-27,2024-08-20 22:53:33,1143.07,in,439543.9
48439,8790982,195.161.0.90,1169.0,ATM,10,4250,171487032,DEBIT,0,act,2030-12-27,2024-08-21 15:23:12,1143.08,add_on_acc,440686.98
48440,9044867,91.107.0.120,986.0,prtbl trm,451,9144,171487032,DEBIT,0,act,2030-12-27,2024-08-27 12:23:58,1143.14,payment,439543.84
48441,9083509,194.0.162.45,743.0,prtbl trm,451,6537,171487032,DEBIT,0,act,2030-12-27,2024-09-01 05:08:30,1143.14,payment,438400.7
48442,9305863,46.8.0.150,779.0,prtbl trm,451,1282,171487032,DEBIT,0,act,2030-12-27,2024-09-24 18:37:56,1142.89,payment,437257.81
48443,9510866,81.17.0.75,1389.0,Portable term,451,6877,171487032,DEBIT,0,act,2030-12-27,2024-10-01 12:39:25,1143.05,payment,436114.76
48444,9864166,46.0.176.75,123.0,atm,10,6537,171487032,DEBIT,0,act,2030-12-27,2024-10-15 13:29:12,1142.69,in,437257.45
48445,1021784,188.128.16.226,1203.0,port_trm,-1,3426,241679527,DEBIT,1,act,2030-06-09,2022-03-24 03:58:42,876.1,bad,697052.0
48446,1060214,194.0.162.210,757.0,ATM,20,7161,241679527,DEBIT,0,act,2030-06-09,2022-04-13 14:22:34,875.97,out,696176.03
48447,1130241,128.0.82.165,627.0,atm,-1,5290,241679527,DEBIT,1,act,2030-06-09,2022-04-15 20:55:53,876.3,err,696176.03
48448,1286747,46.0.176.180,130.0,ATM,30,9974,241679527,DEBIT,0,act,2030-06-09,2022-04-27 10:04:13,876.13,transfer,695299.9
48449,1322247,46.0.188.150,1239.0,cash_in,10,2928,241679527,DEBIT,0,act,2030-06-09,2022-05-19 16:58:38,875.93,add_on_acc,696175.83
48450,1564938,128.0.82.165,627.0,atm,-1,5290,241679527,DEBIT,1,act,2030-06-09,2022-06-30 21:05:38,876.02,err,696175.83
48451,1829440,188.128.16.226,1203.0,port_trm,451,6579,241679527,DEBIT,0,act,2030-06-09,2022-07-08 06:03:07,875.89,payment,695299.94
48452,1832903,213.151.0.90,1004.0,Portable term,451,2900,241679527,DEBIT,0,act,2030-06-09,2022-07-20 04:02:57,875.63,payment,694424.31
48453,1997660,188.128.16.226,1203.0,port_trm,-1,5290,241679527,DEBIT,1,act,2030-06-09,2022-08-07 02:17:57,876.13,err_code,694424.31
48454,2193432,46.0.176.75,123.0,atm,10,3426,241679527,DEBIT,0,act,2030-06-09,2022-08-11 18:31:14,876.08,in_acc,695300.39
48455,2197307,213.151.0.90,1004.0,Portable term,30,3426,241679527,DEBIT,0,act,2030-06-09,2022-09-09 08:48:51,875.83,transfer,694424.56
48456,2230092,188.18.0.135,233.0,port_trm,30,3220,241679527,DEBIT,0,act,2030-06-09,2022-10-22 13:17:23,875.69,transfer,693548.87
48457,2259943,188.128.16.136,1195.0,cash_in,10,1646,241679527,DEBIT,0,act,2030-06-09,2022-11-05 00:45:31,876.12,in_acc,694424.99
48458,2305148,188.128.16.226,1203.0,port_trm,30,9151,241679527,DEBIT,0,act,2030-06-09,2022-11-20 20:36:47,876.1,transfer,693548.89
48459,2836736,213.151.0.90,1004.0,Portable term,451,3220,241679527,DEBIT,0,act,2030-06-09,2022-11-24 21:08:43,875.92,payment,692672.97
48460,3158270,188.43.0.0,1404.0,cash_out,20,9974,241679527,DEBIT,0,act,2030-06-09,2022-12-17 04:52:15,875.7,decrease_on_acc,691797.27
48461,3268923,188.18.0.135,233.0,port_trm,30,9974,241679527,DEBIT,0,act,2030-06-09,2022-12-24 22:37:15,876.15,transfer,690921.12
48462,3505060,185.173.0.0,1272.0,atm,10,9151,241679527,DEBIT,0,act,2030-06-09,2022-12-27 16:40:12,876.04,in_acc,691797.16
48463,4003462,46.0.54.195,1089.0,atm,20,2900,241679527,DEBIT,0,act,2030-06-09,2023-01-28 01:14:14,875.99,out,690921.17
48464,4206926,188.128.16.226,1203.0,port_trm,451,3220,241679527,DEBIT,0,act,2030-06-09,2023-01-29 21:24:13,876.05,payment,690045.12
48465,5176131,194.87.0.195,580.0,ATM,10,2928,241679527,DEBIT,0,act,2030-06-09,2023-02-21 20:25:41,876.14,add_on_acc,690921.26
48466,5265519,128.0.94.225,1114.0,cash_in,10,6579,241679527,DEBIT,0,act,2030-06-09,2023-03-15 17:43:46,876.24,in,691797.5
48467,5519808,213.151.0.135,1010.0,ATM,10,2928,241679527,DEBIT,0,act,2030-06-09,2023-04-16 06:33:27,876.05,in_acc,692673.55
48468,5645924,46.0.176.180,130.0,ATM,25,3220,241679527,DEBIT,0,act,2030-06-09,2023-04-16 18:33:27,876.0,diff_cntry,691797.55
48469,6353495,128.0.82.165,627.0,atm,25,3220,241679527,DEBIT,0,act,2030-06-09,2023-05-30 22:33:54,875.92,diff_cntry,690921.63
48470,6367743,79.104.0.240,653.0,cash_in,25,6105,241679527,DEBIT,0,act,2030-06-09,2023-06-12 20:54:59,876.04,country_transfer,690045.59
48471,6430336,79.104.0.240,653.0,cash_in,451,2016,241679527,DEBIT,0,act,2030-06-09,2023-07-07 02:30:13,876.02,payment,689169.57
48472,6443267,188.18.0.135,233.0,port_trm,30,2016,241679527,DEBIT,0,act,2030-06-09,2023-07-08 19:21:42,876.02,transfer,688293.55
48473,6495320,188.18.0.135,233.0,port_trm,451,3220,241679527,DEBIT,0,act,2030-06-09,2023-07-17 17:24:21,875.98,payment,687417.57
48474,6564748,185.17.0.150,1061.0,cash_out,20,7161,241679527,DEBIT,0,act,2030-06-09,2023-08-18 09:18:05,876.05,decrease_on_acc,686541.52
48475,6708605,213.151.0.90,1004.0,Portable term,451,3426,241679527,DEBIT,0,act,2030-06-09,2023-09-02 18:34:23,876.16,payment,685665.36
48476,6748026,46.0.176.180,130.0,ATM,25,9974,241679527,DEBIT,0,act,2030-06-09,2023-09-04 19:54:05,875.64,country_transfer,684789.72
48477,6754611,128.0.94.165,1110.0,atm,10,9974,241679527,DEBIT,0,act,2030-06-09,2023-10-16 09:21:05,875.76,add_on_acc,685665.48
48478,6884872,86.111.0.180,1356.0,cash_out,20,3220,241679527,DEBIT,0,act,2030-06-09,2023-11-26 18:24:05,876.01,decrease_on_acc,684789.47
48479,6916821,213.151.0.90,1004.0,Portable term,451,3426,241679527,DEBIT,0,act,2030-06-09,2023-12-10 04:16:03,875.96,payment,683913.51
48480,6918982,79.104.0.240,653.0,cash_in,25,6105,241679527,DEBIT,0,act,2030-06-09,2023-12-13 19:13:13,876.12,diff_cntry,683037.39
48481,6930709,81.17.0.180,1399.0,ATM,20,2266,241679527,DEBIT,0,act,2030-06-09,2023-12-29 23:56:57,875.96,decrease_on_acc,682161.43
48482,7062349,128.0.82.75,616.0,cash_in,10,1646,241679527,DEBIT,0,act,2030-06-09,2024-01-09 23:40:17,876.06,in,683037.49
48483,7081597,188.18.0.135,233.0,port_trm,30,2928,241679527,DEBIT,0,act,2030-06-09,2024-01-13 00:58:35,875.96,transfer,682161.53
48484,7097401,128.0.82.165,627.0,atm,-1,6105,241679527,DEBIT,1,act,2030-06-09,2024-01-15 18:42:25,875.96,err,682161.53
48485,7420395,78.24.158.174,945.0,cash_in,10,3220,241679527,DEBIT,0,act,2030-06-09,2024-02-24 18:31:00,876.18,in_acc,683037.71
48486,7838549,188.128.16.226,1203.0,port_trm,-1,2900,241679527,DEBIT,1,act,2030-06-09,2024-05-02 08:11:10,875.93,err_code,683037.71
48487,8136028,188.128.16.226,1203.0,port_trm,-1,3426,241679527,DEBIT,2,act,2030-06-09,2024-05-17 01:03:28,876.03,bad,683037.71
48488,8161941,88.210.0.195,359.0,cash_out,20,6105,241679527,DEBIT,0,act,2030-06-09,2024-05-21 23:25:53,876.2,from_acc,682161.51
48489,8172701,213.151.0.90,1004.0,Portable term,30,5290,241679527,DEBIT,0,act,2030-06-09,2024-06-10 13:44:15,875.97,transfer,681285.54
48490,8315245,46.0.176.180,130.0,ATM,451,2266,241679527,DEBIT,0,act,2030-06-09,2024-07-08 23:29:57,875.9,payment,680409.64
48491,8518085,188.43.0.105,1411.0,ATM,20,5290,241679527,DEBIT,0,act,2030-06-09,2024-07-15 12:20:54,875.94,from_acc,679533.7
48492,8603595,79.104.0.240,653.0,cash_in,25,2900,241679527,DEBIT,0,act,2030-06-09,2024-07-23 09:28:40,875.88,diff_cntry,678657.82
48493,8851168,194.0.162.165,752.0,atm,10,1646,241679527,DEBIT,0,act,2030-06-09,2024-08-17 19:54:27,876.03,add_on_acc,679533.85
48494,8996041,128.0.94.180,1111.0,ATM,10,2928,241679527,DEBIT,0,act,2030-06-09,2024-08-18 01:16:59,875.89,add_on_acc,680409.74
48495,9268189,188.128.16.226,1203.0,port_trm,451,3135,241679527,DEBIT,0,act,2030-06-09,2024-08-28 06:37:50,876.1,payment,679533.64
48496,9538754,213.151.0.90,1004.0,Portable term,25,2016,241679527,DEBIT,0,act,2030-06-09,2024-09-03 06:34:15,875.99,country_transfer,678657.65
48497,9846143,31.134.0.90,1122.0,cash_in,10,2266,241679527,DEBIT,0,act,2030-06-09,2024-09-11 09:36:38,875.86,in_acc,679533.51
48498,9914492,109.126.0.105,372.0,ATM,20,2928,241679527,DEBIT,0,act,2030-06-09,2024-10-22 04:50:37,875.87,out,678657.64
48499,1005763,46.0.176.0,117.0,cash_in,451,6613,785077432,CREDIT,0,active,2028-07-03,2022-02-04 03:11:22,434.04,payment,159356.96
48500,1217813,217.112.0.0,1471.0,ATM,25,2682,785077432,CREDIT,0,active,2028-07-03,2022-02-15 18:07:40,433.94,country_transfer,158923.02
48501,2096256,193.31.0.60,591.0,atm,20,7219,785077432,CREDIT,0,active,2028-07-03,2022-02-24 22:39:29,433.98,from_acc,158489.04
48502,2206516,85.140.0.150,1262.0,atm,10,4145,785077432,CREDIT,0,active,2028-07-03,2022-03-07 04:10:21,433.84,add_on_acc,158922.88
48503,2356042,77.242.0.60,275.0,atm,10,6382,785077432,CREDIT,0,active,2028-07-03,2022-03-09 04:32:55,433.98,in,159356.86
48504,2831489,95.106.0.75,549.0,cash_in,451,3850,785077432,CREDIT,0,active,2028-07-03,2022-03-26 10:02:30,434.34,payment,158922.52
48505,2925217,185.17.0.225,1066.0,Portable term,-1,7943,785077432,CREDIT,1,active,2028-07-03,2022-03-30 14:58:48,434.07,err_code,158922.52
48506,3088423,188.43.0.120,1412.0,cash_out,451,7428,785077432,CREDIT,0,active,2028-07-03,2022-04-02 13:33:51,433.94,payment,158488.58
48507,3152849,62.118.0.120,530.0,ATM,10,8505,785077432,CREDIT,0,active,2028-07-03,2022-04-08 01:38:43,433.99,in_acc,158922.57
48508,3447492,188.43.0.120,1412.0,cash_out,30,7219,785077432,CREDIT,0,active,2028-07-03,2022-05-01 03:48:15,433.84,transfer,158488.73
48509,3744216,185.17.0.0,1041.0,atm,20,7943,785077432,CREDIT,0,active,2028-07-03,2022-06-01 05:00:48,433.78,decrease_on_acc,158054.95
48510,4107680,185.17.0.225,1066.0,Portable term,-1,8505,785077432,CREDIT,1,active,2028-07-03,2022-06-07 11:32:04,434.02,err_code,158054.95
48511,4186763,188.43.0.120,1412.0,cash_out,25,2665,785077432,CREDIT,0,active,2028-07-03,2022-06-13 20:53:54,434.1,country_transfer,157620.85
48512,4332584,193.0.151.15,51.0,ATM,10,1901,785077432,CREDIT,0,active,2028-07-03,2022-06-23 10:05:46,434.25,add_on_acc,158055.1
48513,4411701,95.106.0.75,549.0,cash_in,451,8737,785077432,CREDIT,0,active,2028-07-03,2022-07-10 10:37:44,434.23,payment,157620.87
48514,4457095,46.0.176.0,117.0,cash_in,30,6613,785077432,CREDIT,0,active,2028-07-03,2022-07-14 03:48:44,433.88,transfer,157186.99
48515,4550019,195.143.0.150,1377.0,ATM,10,8089,785077432,CREDIT,0,active,2028-07-03,2022-08-03 23:56:25,433.82,in_acc,157620.81
48516,4551745,95.106.0.75,549.0,cash_in,451,1073,785077432,CREDIT,0,active,2028-07-03,2022-10-02 09:15:27,433.98,payment,157186.83
48517,4618395,95.106.0.30,544.0,pos trm,451,5730,785077432,CREDIT,0,active,2028-07-03,2022-10-06 22:31:08,434.0,payment,156752.83
48518,4660055,185.17.0.225,1066.0,Portable term,451,4145,785077432,CREDIT,0,active,2028-07-03,2022-11-24 06:13:49,433.89,payment,156318.94
48519,4744280,95.106.0.30,544.0,pos trm,451,3850,785077432,CREDIT,0,active,2028-07-03,2022-12-15 01:52:11,433.97,payment,155884.97
48520,4760804,194.156.0.105,29.0,ATM,10,9167,785077432,CREDIT,0,active,2028-07-03,2022-12-31 13:35:47,434.14,in,156319.11
48521,4788624,37.0.127.30,1023.0,cash_out,20,6569,785077432,CREDIT,0,active,2028-07-03,2023-01-24 12:48:59,433.96,out,155885.15
48522,4789284,188.43.0.105,1411.0,ATM,10,8505,785077432,CREDIT,0,active,2028-07-03,2023-02-12 14:26:47,434.11,in_acc,156319.26
48523,4794161,185.17.0.225,1066.0,Portable term,-1,7943,785077432,CREDIT,1,active,2028-07-03,2023-02-13 07:58:17,434.07,bad,156319.26
48524,5009645,95.106.0.30,544.0,pos trm,30,4145,785077432,CREDIT,0,active,2028-07-03,2023-03-27 09:44:42,434.19,transfer,155885.07
48525,5342613,46.173.0.195,512.0,ATM,451,2959,785077432,CREDIT,0,active,2028-07-03,2023-05-24 18:57:06,433.94,payment,155451.13
48526,5383054,79.104.0.90,642.0,ATM,20,8737,785077432,CREDIT,0,active,2028-07-03,2023-06-18 13:55:18,434.28,from_acc,155016.85
48527,5453473,46.8.0.210,783.0,atm,10,6382,785077432,CREDIT,0,active,2028-07-03,2023-07-11 10:06:17,434.05,in,155450.9
48528,5539692,185.17.0.225,1066.0,Portable term,451,2665,785077432,CREDIT,0,active,2028-07-03,2023-08-02 00:40:57,433.99,payment,155016.91
48529,6074502,46.0.176.0,117.0,cash_in,25,6569,785077432,CREDIT,0,active,2028-07-03,2023-09-30 19:24:02,433.9,country_transfer,154583.01
48530,6583066,217.112.0.0,1471.0,ATM,-1,8089,785077432,CREDIT,1,active,2028-07-03,2023-10-08 22:55:56,434.04,err_code,154583.01
48531,6620993,217.112.0.0,1471.0,ATM,451,6569,785077432,CREDIT,0,active,2028-07-03,2023-10-31 08:11:54,434.23,payment,154148.78
48532,6646490,188.43.0.120,1412.0,cash_out,30,1073,785077432,CREDIT,0,active,2028-07-03,2023-11-01 11:06:55,433.95,transfer,153714.83
48533,6757064,46.173.0.195,512.0,ATM,30,4145,785077432,CREDIT,0,active,2028-07-03,2023-11-24 09:21:39,433.85,transfer,153280.98
48534,6936126,217.112.0.0,1471.0,ATM,451,2682,785077432,CREDIT,0,active,2028-07-03,2023-12-06 09:14:05,434.05,payment,152846.93
48535,7076772,88.210.0.75,346.0,atm,10,3850,785077432,CREDIT,0,active,2028-07-03,2023-12-18 16:08:36,434.04,in,153280.97
48536,7421662,188.43.0.120,1412.0,cash_out,451,8505,785077432,CREDIT,0,active,2028-07-03,2024-02-04 00:31:31,434.04,payment,152846.93
48537,8188840,46.173.0.195,512.0,ATM,25,7943,785077432,CREDIT,0,active,2028-07-03,2024-03-08 14:44:22,434.01,country_transfer,152412.92
48538,8424729,185.17.0.225,1066.0,Portable term,451,4145,785077432,CREDIT,0,active,2028-07-03,2024-04-27 03:46:42,433.95,payment,151978.97
48539,8435684,95.106.0.30,544.0,pos trm,451,2665,785077432,CREDIT,0,active,2028-07-03,2024-07-01 10:56:51,433.82,payment,151545.15
48540,8515884,95.106.0.30,544.0,pos trm,451,3850,785077432,CREDIT,0,active,2028-07-03,2024-07-22 05:57:32,433.75,payment,151111.4
48541,8652655,217.112.0.0,1471.0,ATM,30,5730,785077432,CREDIT,0,active,2028-07-03,2024-07-23 12:52:20,433.99,transfer,150677.41
48542,8790367,46.173.0.195,512.0,ATM,30,5590,785077432,CREDIT,0,active,2028-07-03,2024-10-16 04:53:58,434.07,transfer,150243.34
48543,9086254,95.106.0.30,544.0,pos trm,30,1179,785077432,CREDIT,0,active,2028-07-03,2024-10-22 13:51:10,433.89,transfer,149809.45
48544,9136921,188.43.0.120,1412.0,cash_out,451,7943,785077432,CREDIT,0,active,2028-07-03,2024-10-25 03:21:35,433.65,payment,149375.8
48545,9173613,46.173.0.195,512.0,ATM,451,5590,785077432,CREDIT,0,active,2028-07-03,2024-11-06 05:51:59,433.91,payment,148941.89
48546,9641219,185.17.0.225,1066.0,Portable term,-1,1247,785077432,CREDIT,1,active,2028-07-03,2024-11-11 17:39:36,433.94,err,148941.89
48547,9729562,46.0.176.0,117.0,cash_in,30,7686,785077432,CREDIT,0,active,2028-07-03,2024-11-24 20:30:26,434.23,transfer,148507.66
48548,9784649,128.0.24.90,889.0,ATM,10,4258,785077432,CREDIT,0,active,2028-07-03,2024-11-27 13:28:53,433.93,in,148941.59
48549,1326742,81.17.0.150,1397.0,port_trm,451,9372,789035154,CREDIT,0,active,2026-09-02,2022-02-11 20:24:43,675.01,payment,109794.99
48550,1530985,217.26.0.195,694.0,cash_out,-1,5474,789035154,CREDIT,1,active,2026-09-02,2022-02-19 18:53:00,675.14,err,109794.99
48551,1625522,45.154.0.0,292.0,cash_in,30,3774,789035154,CREDIT,0,active,2026-09-02,2022-03-09 06:30:17,674.78,transfer,109120.21
48552,1667716,46.0.2.0,180.0,atm,30,4228,789035154,CREDIT,0,active,2026-09-02,2022-05-12 19:07:49,674.96,transfer,108445.25
48553,1854851,85.140.0.75,1254.0,prtbl trm,451,3797,789035154,CREDIT,0,active,2026-09-02,2022-05-14 15:02:33,675.03,payment,107770.22
48554,1958244,37.0.124.90,727.0,atm,20,9372,789035154,CREDIT,0,active,2026-09-02,2022-07-10 08:05:51,675.27,decrease_on_acc,107094.95
48555,2207609,37.0.124.165,732.0,ATM,10,5134,789035154,CREDIT,0,active,2026-09-02,2022-07-25 19:56:42,675.18,in_acc,107770.13
48556,2228923,81.17.0.150,1397.0,port_trm,-1,9146,789035154,CREDIT,1,active,2026-09-02,2022-08-01 11:14:08,674.99,bad,107770.13
48557,2337546,185.17.0.90,1052.0,atm,20,6362,789035154,CREDIT,0,active,2026-09-02,2022-08-05 18:03:46,674.82,decrease_on_acc,107095.31
48558,2590495,217.26.0.195,694.0,cash_out,25,9372,789035154,CREDIT,0,active,2026-09-02,2022-08-15 15:56:11,674.86,diff_cntry,106420.45
48559,2638092,185.17.0.180,1063.0,atm,10,5474,789035154,CREDIT,0,active,2026-09-02,2022-09-12 22:13:24,674.68,add_on_acc,107095.13
48560,2860351,81.17.0.150,1397.0,port_trm,30,8660,789035154,CREDIT,0,active,2026-09-02,2022-09-23 04:01:15,674.79,transfer,106420.34
48561,2889468,46.0.2.0,180.0,atm,25,8660,789035154,CREDIT,0,active,2026-09-02,2022-10-12 08:33:31,674.85,country_transfer,105745.49
48562,3131223,45.154.0.0,292.0,cash_in,30,9317,789035154,CREDIT,0,active,2026-09-02,2022-12-05 22:47:33,674.94,transfer,105070.55
48563,3253773,94.243.0.240,116.0,atm,10,1083,789035154,CREDIT,0,active,2026-09-02,2022-12-20 00:46:21,674.99,in_acc,105745.54
48564,3396145,81.17.0.150,1397.0,port_trm,451,4313,789035154,CREDIT,0,active,2026-09-02,2023-01-04 00:05:54,675.2,payment,105070.34
48565,3474659,185.17.0.60,1047.0,pos trm,25,4313,789035154,CREDIT,0,active,2026-09-02,2023-02-02 00:08:19,675.04,diff_cntry,104395.3
48566,3586533,46.0.2.0,180.0,atm,451,9146,789035154,CREDIT,0,active,2026-09-02,2023-02-09 08:50:37,674.94,payment,103720.36
48567,3784170,85.140.0.75,1254.0,prtbl trm,30,3661,789035154,CREDIT,0,active,2026-09-02,2023-02-13 23:10:23,675.21,transfer,103045.15
48568,4049604,46.0.2.0,180.0,atm,30,6362,789035154,CREDIT,0,active,2026-09-02,2023-02-24 02:40:45,675.04,transfer,102370.11
48569,4092501,128.0.24.0,879.0,cash_in,10,9332,789035154,CREDIT,0,active,2026-09-02,2023-04-03 03:48:43,674.88,add_on_acc,103044.99
48570,4132287,45.154.0.0,292.0,cash_in,-1,8325,789035154,CREDIT,1,active,2026-09-02,2023-04-08 00:15:09,674.75,err_code,103044.99
48571,4282986,81.17.0.150,1397.0,port_trm,30,1767,789035154,CREDIT,0,active,2026-09-02,2023-04-18 04:33:44,675.03,transfer,102369.96
48572,4327889,85.140.0.75,1254.0,prtbl trm,25,4268,789035154,CREDIT,0,active,2026-09-02,2023-05-04 23:15:11,674.7,country_transfer,101695.26
48573,4437711,217.26.0.195,694.0,cash_out,451,8660,789035154,CREDIT,0,active,2026-09-02,2023-05-07 11:40:40,674.95,payment,101020.31
48574,4538647,217.26.0.195,694.0,cash_out,451,7414,789035154,CREDIT,0,active,2026-09-02,2023-06-03 16:02:23,675.21,payment,100345.1
48575,4655462,45.154.0.0,292.0,cash_in,25,1083,789035154,CREDIT,0,active,2026-09-02,2023-06-09 07:24:02,674.87,country_transfer,99670.23
48576,4938902,46.0.2.0,180.0,atm,-1,2634,789035154,CREDIT,1,active,2026-09-02,2023-06-11 06:45:17,674.93,bad,99670.23
48577,5102939,85.140.0.75,1254.0,prtbl trm,30,3661,789035154,CREDIT,0,active,2026-09-02,2023-06-21 22:34:23,674.83,transfer,98995.4
48578,5749450,45.154.0.0,292.0,cash_in,30,9372,789035154,CREDIT,0,active,2026-09-02,2023-07-05 22:22:02,675.03,transfer,98320.37
48579,5822401,45.154.0.0,292.0,cash_in,30,8660,789035154,CREDIT,0,active,2026-09-02,2023-08-05 11:00:33,674.8,transfer,97645.57
48580,5833023,185.17.0.60,1047.0,pos trm,30,3774,789035154,CREDIT,0,active,2026-09-02,2023-08-10 13:50:45,675.02,transfer,96970.55
48581,6008891,37.0.123.15,319.0,atm,10,3797,789035154,CREDIT,0,active,2026-09-02,2023-08-27 21:23:18,674.97,add_on_acc,97645.52
48582,6203578,46.173.0.195,512.0,ATM,20,4228,789035154,CREDIT,0,active,2026-09-02,2023-09-26 02:18:28,675.07,decrease_on_acc,96970.45
48583,6408736,217.26.0.195,694.0,cash_out,30,6312,789035154,CREDIT,0,active,2026-09-02,2023-09-28 08:16:12,675.03,transfer,96295.42
48584,6430581,45.154.0.0,292.0,cash_in,25,3797,789035154,CREDIT,0,active,2026-09-02,2023-10-03 13:45:52,675.18,country_transfer,95620.24
48585,7002867,46.0.2.60,185.0,cash_in,10,4542,789035154,CREDIT,0,active,2026-09-02,2023-11-09 20:35:48,674.8,in_acc,96295.04
48586,7209057,85.140.0.75,1254.0,prtbl trm,-1,9332,789035154,CREDIT,1,active,2026-09-02,2023-12-12 17:05:23,675.21,bad,96295.04
48587,7640076,85.140.0.75,1254.0,prtbl trm,451,5134,789035154,CREDIT,0,active,2026-09-02,2024-01-02 13:40:00,674.88,payment,95620.16
48588,7910664,185.17.0.60,1047.0,pos trm,30,5835,789035154,CREDIT,0,active,2026-09-02,2024-02-01 17:41:54,675.22,transfer,94944.94
48589,7967311,185.17.0.60,1047.0,pos trm,451,4438,789035154,CREDIT,0,active,2026-09-02,2024-02-09 10:56:49,674.81,payment,94270.13
48590,8139733,79.104.0.240,653.0,cash_in,10,9332,789035154,CREDIT,0,active,2026-09-02,2024-03-09 02:51:39,674.92,add_on_acc,94945.05
48591,8379402,45.154.0.0,292.0,cash_in,451,9332,789035154,CREDIT,0,active,2026-09-02,2024-03-12 01:44:48,674.91,payment,94270.14
48592,8418195,188.191.0.105,1146.0,cash_out,20,3797,789035154,CREDIT,0,active,2026-09-02,2024-04-08 06:43:45,675.18,decrease_on_acc,93594.96
48593,9045956,185.17.0.60,1047.0,pos trm,451,8660,789035154,CREDIT,0,active,2026-09-02,2024-04-17 10:51:22,675.01,payment,92919.95
48594,9139616,46.0.2.0,180.0,atm,451,3774,789035154,CREDIT,0,active,2026-09-02,2024-04-23 05:38:39,674.7,payment,92245.25
48595,9647687,80.234.0.195,424.0,cash_in,10,3661,789035154,CREDIT,0,active,2026-09-02,2024-07-07 14:30:19,675.19,in_acc,92920.44
48596,9742960,81.17.0.150,1397.0,port_trm,30,5835,789035154,CREDIT,0,active,2026-09-02,2024-09-11 05:10:35,674.93,transfer,92245.51
48597,9744243,217.26.0.195,694.0,cash_out,30,1767,789035154,CREDIT,0,active,2026-09-02,2024-09-14 06:56:43,674.96,transfer,91570.55
48598,9788411,45.154.0.0,292.0,cash_in,451,9372,789035154,CREDIT,0,active,2026-09-02,2024-10-17 16:03:39,675.21,payment,90895.34
48599,9917378,81.17.0.150,1397.0,port_trm,30,7189,789035154,CREDIT,0,active,2026-09-02,2024-11-21 21:44:31,675.1,transfer,90220.24
48600,1105568,62.118.0.75,525.0,ATM,20,8154,970437056,CREDIT,0,active,2026-09-20,2022-01-11 12:18:35,236.16,out,711330.84
48601,1161156,81.17.0.150,1397.0,port_trm,30,8231,970437056,CREDIT,0,active,2026-09-20,2022-01-12 03:09:46,236.03,transfer,711094.81
48602,1242168,46.0.2.210,197.0,port_trm,30,4352,970437056,CREDIT,0,active,2026-09-20,2022-01-22 09:14:49,236.15,transfer,710858.66
48603,1265702,62.118.0.15,520.0,prtbl trm,-1,9240,970437056,CREDIT,1,active,2026-09-20,2022-01-25 05:06:27,236.28,bad,710858.66
48604,1344995,195.143.0.225,1382.0,ATM,10,1725,970437056,CREDIT,0,active,2026-09-20,2022-02-19 09:20:00,235.85,in_acc,711094.51
48605,1390882,62.118.0.15,520.0,prtbl trm,30,9240,970437056,CREDIT,0,active,2026-09-20,2022-03-12 07:16:16,236.04,transfer,710858.47
48606,1723285,46.8.0.105,774.0,cash_out,20,3991,970437056,CREDIT,0,active,2026-09-20,2022-03-29 12:21:52,236.01,decrease_on_acc,710622.46
48607,1779415,88.210.0.210,360.0,atm,20,6267,970437056,CREDIT,0,active,2026-09-20,2022-04-16 15:36:16,236.08,decrease_on_acc,710386.38
48608,1866922,195.58.0.15,1425.0,atm,20,6850,970437056,CREDIT,0,active,2026-09-20,2022-04-21 00:03:46,235.85,out,710150.53
48609,1940503,62.118.0.15,520.0,prtbl trm,451,5505,970437056,CREDIT,0,active,2026-09-20,2022-04-30 04:57:06,235.8,payment,709914.73
48610,2273198,81.17.0.150,1397.0,port_trm,30,9240,970437056,CREDIT,0,active,2026-09-20,2022-05-18 04:05:48,236.02,transfer,709678.71
48611,2399274,185.173.0.135,1282.0,cash_out,25,3694,970437056,CREDIT,0,active,2026-09-20,2022-06-15 01:33:07,236.14,country_transfer,709442.57
48612,2552062,81.17.0.150,1397.0,port_trm,451,3694,970437056,CREDIT,0,active,2026-09-20,2022-07-05 01:37:46,235.72,payment,709206.85
48613,2895156,46.0.143.0,810.0,prtbl trm,451,8154,970437056,CREDIT,0,active,2026-09-20,2022-08-08 15:24:47,236.18,payment,708970.67
48614,2943905,62.118.0.15,520.0,prtbl trm,25,8154,970437056,CREDIT,0,active,2026-09-20,2022-08-20 16:40:24,235.92,country_transfer,708734.75
48615,3400790,81.17.0.150,1397.0,port_trm,451,2185,970437056,CREDIT,0,active,2026-09-20,2022-09-17 18:12:21,235.98,payment,708498.77
48616,3418604,81.17.0.150,1397.0,port_trm,25,5732,970437056,CREDIT,0,active,2026-09-20,2022-10-29 21:09:44,235.65,diff_cntry,708263.12
48617,3764878,46.0.2.210,197.0,port_trm,30,8154,970437056,CREDIT,0,active,2026-09-20,2022-10-31 21:28:40,236.01,transfer,708027.11
48618,3886861,81.17.0.150,1397.0,port_trm,-1,3694,970437056,CREDIT,1,active,2026-09-20,2022-12-17 13:20:59,235.84,bad,708027.11
48619,3923679,46.0.128.210,715.0,atm,20,6292,970437056,CREDIT,0,active,2026-09-20,2022-12-19 14:02:36,236.11,out,707791.0
48620,4037724,85.140.0.150,1262.0,atm,10,5505,970437056,CREDIT,0,active,2026-09-20,2022-12-21 08:56:45,236.08,in,708027.08
48621,4125943,46.0.143.0,810.0,prtbl trm,25,3694,970437056,CREDIT,0,active,2026-09-20,2023-01-19 22:46:45,235.96,country_transfer,707791.12
48622,4361702,46.0.2.210,197.0,port_trm,25,1737,970437056,CREDIT,0,active,2026-09-20,2023-01-25 22:51:32,235.88,country_transfer,707555.24
48623,4393009,62.118.0.15,520.0,prtbl trm,25,3694,970437056,CREDIT,0,active,2026-09-20,2023-02-02 02:21:51,236.01,country_transfer,707319.23
48624,4407514,46.0.2.210,197.0,port_trm,30,5732,970437056,CREDIT,0,active,2026-09-20,2023-04-12 07:31:01,236.04,transfer,707083.19
48625,4555344,217.26.0.135,688.0,ATM,10,9240,970437056,CREDIT,0,active,2026-09-20,2023-04-15 02:58:43,236.08,in,707319.27
48626,4653672,95.106.0.150,557.0,cash_in,10,8154,970437056,CREDIT,0,active,2026-09-20,2023-04-24 22:15:22,236.18,in,707555.45
48627,4709209,185.173.0.135,1282.0,cash_out,-1,1725,970437056,CREDIT,1,active,2026-09-20,2023-06-14 01:27:03,235.91,err,707555.45
48628,4729798,185.173.0.135,1282.0,cash_out,451,6025,970437056,CREDIT,0,active,2026-09-20,2023-08-07 17:04:27,235.82,payment,707319.63
48629,4804462,46.0.2.210,197.0,port_trm,451,6267,970437056,CREDIT,0,active,2026-09-20,2023-08-14 17:08:35,236.01,payment,707083.62
48630,4890330,46.0.0.105,662.0,cash_in,-1,3991,970437056,CREDIT,1,active,2026-09-20,2023-09-03 23:32:33,235.98,err,707083.62
48631,4985473,185.173.0.135,1282.0,cash_out,-1,5066,970437056,CREDIT,2,active,2026-09-20,2023-09-10 17:53:20,236.01,err,707083.62
48632,5314818,81.17.0.150,1397.0,port_trm,25,5066,970437056,CREDIT,0,active,2026-09-20,2023-09-12 18:00:38,235.95,diff_cntry,706847.67
48633,5335826,46.0.143.0,810.0,prtbl trm,25,1725,970437056,CREDIT,0,active,2026-09-20,2023-09-13 11:41:15,235.88,diff_cntry,706611.79
48634,5353573,46.0.0.105,662.0,cash_in,25,6292,970437056,CREDIT,0,active,2026-09-20,2023-09-29 12:42:17,236.17,diff_cntry,706375.62
48635,5685660,46.0.2.210,197.0,port_trm,30,5505,970437056,CREDIT,0,active,2026-09-20,2023-10-16 16:09:25,235.91,transfer,706139.71
48636,5783579,88.210.0.105,349.0,cash_out,20,1737,970437056,CREDIT,0,active,2026-09-20,2023-10-30 19:06:04,236.16,decrease_on_acc,705903.55
48637,5822033,81.17.0.150,1397.0,port_trm,25,3130,970437056,CREDIT,0,active,2026-09-20,2023-11-02 13:07:05,235.94,diff_cntry,705667.61
48638,5893471,46.0.143.0,810.0,prtbl trm,-1,6267,970437056,CREDIT,1,active,2026-09-20,2023-11-27 23:22:30,235.92,err,705667.61
48639,6121583,62.118.0.15,520.0,prtbl trm,-1,3130,970437056,CREDIT,2,active,2026-09-20,2023-12-02 08:28:15,236.08,err_code,705667.61
48640,6138768,46.0.2.210,197.0,port_trm,25,3991,970437056,CREDIT,0,active,2026-09-20,2023-12-08 09:38:46,236.14,diff_cntry,705431.47
48641,7001500,46.0.2.210,197.0,port_trm,-1,8154,970437056,CREDIT,1,active,2026-09-20,2023-12-09 20:30:24,235.92,err_code,705431.47
48642,7022202,46.0.143.0,810.0,prtbl trm,451,8778,970437056,CREDIT,0,active,2026-09-20,2023-12-16 14:33:30,235.82,payment,705195.65
48643,7477172,95.181.0.165,260.0,atm,20,5732,970437056,CREDIT,0,active,2026-09-20,2023-12-22 05:15:15,235.94,out,704959.71
48644,7649396,79.104.0.120,644.0,ATM,20,1737,970437056,CREDIT,0,active,2026-09-20,2024-01-30 06:03:37,236.07,out,704723.64
48645,7662835,46.0.8.165,149.0,cash_out,20,4685,970437056,CREDIT,0,active,2026-09-20,2024-03-16 13:10:11,235.89,decrease_on_acc,704487.75
48646,7905764,81.17.0.150,1397.0,port_trm,451,2185,970437056,CREDIT,0,active,2026-09-20,2024-03-27 15:36:52,235.73,payment,704252.02
48647,7927703,46.0.2.210,197.0,port_trm,-1,4196,970437056,CREDIT,1,active,2026-09-20,2024-05-06 00:28:44,235.75,bad,704252.02
48648,7998459,213.151.0.30,998.0,ATM,10,2185,970437056,CREDIT,0,active,2026-09-20,2024-06-23 13:06:19,236.18,add_on_acc,704488.2
48649,8063128,62.118.0.15,520.0,prtbl trm,30,8154,970437056,CREDIT,0,active,2026-09-20,2024-07-23 02:38:20,235.95,transfer,704252.25
48650,8747995,81.17.0.150,1397.0,port_trm,30,4685,970437056,CREDIT,0,active,2026-09-20,2024-07-24 17:00:13,236.13,transfer,704016.12
48651,8780346,194.87.0.165,577.0,atm,20,3130,970437056,CREDIT,0,active,2026-09-20,2024-07-30 15:27:49,236.37,decrease_on_acc,703779.75
48652,9117631,46.0.0.105,662.0,cash_in,451,6850,970437056,CREDIT,0,active,2026-09-20,2024-08-22 21:14:40,236.05,payment,703543.7
48653,9174377,46.0.143.0,810.0,prtbl trm,30,8778,970437056,CREDIT,0,active,2026-09-20,2024-09-01 14:45:42,235.94,transfer,703307.76
48654,9270639,188.0.166.75,1304.0,atm,20,5505,970437056,CREDIT,0,active,2026-09-20,2024-10-12 07:47:28,235.71,from_acc,703072.05
48655,9465544,81.17.0.150,1397.0,port_trm,451,8154,970437056,CREDIT,0,active,2026-09-20,2024-10-17 06:16:49,235.96,payment,702836.09
48656,9544373,45.154.0.120,304.0,ATM,20,6025,970437056,CREDIT,0,active,2026-09-20,2024-11-10 03:50:11,235.96,decrease_on_acc,702600.13
48657,9768509,185.173.0.135,1282.0,cash_out,25,3991,970437056,CREDIT,0,active,2026-09-20,2024-11-20 11:48:32,236.1,country_transfer,702364.03
48658,9933785,46.0.2.210,197.0,port_trm,451,5505,970437056,CREDIT,0,active,2026-09-20,2024-11-21 18:13:32,236.07,payment,702127.96
48659,1002941,46.0.8.180,151.0,port_trm,25,6023,178679032,DEBIT,0,act,2027-07-14,2022-01-04 12:47:34,628.89,country_transfer,484407.11
48660,1143510,194.0.144.15,159.0,cash_out,451,1397,178679032,DEBIT,0,act,2027-07-14,2022-01-07 08:55:17,628.88,payment,483778.23
48661,1838679,194.0.144.15,159.0,cash_out,25,7944,178679032,DEBIT,0,act,2027-07-14,2022-01-19 06:56:48,628.88,country_transfer,483149.35
48662,1873587,77.242.0.210,287.0,atm,10,1659,178679032,DEBIT,0,act,2027-07-14,2022-01-29 13:46:04,629.09,add_on_acc,483778.44
48663,2018967,188.18.0.120,231.0,port_trm,451,1145,178679032,DEBIT,0,act,2027-07-14,2022-07-13 08:57:17,628.59,payment,483149.85
48664,2046633,188.244.0.240,1470.0,port_trm,25,7944,178679032,DEBIT,0,act,2027-07-14,2022-08-13 00:11:01,629.31,country_transfer,482520.54
48665,2063212,194.0.144.15,159.0,cash_out,25,2213,178679032,DEBIT,0,act,2027-07-14,2022-08-16 14:18:01,629.11,country_transfer,481891.43
48666,2066374,88.210.0.15,341.0,atm,20,5632,178679032,DEBIT,0,act,2027-07-14,2022-08-21 05:40:15,629.24,decrease_on_acc,481262.19
48667,2279811,217.112.0.60,1476.0,atm,10,4146,178679032,DEBIT,0,act,2027-07-14,2022-08-26 05:13:52,629.0,in_acc,481891.19
48668,2370740,188.244.0.240,1470.0,port_trm,451,4974,178679032,DEBIT,0,act,2027-07-14,2022-09-23 20:15:12,628.9,payment,481262.29
48669,2406504,185.233.0.60,81.0,ATM,20,1599,178679032,DEBIT,0,act,2027-07-14,2022-10-15 12:15:26,629.22,out,480633.07
48670,2449758,193.31.0.45,589.0,cash_in,451,1397,178679032,DEBIT,0,act,2027-07-14,2022-10-19 20:20:18,628.84,payment,480004.23
48671,2468119,128.0.82.195,630.0,ATM,10,4791,178679032,DEBIT,0,act,2027-07-14,2022-10-27 06:27:29,629.22,in_acc,480633.45
48672,2528422,188.18.0.0,220.0,atm,20,7934,178679032,DEBIT,0,act,2027-07-14,2022-11-30 12:32:09,628.93,out,480004.52
48673,2664586,188.244.0.240,1470.0,port_trm,451,9922,178679032,DEBIT,0,act,2027-07-14,2022-12-04 10:43:32,628.97,payment,479375.55
48674,3308079,185.17.0.0,1041.0,atm,10,5550,178679032,DEBIT,0,act,2027-07-14,2022-12-05 12:50:47,628.98,in_acc,480004.53
48675,3339597,193.31.0.45,589.0,cash_in,30,1397,178679032,DEBIT,0,act,2027-07-14,2023-01-18 00:08:00,629.13,transfer,479375.4
48676,3724891,46.0.128.210,715.0,atm,10,4791,178679032,DEBIT,0,act,2027-07-14,2023-01-26 11:26:36,629.02,in,480004.42
48677,3771482,193.31.0.45,589.0,cash_in,-1,6527,178679032,DEBIT,1,act,2027-07-14,2023-02-05 09:03:14,629.07,bad,480004.42
48678,3829318,188.43.0.210,1421.0,ATM,-1,5550,178679032,DEBIT,2,act,2027-07-14,2023-02-27 16:15:20,628.9,bad,480004.42
48679,4122024,194.0.144.15,159.0,cash_out,30,9777,178679032,DEBIT,0,act,2027-07-14,2023-03-02 10:37:17,628.94,transfer,479375.48
48680,4364690,46.0.2.165,193.0,cash_in,10,1659,178679032,DEBIT,0,act,2027-07-14,2023-03-09 02:43:08,629.17,in_acc,480004.65
48681,4602121,193.31.0.45,589.0,cash_in,25,7934,178679032,DEBIT,0,act,2027-07-14,2023-03-16 11:59:26,628.96,country_transfer,479375.69
48682,4616570,188.244.0.210,1468.0,cash_in,10,9922,178679032,DEBIT,0,act,2027-07-14,2023-04-17 00:37:39,628.76,add_on_acc,480004.45
48683,4915189,188.244.0.240,1470.0,port_trm,-1,2213,178679032,DEBIT,1,act,2027-07-14,2023-05-05 07:18:45,629.0,bad,480004.45
48684,5153033,188.43.0.210,1421.0,ATM,451,1938,178679032,DEBIT,0,act,2027-07-14,2023-05-12 17:08:14,628.99,payment,479375.46
48685,5280563,78.24.158.24,931.0,ATM,20,6023,178679032,DEBIT,0,act,2027-07-14,2023-05-29 19:56:50,629.25,decrease_on_acc,478746.21
48686,5309265,46.0.54.210,1090.0,atm,20,9976,178679032,DEBIT,0,act,2027-07-14,2023-06-01 19:14:06,629.04,from_acc,478117.17
48687,5845777,37.0.124.195,734.0,ATM,10,1659,178679032,DEBIT,0,act,2027-07-14,2023-07-18 15:28:03,629.07,in,478746.24
48688,5857872,46.0.54.210,1090.0,atm,20,5550,178679032,DEBIT,0,act,2027-07-14,2023-07-27 06:54:50,629.09,decrease_on_acc,478117.15
48689,5979427,46.0.8.180,151.0,port_trm,451,9922,178679032,DEBIT,0,act,2027-07-14,2023-07-28 20:53:14,628.86,payment,477488.29
48690,6328262,88.210.0.150,355.0,cash_in,10,5100,178679032,DEBIT,0,act,2027-07-14,2023-08-07 21:54:14,629.18,in,478117.47
48691,6337046,128.0.94.195,1112.0,cash_in,10,7944,178679032,DEBIT,0,act,2027-07-14,2023-08-19 03:54:28,628.98,in,478746.45
48692,6580117,212.20.0.120,457.0,ATM,20,5550,178679032,DEBIT,0,act,2027-07-14,2023-10-13 17:05:16,629.19,out,478117.26
48693,6732131,88.210.0.15,341.0,atm,10,9922,178679032,DEBIT,0,act,2027-07-14,2023-11-01 08:17:33,629.15,in,478746.41
48694,6958111,62.118.0.165,533.0,cash_out,451,6019,178679032,DEBIT,0,act,2027-07-14,2023-12-13 12:59:47,629.15,payment,478117.26
48695,6977449,188.0.166.15,1297.0,ATM,10,1938,178679032,DEBIT,0,act,2027-07-14,2023-12-29 04:36:56,629.02,add_on_acc,478746.28
48696,7059538,188.244.0.240,1470.0,port_trm,451,4146,178679032,DEBIT,0,act,2027-07-14,2024-01-14 15:30:54,629.02,payment,478117.26
48697,7215535,188.43.0.210,1421.0,ATM,-1,4791,178679032,DEBIT,1,act,2027-07-14,2024-01-17 07:15:52,628.65,bad,478117.26
48698,7236898,193.31.0.45,589.0,cash_in,25,1145,178679032,DEBIT,0,act,2027-07-14,2024-02-10 11:35:41,629.02,country_transfer,477488.24
48699,7312128,62.118.0.165,533.0,cash_out,451,9922,178679032,DEBIT,0,act,2027-07-14,2024-02-23 06:51:58,629.11,payment,476859.13
48700,7355801,188.244.0.240,1470.0,port_trm,30,7944,178679032,DEBIT,0,act,2027-07-14,2024-03-04 02:14:10,628.92,transfer,476230.21
48701,7650333,193.31.0.45,589.0,cash_in,25,5550,178679032,DEBIT,0,act,2027-07-14,2024-03-10 10:35:26,629.07,diff_cntry,475601.14
48702,7835312,193.31.0.45,589.0,cash_in,30,9777,178679032,DEBIT,0,act,2027-07-14,2024-04-01 13:13:54,629.08,transfer,474972.06
48703,7903857,194.0.144.15,159.0,cash_out,451,1938,178679032,DEBIT,0,act,2027-07-14,2024-04-12 09:17:32,628.84,payment,474343.22
48704,8359540,188.244.0.240,1470.0,port_trm,30,1938,178679032,DEBIT,0,act,2027-07-14,2024-04-26 21:17:22,629.14,transfer,473714.08
48705,8495736,194.0.144.15,159.0,cash_out,-1,1145,178679032,DEBIT,1,act,2027-07-14,2024-05-23 09:27:55,629.11,err,473714.08
48706,8696630,194.87.0.90,572.0,atm,10,1599,178679032,DEBIT,0,act,2027-07-14,2024-07-18 09:34:25,628.81,add_on_acc,474342.89
48707,8951699,81.17.0.45,1387.0,cash_in,10,4041,178679032,DEBIT,0,act,2027-07-14,2024-08-22 01:57:28,628.79,in,474971.68
48708,9042034,46.0.8.180,151.0,port_trm,25,1145,178679032,DEBIT,0,act,2027-07-14,2024-08-22 17:15:42,628.85,diff_cntry,474342.83
48709,9412801,188.244.0.240,1470.0,port_trm,30,7934,178679032,DEBIT,0,act,2027-07-14,2024-08-27 07:27:49,629.19,transfer,473713.64
48710,9435500,194.0.144.15,159.0,cash_out,30,7934,178679032,DEBIT,0,act,2027-07-14,2024-10-03 20:06:30,629.02,transfer,473084.62
48711,9469222,188.43.0.210,1421.0,ATM,-1,5632,178679032,DEBIT,1,act,2027-07-14,2024-10-07 09:16:39,629.1,err_code,473084.62
48712,9615791,188.43.0.210,1421.0,ATM,30,5632,178679032,DEBIT,0,act,2027-07-14,2024-10-11 07:05:09,629.01,transfer,472455.61
48713,9951576,194.0.144.15,159.0,cash_out,-1,5874,178679032,DEBIT,1,act,2027-07-14,2024-10-13 07:33:46,628.93,err,472455.61
48714,1508971,37.0.123.15,319.0,atm,10,1256,983813572,DEBIT,0,active,2027-04-11,2022-01-21 16:20:22,1060.93,add_on_acc,784317.93
48715,1654259,81.17.0.225,1402.0,Portable term,30,4718,983813572,DEBIT,0,active,2027-04-11,2022-02-03 13:03:56,1061.05,transfer,783256.88
48716,2078717,46.173.0.105,502.0,atm,20,4231,983813572,DEBIT,0,active,2027-04-11,2022-02-23 02:07:04,1060.82,decrease_on_acc,782196.06
48717,2154657,88.210.0.90,348.0,atm,10,7953,983813572,DEBIT,0,active,2027-04-11,2022-03-21 20:42:56,1061.02,add_on_acc,783257.08
48718,2244228,188.0.0.240,1224.0,port_trm,25,3458,983813572,DEBIT,0,active,2027-04-11,2022-03-24 08:15:55,1061.17,diff_cntry,782195.91
48719,2368509,81.17.0.225,1402.0,Portable term,451,4718,983813572,DEBIT,0,active,2027-04-11,2022-04-02 23:00:52,1061.15,payment,781134.76
48720,2374338,88.210.0.90,348.0,atm,10,5818,983813572,DEBIT,0,active,2027-04-11,2022-04-25 22:19:43,1061.06,in_acc,782195.82
48721,2423687,188.128.16.151,1196.0,port_trm,451,8702,983813572,DEBIT,0,active,2027-04-11,2022-05-07 21:34:56,1061.2,payment,781134.62
48722,2449299,79.104.0.90,642.0,ATM,10,4718,983813572,DEBIT,0,active,2027-04-11,2022-05-16 08:13:13,1060.96,in_acc,782195.58
48723,2642765,194.0.144.105,168.0,ATM,25,5368,983813572,DEBIT,0,active,2027-04-11,2022-06-23 07:24:56,1061.29,country_transfer,781134.29
48724,2682320,81.17.0.225,1402.0,Portable term,451,3458,983813572,DEBIT,0,active,2027-04-11,2022-07-28 02:38:24,1060.87,payment,780073.42
48725,2779593,81.17.0.225,1402.0,Portable term,451,7171,983813572,DEBIT,0,active,2027-04-11,2022-09-05 04:26:23,1060.78,payment,779012.64
48726,2908148,81.17.0.225,1402.0,Portable term,451,3126,983813572,DEBIT,0,active,2027-04-11,2022-10-16 21:59:38,1061.12,payment,777951.52
48727,3062525,188.0.0.240,1224.0,port_trm,451,4718,983813572,DEBIT,0,active,2027-04-11,2022-10-24 13:57:38,1060.79,payment,776890.73
48728,3391963,194.0.144.105,168.0,ATM,30,4231,983813572,DEBIT,0,active,2027-04-11,2022-10-30 04:52:54,1061.27,transfer,775829.46
48729,3464412,194.0.144.105,168.0,ATM,-1,4231,983813572,DEBIT,1,active,2027-04-11,2022-11-24 21:52:18,1060.97,err,775829.46
48730,3612857,188.128.16.151,1196.0,port_trm,451,5525,983813572,DEBIT,0,active,2027-04-11,2022-12-29 23:51:24,1060.84,payment,774768.62
48731,3811000,81.17.0.225,1402.0,Portable term,30,6573,983813572,DEBIT,0,active,2027-04-11,2023-01-20 14:53:28,1061.16,transfer,773707.46
48732,3899825,213.151.0.120,1009.0,ATM,10,8292,983813572,DEBIT,0,active,2027-04-11,2023-01-31 08:53:03,1061.06,in,774768.52
48733,4015698,194.0.144.105,168.0,ATM,25,2262,983813572,DEBIT,0,active,2027-04-11,2023-03-25 11:53:03,1060.96,country_transfer,773707.56
48734,4610876,188.128.16.151,1196.0,port_trm,30,7171,983813572,DEBIT,0,active,2027-04-11,2023-04-13 19:39:41,1060.67,transfer,772646.89
48735,4889241,81.17.0.225,1402.0,Portable term,451,4718,983813572,DEBIT,0,active,2027-04-11,2023-04-14 03:59:38,1061.08,payment,771585.81
48736,5318082,188.0.0.240,1224.0,port_trm,25,3126,983813572,DEBIT,0,active,2027-04-11,2023-04-17 18:06:53,1060.73,diff_cntry,770525.08
48737,5405268,213.151.0.60,1000.0,ATM,451,2262,983813572,DEBIT,0,active,2027-04-11,2023-04-21 23:47:18,1061.49,payment,769463.59
48738,5493855,88.210.0.15,341.0,atm,20,3458,983813572,DEBIT,0,active,2027-04-11,2023-04-27 06:57:28,1061.2,from_acc,768402.39
48739,5579807,37.0.127.180,1035.0,atm,20,7171,983813572,DEBIT,0,active,2027-04-11,2023-05-03 08:49:24,1061.03,decrease_on_acc,767341.36
48740,5633214,194.87.0.90,572.0,atm,10,1256,983813572,DEBIT,0,active,2027-04-11,2023-05-06 13:53:30,1060.98,add_on_acc,768402.34
48741,5682708,5.189.0.15,857.0,cash_in,10,8702,983813572,DEBIT,0,active,2027-04-11,2023-06-09 11:11:47,1060.96,in,769463.3
48742,6009559,134.0.98.15,791.0,pos trm,30,3458,983813572,DEBIT,0,active,2027-04-11,2023-06-22 03:46:40,1060.85,transfer,768402.45
48743,6084910,81.17.0.225,1402.0,Portable term,25,4231,983813572,DEBIT,0,active,2027-04-11,2023-07-06 02:45:03,1060.87,diff_cntry,767341.58
48744,6235083,31.134.0.225,1134.0,cash_in,10,5368,983813572,DEBIT,0,active,2027-04-11,2023-07-23 06:21:47,1061.02,in_acc,768402.6
48745,6316992,81.17.0.225,1402.0,Portable term,25,3458,983813572,DEBIT,0,active,2027-04-11,2023-07-25 16:19:32,1060.97,diff_cntry,767341.63
48746,6490112,188.128.16.151,1196.0,port_trm,451,3204,983813572,DEBIT,0,active,2027-04-11,2023-08-12 09:46:50,1061.26,payment,766280.37
48747,6534476,213.151.0.60,1000.0,ATM,451,3204,983813572,DEBIT,0,active,2027-04-11,2023-09-04 13:54:20,1061.07,payment,765219.3
48748,6596213,213.151.0.60,1000.0,ATM,451,5818,983813572,DEBIT,0,active,2027-04-11,2023-10-17 20:49:34,1061.05,payment,764158.25
48749,6624345,213.151.0.60,1000.0,ATM,25,8292,983813572,DEBIT,0,active,2027-04-11,2023-11-03 02:28:18,1060.92,diff_cntry,763097.33
48750,6981607,194.0.144.105,168.0,ATM,451,3204,983813572,DEBIT,0,active,2027-04-11,2023-12-08 01:17:43,1060.92,payment,762036.41
48751,7059743,188.43.0.120,1412.0,cash_out,20,4718,983813572,DEBIT,0,active,2027-04-11,2023-12-16 23:12:31,1061.08,decrease_on_acc,760975.33
48752,7346099,134.0.98.15,791.0,pos trm,25,7953,983813572,DEBIT,0,active,2027-04-11,2023-12-31 01:20:43,1060.77,diff_cntry,759914.56
48753,7449072,188.128.16.151,1196.0,port_trm,451,5660,983813572,DEBIT,0,active,2027-04-11,2024-04-10 01:52:19,1061.01,payment,758853.55
48754,7518645,134.0.98.15,791.0,pos trm,451,3458,983813572,DEBIT,0,active,2027-04-11,2024-04-11 15:09:21,1061.15,payment,757792.4
48755,7525050,85.140.0.165,1264.0,atm,10,4231,983813572,DEBIT,0,active,2027-04-11,2024-06-16 18:41:09,1061.16,add_on_acc,758853.56
48756,7629450,188.0.0.240,1224.0,port_trm,451,6573,983813572,DEBIT,0,active,2027-04-11,2024-06-17 07:46:43,1060.89,payment,757792.67
48757,8157835,81.17.0.225,1402.0,Portable term,30,5660,983813572,DEBIT,0,active,2027-04-11,2024-06-25 23:35:10,1060.9,transfer,756731.77
48758,8182898,194.0.144.105,168.0,ATM,30,5660,983813572,DEBIT,0,active,2027-04-11,2024-07-16 04:57:30,1061.03,transfer,755670.74
48759,8549914,194.0.144.105,168.0,ATM,-1,7953,983813572,DEBIT,1,active,2027-04-11,2024-08-21 21:07:49,1061.12,bad,755670.74
48760,8780955,95.106.0.180,560.0,cash_out,20,2782,983813572,DEBIT,0,active,2027-04-11,2024-08-23 14:09:03,1060.93,from_acc,754609.81
48761,8855300,134.0.98.15,791.0,pos trm,30,7953,983813572,DEBIT,0,active,2027-04-11,2024-08-30 09:03:02,1061.28,transfer,753548.53
48762,9124515,188.128.16.151,1196.0,port_trm,25,5368,983813572,DEBIT,0,active,2027-04-11,2024-09-12 18:32:20,1060.91,diff_cntry,752487.62
48763,9411318,134.0.98.15,791.0,pos trm,30,2782,983813572,DEBIT,0,active,2027-04-11,2024-09-30 02:02:38,1060.68,transfer,751426.94
48764,9798987,188.0.169.225,485.0,cash_in,10,7171,983813572,DEBIT,0,active,2027-04-11,2024-10-29 06:46:46,1060.66,add_on_acc,752487.6
48765,1194530,194.87.0.60,570.0,cash_out,30,7505,430766543,CREDIT,0,active,2030-11-15,2022-01-09 12:50:15,756.03,transfer,776293.97
48766,1220304,194.87.0.165,577.0,atm,10,2927,430766543,CREDIT,0,active,2030-11-15,2022-01-29 23:24:43,755.84,in_acc,777049.81
48767,1295331,46.0.54.210,1090.0,atm,25,7980,430766543,CREDIT,0,active,2030-11-15,2022-02-01 03:01:33,755.92,diff_cntry,776293.89
48768,1374237,151.0.38.165,402.0,pos trm,30,5082,430766543,CREDIT,0,active,2030-11-15,2022-02-19 19:45:24,756.11,transfer,775537.78
48769,1487131,188.0.169.180,481.0,pos trm,30,7569,430766543,CREDIT,0,active,2030-11-15,2022-03-13 13:32:54,756.23,transfer,774781.55
48770,1609783,46.0.188.15,1227.0,atm,10,7502,430766543,CREDIT,0,active,2030-11-15,2022-03-20 01:04:08,756.39,add_on_acc,775537.94
48771,1679341,151.0.38.165,402.0,pos trm,-1,3717,430766543,CREDIT,1,active,2030-11-15,2022-05-04 11:45:34,755.97,err_code,775537.94
48772,1758484,151.0.38.165,402.0,pos trm,30,7589,430766543,CREDIT,0,active,2030-11-15,2022-05-23 13:22:46,756.06,transfer,774781.88
48773,1828444,213.151.0.120,1009.0,ATM,10,4157,430766543,CREDIT,0,active,2030-11-15,2022-05-25 00:30:24,756.15,in,775538.03
48774,1865400,151.0.38.165,402.0,pos trm,25,5827,430766543,CREDIT,0,active,2030-11-15,2022-06-04 08:34:29,756.1,diff_cntry,774781.93
48775,1907611,95.181.0.105,255.0,cash_out,20,3470,430766543,CREDIT,0,active,2030-11-15,2022-06-24 12:10:07,755.94,from_acc,774025.99
48776,1919490,188.0.169.180,481.0,pos trm,30,1213,430766543,CREDIT,0,active,2030-11-15,2022-06-30 02:28:25,756.08,transfer,773269.91
48777,2222545,88.210.0.15,341.0,atm,20,5545,430766543,CREDIT,0,active,2030-11-15,2022-08-21 06:18:40,755.76,decrease_on_acc,772514.15
48778,2512001,45.154.0.60,299.0,cash_in,10,1574,430766543,CREDIT,0,active,2030-11-15,2022-08-25 12:16:24,756.25,add_on_acc,773270.4
48779,2549863,151.0.38.165,402.0,pos trm,451,1213,430766543,CREDIT,0,active,2030-11-15,2022-09-04 16:41:56,755.76,payment,772514.64
48780,2574409,37.0.123.0,318.0,ATM,10,5228,430766543,CREDIT,0,active,2030-11-15,2022-09-22 12:38:45,755.84,in_acc,773270.48
48781,2602211,188.0.166.165,1311.0,cash_out,-1,1574,430766543,CREDIT,1,active,2030-11-15,2022-10-17 14:37:59,755.9,err_code,773270.48
48782,2830411,188.244.0.135,1461.0,atm,20,5082,430766543,CREDIT,0,active,2030-11-15,2022-11-08 14:02:53,755.95,decrease_on_acc,772514.53
48783,2846978,5.189.0.90,862.0,port_trm,451,7589,430766543,CREDIT,0,active,2030-11-15,2022-11-20 20:47:22,755.97,payment,771758.56
48784,3130898,195.161.0.0,1162.0,cash_out,30,7505,430766543,CREDIT,0,active,2030-11-15,2022-12-04 20:02:03,756.2,transfer,771002.36
48785,3172654,188.43.0.225,1422.0,cash_in,10,7505,430766543,CREDIT,0,active,2030-11-15,2022-12-08 10:05:53,756.1,add_on_acc,771758.46
48786,3525862,194.87.0.60,570.0,cash_out,25,5976,430766543,CREDIT,0,active,2030-11-15,2022-12-29 12:37:37,756.03,country_transfer,771002.43
48787,3973853,46.0.54.210,1090.0,atm,30,5228,430766543,CREDIT,0,active,2030-11-15,2023-01-05 03:13:15,755.97,transfer,770246.46
48788,4001858,195.161.0.0,1162.0,cash_out,451,3717,430766543,CREDIT,0,active,2030-11-15,2023-01-05 04:39:48,755.96,payment,769490.5
48789,4145610,188.0.166.165,1311.0,cash_out,451,2927,430766543,CREDIT,0,active,2030-11-15,2023-01-08 10:53:13,755.83,payment,768734.67
48790,4195223,188.0.166.165,1311.0,cash_out,30,3470,430766543,CREDIT,0,active,2030-11-15,2023-01-23 19:46:32,756.19,transfer,767978.48
48791,4415646,46.0.54.210,1090.0,atm,-1,5827,430766543,CREDIT,1,active,2030-11-15,2023-01-29 07:01:35,756.03,err_code,767978.48
48792,5017527,45.154.0.195,312.0,atm,451,7589,430766543,CREDIT,0,active,2030-11-15,2023-03-14 04:16:45,755.77,payment,767222.71
48793,5547635,194.87.0.30,568.0,cash_in,10,3470,430766543,CREDIT,0,active,2030-11-15,2023-03-20 09:11:10,756.03,in_acc,767978.74
48794,5712641,188.0.166.165,1311.0,cash_out,30,5976,430766543,CREDIT,0,active,2030-11-15,2023-06-16 13:42:09,755.98,transfer,767222.76
48795,5986237,188.0.166.165,1311.0,cash_out,451,6471,430766543,CREDIT,0,active,2030-11-15,2023-06-27 21:00:01,756.25,payment,766466.51
48796,6051961,194.87.0.60,570.0,cash_out,30,3717,430766543,CREDIT,0,active,2030-11-15,2023-07-25 02:26:13,755.99,transfer,765710.52
48797,6281588,212.20.0.15,446.0,cash_in,10,7980,430766543,CREDIT,0,active,2030-11-15,2023-10-03 06:43:23,756.25,add_on_acc,766466.77
48798,6391703,46.0.54.210,1090.0,atm,25,5228,430766543,CREDIT,0,active,2030-11-15,2023-12-01 16:47:47,756.05,diff_cntry,765710.72
48799,6677042,91.107.0.240,995.0,cash_in,10,2659,430766543,CREDIT,0,active,2030-11-15,2023-12-03 13:25:23,755.86,in,766466.58
48800,6878775,46.173.0.0,487.0,prtbl trm,30,7505,430766543,CREDIT,0,active,2030-11-15,2023-12-05 22:54:43,756.03,transfer,765710.55
48801,7181285,46.0.54.210,1090.0,atm,451,6098,430766543,CREDIT,0,active,2030-11-15,2023-12-23 06:20:31,756.02,payment,764954.53
48802,7223469,195.161.0.0,1162.0,cash_out,30,7589,430766543,CREDIT,0,active,2030-11-15,2024-01-16 01:47:54,755.76,transfer,764198.77
48803,7381480,46.173.0.0,487.0,prtbl trm,451,7589,430766543,CREDIT,0,active,2030-11-15,2024-02-16 13:31:05,755.83,payment,763442.94
48804,7514484,195.161.0.0,1162.0,cash_out,25,5827,430766543,CREDIT,0,active,2030-11-15,2024-03-09 08:37:28,756.11,diff_cntry,762686.83
48805,7533906,151.0.38.165,402.0,pos trm,30,7047,430766543,CREDIT,0,active,2030-11-15,2024-03-11 15:50:22,756.02,transfer,761930.81
48806,7591200,188.191.0.45,1142.0,cash_out,20,4157,430766543,CREDIT,0,active,2030-11-15,2024-03-11 15:54:19,755.96,out,761174.85
48807,7708742,46.0.128.105,708.0,cash_out,20,1992,430766543,CREDIT,0,active,2030-11-15,2024-03-17 12:08:52,755.99,out,760418.86
48808,7781979,151.0.38.165,402.0,pos trm,451,7569,430766543,CREDIT,0,active,2030-11-15,2024-04-20 15:04:11,756.05,payment,759662.81
48809,8038532,62.118.0.75,525.0,ATM,20,6098,430766543,CREDIT,0,active,2030-11-15,2024-04-24 04:53:19,755.91,from_acc,758906.9
48810,8149193,194.87.0.60,570.0,cash_out,25,5545,430766543,CREDIT,0,active,2030-11-15,2024-05-05 17:06:50,755.93,country_transfer,758150.97
48811,8205631,46.173.0.0,487.0,prtbl trm,25,2659,430766543,CREDIT,0,active,2030-11-15,2024-05-31 04:16:06,756.13,country_transfer,757394.84
48812,8525838,46.173.0.0,487.0,prtbl trm,25,3861,430766543,CREDIT,0,active,2030-11-15,2024-07-02 21:23:20,756.27,country_transfer,756638.57
48813,8625014,194.87.0.60,570.0,cash_out,-1,5228,430766543,CREDIT,1,active,2030-11-15,2024-07-10 22:44:05,756.03,err_code,756638.57
48814,8639807,151.0.38.165,402.0,pos trm,451,5827,430766543,CREDIT,0,active,2030-11-15,2024-09-08 00:05:33,756.14,payment,755882.43
48815,8725950,95.106.0.240,564.0,ATM,10,7047,430766543,CREDIT,0,active,2030-11-15,2024-09-09 12:05:30,755.86,add_on_acc,756638.29
48816,9152092,46.0.54.210,1090.0,atm,30,6471,430766543,CREDIT,0,active,2030-11-15,2024-10-05 02:38:02,755.72,transfer,755882.57
48817,9607601,188.0.166.165,1311.0,cash_out,451,2927,430766543,CREDIT,0,active,2030-11-15,2024-10-11 02:46:16,755.97,payment,755126.6
48818,9794470,212.20.0.150,459.0,cash_in,10,5228,430766543,CREDIT,0,active,2030-11-15,2024-10-15 07:00:53,755.85,add_on_acc,755882.45
48819,9794895,46.173.0.0,487.0,prtbl trm,451,7047,430766543,CREDIT,0,active,2030-11-15,2024-11-01 00:55:05,755.9,payment,755126.55
48820,9816872,151.0.38.165,402.0,pos trm,451,1992,430766543,CREDIT,0,active,2030-11-15,2024-11-28 09:45:14,755.98,payment,754370.57
48821,1127232,94.243.0.0,97.0,atm,-1,6581,901505935,CREDIT,1,active,2026-09-11,2022-02-22 06:40:59,596.03,err,432321.0
48822,1201415,46.0.176.240,135.0,cash_out,30,1096,901505935,CREDIT,0,active,2026-09-11,2022-03-15 05:02:05,595.94,transfer,431725.06
48823,1324132,94.243.0.0,97.0,atm,-1,8619,901505935,CREDIT,1,active,2026-09-11,2022-03-16 02:58:16,595.78,err_code,431725.06
48824,1782663,45.154.0.105,303.0,ATM,10,8278,901505935,CREDIT,0,active,2026-09-11,2022-03-25 03:19:12,596.05,add_on_acc,432321.11
48825,1982878,195.143.0.240,1383.0,Portable term,25,5122,901505935,CREDIT,0,active,2026-09-11,2022-04-13 21:54:45,596.19,diff_cntry,431724.92
48826,2183977,185.173.0.165,1284.0,cash_out,451,7957,901505935,CREDIT,0,active,2026-09-11,2022-04-18 03:45:17,595.88,payment,431129.04
48827,2951464,188.0.166.60,1303.0,atm,10,6696,901505935,CREDIT,0,active,2026-09-11,2022-04-26 00:00:10,595.89,in,431724.93
48828,3092335,188.43.0.180,1418.0,pos trm,451,4714,901505935,CREDIT,0,active,2026-09-11,2022-05-29 18:24:02,596.03,payment,431128.9
48829,3154563,94.243.0.0,97.0,atm,30,4927,901505935,CREDIT,0,active,2026-09-11,2022-06-05 21:21:34,596.08,transfer,430532.82
48830,3226422,185.173.0.165,1284.0,cash_out,25,7957,901505935,CREDIT,0,active,2026-09-11,2022-06-09 14:45:54,596.07,country_transfer,429936.75
48831,3443449,128.0.94.210,1113.0,cash_in,25,6116,901505935,CREDIT,0,active,2026-09-11,2022-06-15 08:43:20,596.08,diff_cntry,429340.67
48832,3832431,46.0.176.240,135.0,cash_out,30,9408,901505935,CREDIT,0,active,2026-09-11,2022-07-01 20:53:48,596.1,transfer,428744.57
48833,4119736,37.0.127.180,1035.0,atm,10,6581,901505935,CREDIT,0,active,2026-09-11,2022-07-14 03:32:04,596.27,add_on_acc,429340.84
48834,4201652,94.243.0.0,97.0,atm,25,3549,901505935,CREDIT,0,active,2026-09-11,2022-08-04 22:42:58,595.81,country_transfer,428745.03
48835,4278146,194.0.162.0,739.0,cash_in,10,8619,901505935,CREDIT,0,active,2026-09-11,2022-08-19 13:38:17,595.84,in_acc,429340.87
48836,4424413,188.0.166.240,1316.0,pos trm,-1,1096,901505935,CREDIT,1,active,2026-09-11,2022-08-24 03:56:15,596.05,err,429340.87
48837,4548873,188.43.0.180,1418.0,pos trm,451,3549,901505935,CREDIT,0,active,2026-09-11,2022-08-28 21:03:08,595.95,payment,428744.92
48838,4750546,188.0.166.105,1306.0,prtbl trm,25,4927,901505935,CREDIT,0,active,2026-09-11,2022-09-18 11:55:11,595.98,diff_cntry,428148.94
48839,4899121,46.0.54.150,1086.0,ATM,10,2447,901505935,CREDIT,0,active,2026-09-11,2022-09-27 03:24:36,596.04,in,428744.98
48840,5046630,195.143.0.240,1383.0,Portable term,-1,8619,901505935,CREDIT,1,active,2026-09-11,2022-11-09 00:20:53,596.1,err,428744.98
48841,5135200,45.154.0.180,309.0,atm,20,4400,901505935,CREDIT,0,active,2026-09-11,2022-11-27 07:58:53,596.01,decrease_on_acc,428148.97
48842,5418535,185.173.0.165,1284.0,cash_out,451,6696,901505935,CREDIT,0,active,2026-09-11,2022-12-18 03:37:46,595.86,payment,427553.11
48843,5441627,188.0.166.240,1316.0,pos trm,30,5122,901505935,CREDIT,0,active,2026-09-11,2022-12-18 12:12:55,596.04,transfer,426957.07
48844,5612334,94.243.0.0,97.0,atm,25,1096,901505935,CREDIT,0,active,2026-09-11,2022-12-24 00:04:19,595.97,diff_cntry,426361.1
48845,5614207,195.143.0.240,1383.0,Portable term,30,4927,901505935,CREDIT,0,active,2026-09-11,2023-03-01 08:36:53,596.01,transfer,425765.09
48846,5617185,46.0.9.210,1336.0,cash_out,20,9008,901505935,CREDIT,0,active,2026-09-11,2023-03-17 13:23:32,596.15,out,425168.94
48847,5643647,46.0.176.240,135.0,cash_out,-1,5122,901505935,CREDIT,1,active,2026-09-11,2023-07-21 00:48:37,596.02,err_code,425168.94
48848,5731263,188.0.166.105,1306.0,prtbl trm,30,2490,901505935,CREDIT,0,active,2026-09-11,2023-07-25 09:46:35,596.09,transfer,424572.85
48849,5913301,5.189.0.120,865.0,ATM,10,6116,901505935,CREDIT,0,active,2026-09-11,2023-07-26 09:40:28,596.12,add_on_acc,425168.97
48850,5968564,195.143.0.240,1383.0,Portable term,25,1656,901505935,CREDIT,0,active,2026-09-11,2023-09-15 14:16:30,595.85,country_transfer,424573.12
48851,6327335,94.243.0.0,97.0,atm,451,4400,901505935,CREDIT,0,active,2026-09-11,2023-10-01 00:45:09,595.86,payment,423977.26
48852,6659949,94.243.0.0,97.0,atm,30,9914,901505935,CREDIT,0,active,2026-09-11,2023-11-01 12:46:37,596.05,transfer,423381.21
48853,6669047,195.58.0.120,1435.0,cash_out,20,9008,901505935,CREDIT,0,active,2026-09-11,2023-11-09 14:38:51,595.95,out,422785.26
48854,6804471,88.210.0.240,362.0,ATM,10,4400,901505935,CREDIT,0,active,2026-09-11,2023-11-17 16:20:47,596.0,in_acc,423381.26
48855,6818779,195.143.0.240,1383.0,Portable term,-1,8278,901505935,CREDIT,1,active,2026-09-11,2023-12-12 02:45:14,596.2,err,423381.26
48856,6942431,217.112.0.165,1485.0,ATM,10,4930,901505935,CREDIT,0,active,2026-09-11,2024-01-06 23:54:06,595.96,in_acc,423977.22
48857,7195253,94.243.0.0,97.0,atm,25,8619,901505935,CREDIT,0,active,2026-09-11,2024-01-08 10:14:11,596.16,country_transfer,423381.06
48858,7380757,46.0.54.15,1069.0,cash_in,10,4400,901505935,CREDIT,0,active,2026-09-11,2024-01-26 05:29:22,596.04,add_on_acc,423977.1
48859,7473696,94.243.0.0,97.0,atm,451,1096,901505935,CREDIT,0,active,2026-09-11,2024-01-29 04:28:32,595.93,payment,423381.17
48860,7523782,188.43.0.180,1418.0,pos trm,25,2447,901505935,CREDIT,0,active,2026-09-11,2024-02-18 11:44:33,596.27,country_transfer,422784.9
48861,7561876,128.0.24.135,893.0,Portable term,-1,8619,901505935,CREDIT,1,active,2026-09-11,2024-03-14 04:42:40,595.88,err_code,422784.9
48862,7568211,128.0.94.210,1113.0,cash_in,25,1096,901505935,CREDIT,0,active,2026-09-11,2024-03-24 21:49:40,595.97,diff_cntry,422188.93
48863,7776696,94.243.0.0,97.0,atm,25,4930,901505935,CREDIT,0,active,2026-09-11,2024-04-01 16:04:13,596.14,diff_cntry,421592.79
48864,8176009,188.0.166.105,1306.0,prtbl trm,451,6696,901505935,CREDIT,0,active,2026-09-11,2024-05-11 23:48:26,596.19,payment,420996.6
48865,8195628,195.143.0.240,1383.0,Portable term,451,5122,901505935,CREDIT,0,active,2026-09-11,2024-05-20 21:00:37,595.97,payment,420400.63
48866,8502618,185.173.0.210,1288.0,atm,20,6696,901505935,CREDIT,0,active,2026-09-11,2024-05-26 15:40:03,595.81,out,419804.82
48867,8528638,185.173.0.165,1284.0,cash_out,-1,6116,901505935,CREDIT,1,active,2026-09-11,2024-06-18 06:06:52,595.99,bad,419804.82
48868,8549326,188.43.0.180,1418.0,pos trm,-1,1096,901505935,CREDIT,2,active,2026-09-11,2024-06-18 09:07:23,596.22,err_code,419804.82
48869,8870257,94.243.0.0,97.0,atm,25,1096,901505935,CREDIT,0,active,2026-09-11,2024-07-24 20:17:02,595.92,country_transfer,419208.9
48870,8888849,94.243.0.0,97.0,atm,25,5125,901505935,CREDIT,0,active,2026-09-11,2024-08-18 11:31:03,595.84,country_transfer,418613.06
48871,8900614,46.0.176.240,135.0,cash_out,451,6581,901505935,CREDIT,0,active,2026-09-11,2024-08-30 23:42:27,595.88,payment,418017.18
48872,9041292,185.173.0.165,1284.0,cash_out,30,8619,901505935,CREDIT,0,active,2026-09-11,2024-09-09 01:57:48,595.8,transfer,417421.38
48873,9142444,185.173.0.165,1284.0,cash_out,451,9408,901505935,CREDIT,0,active,2026-09-11,2024-09-18 14:29:02,595.91,payment,416825.47
48874,9793582,185.17.0.210,1065.0,atm,10,1096,901505935,CREDIT,0,active,2026-09-11,2024-10-19 03:09:41,596.04,in_acc,417421.51
48875,1197073,195.161.0.60,1167.0,Portable term,451,3484,101814879,CREDIT,0,act,2028-11-04,2022-02-19 12:59:04,385.13,payment,104899.87
48876,1457322,95.167.0.225,218.0,ATM,-1,2607,101814879,CREDIT,1,act,2028-11-04,2022-03-01 01:24:13,384.98,bad,104899.87
48877,1564640,46.0.2.165,193.0,cash_in,10,1291,101814879,CREDIT,0,act,2028-11-04,2022-04-01 19:58:32,384.89,in_acc,105284.76
48878,1566445,31.134.0.15,1117.0,Portable term,451,4908,101814879,CREDIT,0,act,2028-11-04,2022-04-04 03:12:17,384.94,payment,104899.82
48879,1666248,194.87.0.90,572.0,atm,20,2607,101814879,CREDIT,0,act,2028-11-04,2022-04-06 16:12:20,384.85,decrease_on_acc,104514.97
48880,1831046,195.161.0.60,1167.0,Portable term,30,2250,101814879,CREDIT,0,act,2028-11-04,2022-04-07 14:14:35,384.92,transfer,104130.05
48881,1863817,95.167.0.225,218.0,ATM,25,2607,101814879,CREDIT,0,act,2028-11-04,2022-06-18 05:45:56,385.07,diff_cntry,103744.98
48882,1895474,95.106.0.180,560.0,cash_out,451,2250,101814879,CREDIT,0,act,2028-11-04,2022-06-20 20:47:00,385.02,payment,103359.96
48883,1977074,86.111.0.120,1352.0,cash_in,-1,6248,101814879,CREDIT,1,act,2028-11-04,2022-07-04 17:54:52,385.04,err,103359.96
48884,2001925,31.134.0.15,1117.0,Portable term,451,6248,101814879,CREDIT,0,act,2028-11-04,2022-08-17 05:30:53,385.02,payment,102974.94
48885,2043550,195.161.0.60,1167.0,Portable term,451,2607,101814879,CREDIT,0,act,2028-11-04,2022-08-21 21:41:47,384.92,payment,102590.02
48886,2283104,95.167.0.225,218.0,ATM,-1,4933,101814879,CREDIT,1,act,2028-11-04,2022-09-12 06:18:56,384.93,err_code,102590.02
48887,2386491,195.161.0.60,1167.0,Portable term,25,3837,101814879,CREDIT,0,act,2028-11-04,2022-10-11 01:33:30,384.73,diff_cntry,102205.29
48888,2591571,195.161.0.60,1167.0,Portable term,451,6318,101814879,CREDIT,0,act,2028-11-04,2022-10-19 08:16:58,384.98,payment,101820.31
48889,2658359,193.31.0.135,599.0,ATM,20,8642,101814879,CREDIT,0,act,2028-11-04,2022-11-01 08:15:23,385.01,decrease_on_acc,101435.3
48890,2686164,95.106.0.180,560.0,cash_out,30,4908,101814879,CREDIT,0,act,2028-11-04,2022-11-06 10:49:22,384.89,transfer,101050.41
48891,2792848,86.111.0.120,1352.0,cash_in,25,8274,101814879,CREDIT,0,act,2028-11-04,2022-12-06 09:41:36,385.1,country_transfer,100665.31
48892,2802764,31.134.0.15,1117.0,Portable term,30,2732,101814879,CREDIT,0,act,2028-11-04,2022-12-12 12:01:39,384.83,transfer,100280.48
48893,2812637,46.173.0.120,503.0,ATM,20,6318,101814879,CREDIT,0,act,2028-11-04,2022-12-12 23:15:10,385.08,out,99895.4
48894,2833741,31.134.0.15,1117.0,Portable term,-1,6318,101814879,CREDIT,1,act,2028-11-04,2022-12-23 08:51:37,385.06,err_code,99895.4
48895,2885697,188.244.0.75,1455.0,cash_out,30,2607,101814879,CREDIT,0,act,2028-11-04,2023-02-16 02:29:54,385.29,transfer,99510.11
48896,2901634,188.244.0.75,1455.0,cash_out,30,3837,101814879,CREDIT,0,act,2028-11-04,2023-02-27 14:53:42,385.05,transfer,99125.06
48897,3022920,31.134.0.15,1117.0,Portable term,-1,3837,101814879,CREDIT,1,act,2028-11-04,2023-04-06 18:48:49,384.89,bad,99125.06
48898,3023911,188.43.0.210,1421.0,ATM,20,4155,101814879,CREDIT,0,act,2028-11-04,2023-04-29 05:31:56,385.04,from_acc,98740.02
48899,3040751,195.161.0.60,1167.0,Portable term,451,3577,101814879,CREDIT,0,act,2028-11-04,2023-04-30 14:21:42,384.77,payment,98355.25
48900,3077503,195.161.0.60,1167.0,Portable term,30,2250,101814879,CREDIT,0,act,2028-11-04,2023-05-01 07:13:18,384.89,transfer,97970.36
48901,3406786,5.189.0.150,867.0,ATM,20,2732,101814879,CREDIT,0,act,2028-11-04,2023-05-28 01:00:17,384.67,out,97585.69
48902,3715996,188.244.0.75,1455.0,cash_out,30,8642,101814879,CREDIT,0,act,2028-11-04,2023-05-29 03:41:50,384.75,transfer,97200.94
48903,3777259,86.111.0.120,1352.0,cash_in,451,6248,101814879,CREDIT,0,act,2028-11-04,2023-06-01 07:33:12,384.78,payment,96816.16
48904,3907711,31.134.0.120,1124.0,ATM,20,8642,101814879,CREDIT,0,act,2028-11-04,2023-06-05 08:01:04,385.08,decrease_on_acc,96431.08
48905,4126626,188.244.0.75,1455.0,cash_out,-1,6248,101814879,CREDIT,1,act,2028-11-04,2023-06-28 09:04:44,385.17,bad,96431.08
48906,4587202,31.134.0.15,1117.0,Portable term,-1,6248,101814879,CREDIT,2,act,2028-11-04,2023-08-07 18:56:07,385.07,err,96431.08
48907,4958589,188.244.0.75,1455.0,cash_out,451,3577,101814879,CREDIT,0,act,2028-11-04,2023-08-24 00:19:11,385.02,payment,96046.06
48908,4967877,37.0.127.30,1023.0,cash_out,20,2732,101814879,CREDIT,0,act,2028-11-04,2023-09-07 14:52:55,384.89,out,95661.17
48909,5226258,188.244.0.75,1455.0,cash_out,-1,1291,101814879,CREDIT,1,act,2028-11-04,2023-09-24 18:59:01,385.23,err_code,95661.17
48910,5360730,88.210.0.30,342.0,ATM,10,4933,101814879,CREDIT,0,act,2028-11-04,2023-09-30 11:46:01,385.15,add_on_acc,96046.32
48911,5390379,95.106.0.90,550.0,atm,10,7285,101814879,CREDIT,0,act,2028-11-04,2023-10-06 00:03:37,384.85,add_on_acc,96431.17
48912,5521618,86.111.0.120,1352.0,cash_in,451,4933,101814879,CREDIT,0,act,2028-11-04,2023-10-25 06:21:26,385.11,payment,96046.06
48913,5628642,95.167.0.225,218.0,ATM,30,2250,101814879,CREDIT,0,act,2028-11-04,2023-12-02 21:01:06,385.08,transfer,95660.98
48914,5815736,95.106.0.180,560.0,cash_out,30,3837,101814879,CREDIT,0,act,2028-11-04,2023-12-07 22:04:44,384.83,transfer,95276.15
48915,6033394,86.111.0.120,1352.0,cash_in,451,2732,101814879,CREDIT,0,act,2028-11-04,2023-12-14 17:26:39,385.1,payment,94891.05
48916,6210761,95.106.0.90,550.0,atm,10,7285,101814879,CREDIT,0,act,2028-11-04,2023-12-17 08:41:18,384.7,in_acc,95275.75
48917,6687275,95.167.0.225,218.0,ATM,30,6248,101814879,CREDIT,0,act,2028-11-04,2023-12-24 02:25:32,384.72,transfer,94891.03
48918,6991640,195.161.0.60,1167.0,Portable term,25,2250,101814879,CREDIT,0,act,2028-11-04,2023-12-28 17:13:28,384.62,diff_cntry,94506.41
48919,7186701,188.128.16.76,1189.0,cash_out,20,8274,101814879,CREDIT,0,act,2028-11-04,2024-01-04 07:12:31,384.96,decrease_on_acc,94121.45
48920,7214183,46.0.54.240,1093.0,atm,20,8642,101814879,CREDIT,0,act,2028-11-04,2024-01-12 01:23:46,384.84,decrease_on_acc,93736.61
48921,7216679,31.134.0.15,1117.0,Portable term,451,3484,101814879,CREDIT,0,act,2028-11-04,2024-01-26 14:38:09,384.87,payment,93351.74
48922,7245640,195.161.0.60,1167.0,Portable term,-1,3484,101814879,CREDIT,1,act,2028-11-04,2024-03-17 10:12:36,385.14,bad,93351.74
48923,7345815,79.104.0.240,653.0,cash_in,10,4908,101814879,CREDIT,0,act,2028-11-04,2024-04-06 16:36:36,385.08,in,93736.82
48924,7464692,86.111.0.120,1352.0,cash_in,451,8274,101814879,CREDIT,0,act,2028-11-04,2024-05-12 07:23:36,385.1,payment,93351.72
48925,8020174,95.106.0.180,560.0,cash_out,451,4155,101814879,CREDIT,0,act,2028-11-04,2024-05-22 10:30:43,384.91,payment,92966.81
48926,8317383,31.134.0.15,1117.0,Portable term,-1,6318,101814879,CREDIT,1,act,2028-11-04,2024-06-01 20:47:41,385.03,err,92966.81
48927,8382728,95.106.0.180,560.0,cash_out,30,4933,101814879,CREDIT,0,act,2028-11-04,2024-06-03 20:52:47,384.7,transfer,92582.11
48928,8408053,46.0.188.135,1238.0,atm,20,6318,101814879,CREDIT,0,act,2028-11-04,2024-09-21 19:48:06,384.93,from_acc,92197.18
48929,8895309,193.31.0.195,605.0,atm,10,8274,101814879,CREDIT,0,act,2028-11-04,2024-09-22 15:23:39,385.11,in_acc,92582.29
48930,9248725,213.151.0.135,1010.0,ATM,10,8642,101814879,CREDIT,0,act,2028-11-04,2024-09-27 09:14:15,384.82,in,92967.11
48931,9407934,213.151.0.180,1014.0,cash_in,10,3837,101814879,CREDIT,0,act,2028-11-04,2024-11-20 14:30:43,385.06,in,93352.17
48932,9993957,188.244.0.75,1455.0,cash_out,451,4933,101814879,CREDIT,0,act,2028-11-04,2024-11-22 17:01:41,385.0,payment,92967.17
48933,1038361,188.244.0.150,1463.0,cash_out,30,2390,963281221,DEBIT,0,act,2028-10-26,2022-01-28 04:20:23,839.9,transfer,254151.1
48934,1200435,188.244.0.150,1463.0,cash_out,451,4756,963281221,DEBIT,0,act,2028-10-26,2022-02-03 03:20:25,840.15,payment,253310.95
48935,1330451,37.0.124.75,726.0,ATM,10,7239,963281221,DEBIT,0,act,2028-10-26,2022-02-16 02:58:16,840.0,add_on_acc,254150.95
48936,1495314,188.191.0.30,1141.0,prtbl trm,30,4662,963281221,DEBIT,0,act,2028-10-26,2022-02-25 22:07:56,839.93,transfer,253311.02
48937,1562051,88.210.0.90,348.0,atm,10,7239,963281221,DEBIT,0,act,2028-10-26,2022-04-13 21:26:55,840.04,in,254151.06
48938,1582087,194.87.0.120,574.0,cash_out,25,2865,963281221,DEBIT,0,act,2028-10-26,2022-04-27 21:54:18,839.89,country_transfer,253311.17
48939,2064818,188.43.0.45,1407.0,prtbl trm,451,6233,963281221,DEBIT,0,act,2028-10-26,2022-05-09 06:11:47,839.69,payment,252471.48
48940,2101480,46.0.9.60,1321.0,ATM,30,4756,963281221,DEBIT,0,act,2028-10-26,2022-05-29 08:40:07,839.77,transfer,251631.71
48941,2278023,188.43.0.45,1407.0,prtbl trm,25,9755,963281221,DEBIT,0,act,2028-10-26,2022-05-30 08:18:31,839.99,country_transfer,250791.72
48942,2616852,46.0.9.60,1321.0,ATM,451,8069,963281221,DEBIT,0,act,2028-10-26,2022-06-10 12:08:32,839.85,payment,249951.87
48943,2661234,85.140.0.135,1260.0,ATM,20,6567,963281221,DEBIT,0,act,2028-10-26,2022-07-07 15:54:48,840.23,out,249111.64
48944,2664085,188.244.0.150,1463.0,cash_out,-1,4662,963281221,DEBIT,1,act,2028-10-26,2022-07-21 06:37:07,840.12,err,249111.64
48945,2863683,188.0.0.165,1217.0,ATM,10,1924,963281221,DEBIT,0,act,2028-10-26,2022-09-10 11:58:20,840.16,in_acc,249951.8
48946,3008656,37.0.124.75,726.0,ATM,20,1924,963281221,DEBIT,0,act,2028-10-26,2022-10-05 15:22:58,839.95,out,249111.85
48947,3428380,37.0.124.180,733.0,pos trm,451,6233,963281221,DEBIT,0,act,2028-10-26,2022-10-21 01:26:06,839.87,payment,248271.98
48948,3483695,188.244.0.150,1463.0,cash_out,451,4784,963281221,DEBIT,0,act,2028-10-26,2022-10-25 13:23:30,839.98,payment,247432.0
48949,3526328,188.43.0.45,1407.0,prtbl trm,451,4660,963281221,DEBIT,0,act,2028-10-26,2022-10-26 13:26:20,840.01,payment,246591.99
48950,3690292,37.0.124.180,733.0,pos trm,451,4869,963281221,DEBIT,0,act,2028-10-26,2022-11-08 12:29:34,840.02,payment,245751.97
48951,3734102,46.0.54.75,1075.0,ATM,25,5038,963281221,DEBIT,0,act,2028-10-26,2022-12-06 23:02:48,840.08,diff_cntry,244911.89
48952,3850373,188.18.0.150,234.0,atm,20,7245,963281221,DEBIT,0,act,2028-10-26,2022-12-15 19:28:41,840.13,out,244071.76
48953,3887795,194.87.0.120,574.0,cash_out,25,4784,963281221,DEBIT,0,act,2028-10-26,2023-01-08 14:10:44,840.0,country_transfer,243231.76
48954,3897373,151.0.38.75,393.0,cash_in,10,6857,963281221,DEBIT,0,act,2028-10-26,2023-02-08 08:47:12,839.96,add_on_acc,244071.72
48955,4173632,37.0.124.180,733.0,pos trm,30,7496,963281221,DEBIT,0,act,2028-10-26,2023-02-15 14:20:45,839.98,transfer,243231.74
48956,4186765,81.17.0.90,1390.0,atm,20,9796,963281221,DEBIT,0,act,2028-10-26,2023-03-05 07:03:34,840.01,decrease_on_acc,242391.73
48957,4471615,188.0.166.90,1305.0,cash_out,20,1128,963281221,DEBIT,0,act,2028-10-26,2023-04-02 00:34:19,839.89,from_acc,241551.84
48958,4563715,193.31.0.195,605.0,atm,20,1128,963281221,DEBIT,0,act,2028-10-26,2023-04-24 19:59:08,840.02,from_acc,240711.82
48959,4711012,188.43.0.45,1407.0,prtbl trm,-1,6567,963281221,DEBIT,1,act,2028-10-26,2023-04-29 23:48:44,840.05,err_code,240711.82
48960,4760038,188.191.0.30,1141.0,prtbl trm,25,1924,963281221,DEBIT,0,act,2028-10-26,2023-05-13 14:41:20,840.1,country_transfer,239871.72
48961,4805329,188.244.0.150,1463.0,cash_out,-1,5075,963281221,DEBIT,1,act,2028-10-26,2023-05-15 22:22:07,839.98,err_code,239871.72
48962,5018803,37.0.124.180,733.0,pos trm,25,6233,963281221,DEBIT,0,act,2028-10-26,2023-05-28 06:25:13,839.83,country_transfer,239031.89
48963,5154148,185.17.0.180,1063.0,atm,10,4784,963281221,DEBIT,0,act,2028-10-26,2023-06-17 15:33:26,840.04,add_on_acc,239871.93
48964,5310909,188.244.0.30,1450.0,port_trm,25,5038,963281221,DEBIT,0,act,2028-10-26,2023-08-12 00:41:01,840.13,country_transfer,239031.8
48965,5353786,46.0.54.150,1086.0,ATM,20,9755,963281221,DEBIT,0,act,2028-10-26,2023-08-18 19:12:53,840.25,from_acc,238191.55
48966,5434945,188.244.0.150,1463.0,cash_out,25,5038,963281221,DEBIT,0,act,2028-10-26,2023-09-08 08:57:22,839.8,diff_cntry,237351.75
48967,6009565,128.0.24.90,889.0,ATM,20,5038,963281221,DEBIT,0,act,2028-10-26,2023-09-15 07:55:26,840.1,from_acc,236511.65
48968,6348257,46.0.2.165,193.0,cash_in,10,6233,963281221,DEBIT,0,act,2028-10-26,2023-10-21 04:24:46,840.28,in,237351.93
48969,6434659,46.0.9.60,1321.0,ATM,451,3757,963281221,DEBIT,0,act,2028-10-26,2023-10-25 16:16:01,840.03,payment,236511.9
48970,6673968,79.104.60.240,444.0,cash_out,20,2390,963281221,DEBIT,0,act,2028-10-26,2023-12-15 20:05:30,840.08,decrease_on_acc,235671.82
48971,7158048,194.0.162.75,745.0,port_trm,451,6857,963281221,DEBIT,0,act,2028-10-26,2023-12-22 07:26:09,839.99,payment,234831.83
48972,7283811,188.244.0.150,1463.0,cash_out,30,4784,963281221,DEBIT,0,act,2028-10-26,2024-01-01 04:26:37,840.05,transfer,233991.78
48973,7306855,134.0.98.210,807.0,atm,20,5913,963281221,DEBIT,0,act,2028-10-26,2024-01-27 14:58:22,839.98,decrease_on_acc,233151.8
48974,7990199,188.43.0.45,1407.0,prtbl trm,451,8069,963281221,DEBIT,0,act,2028-10-26,2024-02-03 10:53:10,839.97,payment,232311.83
48975,8148495,188.43.0.45,1407.0,prtbl trm,25,2390,963281221,DEBIT,0,act,2028-10-26,2024-03-29 17:29:15,839.81,country_transfer,231472.02
48976,8343715,188.244.0.150,1463.0,cash_out,451,8069,963281221,DEBIT,0,act,2028-10-26,2024-04-20 06:27:40,840.06,payment,230631.96
48977,8352881,194.0.162.75,745.0,port_trm,25,4662,963281221,DEBIT,0,act,2028-10-26,2024-05-15 06:20:55,840.0,country_transfer,229791.96
48978,8504215,46.0.54.75,1075.0,ATM,-1,9755,963281221,DEBIT,1,act,2028-10-26,2024-06-04 21:43:14,840.22,err,229791.96
48979,8696013,194.0.162.75,745.0,port_trm,-1,7239,963281221,DEBIT,2,act,2028-10-26,2024-07-17 18:36:56,840.05,err_code,229791.96
48980,8874549,37.0.124.75,726.0,ATM,10,4662,963281221,DEBIT,0,act,2028-10-26,2024-07-29 19:16:51,840.17,add_on_acc,230632.13
48981,9266562,37.0.124.180,733.0,pos trm,25,8069,963281221,DEBIT,0,act,2028-10-26,2024-08-09 23:23:38,839.83,diff_cntry,229792.3
48982,9756600,188.191.0.30,1141.0,prtbl trm,30,6567,963281221,DEBIT,0,act,2028-10-26,2024-08-30 06:55:15,840.12,transfer,228952.18
48983,9776320,37.0.124.180,733.0,pos trm,451,8510,963281221,DEBIT,0,act,2028-10-26,2024-09-13 15:23:39,839.98,payment,228112.2
48984,9777464,188.244.0.150,1463.0,cash_out,451,7239,963281221,DEBIT,0,act,2028-10-26,2024-09-30 23:58:53,840.13,payment,227272.07
48985,9787042,188.191.0.30,1141.0,prtbl trm,451,4660,963281221,DEBIT,0,act,2028-10-26,2024-10-22 07:35:49,840.01,payment,226432.06
48986,9809154,188.191.0.30,1141.0,prtbl trm,30,5075,963281221,DEBIT,0,act,2028-10-26,2024-11-05 02:01:56,839.86,transfer,225592.2
48987,1087945,95.181.0.225,266.0,cash_out,451,6751,807400201,DEBIT,0,active,2028-05-21,2022-01-01 14:05:13,557.75,payment,900824.25
48988,1469431,95.181.0.225,266.0,cash_out,25,5842,807400201,DEBIT,0,active,2028-05-21,2022-01-01 16:15:12,558.06,country_transfer,900266.19
48989,2245295,88.210.0.210,360.0,atm,-1,2936,807400201,DEBIT,1,active,2028-05-21,2022-01-04 10:55:07,558.01,err,900266.19
48990,2296169,37.0.123.90,327.0,atm,25,5783,807400201,DEBIT,0,active,2028-05-21,2022-01-10 15:36:13,557.92,country_transfer,899708.27
48991,2419080,217.112.0.15,1473.0,Portable term,-1,8290,807400201,DEBIT,1,active,2028-05-21,2022-01-12 12:45:15,557.98,bad,899708.27
48992,2640508,128.0.94.75,1102.0,cash_out,451,7638,807400201,DEBIT,0,active,2028-05-21,2022-01-27 10:56:02,557.95,payment,899150.32
48993,2682321,37.0.123.90,327.0,atm,451,7638,807400201,DEBIT,0,active,2028-05-21,2022-02-02 04:08:04,558.23,payment,898592.09
48994,2849267,46.0.176.240,135.0,cash_out,451,7638,807400201,DEBIT,0,active,2028-05-21,2022-02-06 23:03:59,558.0,payment,898034.09
48995,2892093,46.173.0.60,497.0,atm,10,8632,807400201,DEBIT,0,active,2028-05-21,2022-02-07 11:33:21,557.95,in_acc,898592.04
48996,3025281,88.210.0.210,360.0,atm,30,5783,807400201,DEBIT,0,active,2028-05-21,2022-03-26 08:22:07,558.15,transfer,898033.89
48997,3242350,88.210.0.210,360.0,atm,451,5783,807400201,DEBIT,0,active,2028-05-21,2022-04-13 20:12:25,557.92,payment,897475.97
48998,3390490,31.134.0.45,1119.0,atm,10,8632,807400201,DEBIT,0,active,2028-05-21,2022-04-27 13:44:24,558.23,in_acc,898034.2
48999,3455811,128.0.94.180,1111.0,ATM,25,2679,807400201,DEBIT,0,active,2028-05-21,2022-05-10 12:27:01,558.01,country_transfer,897476.19
49000,3777550,77.242.0.15,269.0,atm,20,6751,807400201,DEBIT,0,active,2028-05-21,2022-05-26 10:12:05,557.82,from_acc,896918.37
49001,3835272,46.0.123.105,918.0,cash_out,20,2679,807400201,DEBIT,0,active,2028-05-21,2022-06-07 23:24:37,557.86,from_acc,896360.51
49002,4172433,88.210.0.210,360.0,atm,451,4487,807400201,DEBIT,0,active,2028-05-21,2022-07-17 20:34:16,558.03,payment,895802.48
49003,4570849,128.0.94.75,1102.0,cash_out,451,1261,807400201,DEBIT,0,active,2028-05-21,2022-08-20 21:45:17,557.83,payment,895244.65
49004,4610698,5.189.0.120,865.0,ATM,10,8290,807400201,DEBIT,0,active,2028-05-21,2022-09-05 15:52:32,557.65,in,895802.3
49005,4901505,88.210.0.210,360.0,atm,451,6751,807400201,DEBIT,0,active,2028-05-21,2022-09-13 02:58:19,557.92,payment,895244.38
49006,4919828,46.8.0.210,783.0,atm,10,7638,807400201,DEBIT,0,active,2028-05-21,2022-10-31 11:53:56,558.03,in,895802.41
49007,4956224,128.0.94.75,1102.0,cash_out,-1,7638,807400201,DEBIT,1,active,2028-05-21,2022-11-17 09:14:42,557.99,err,895802.41
49008,5304541,217.112.0.15,1473.0,Portable term,25,4487,807400201,DEBIT,0,active,2028-05-21,2022-12-02 16:49:54,558.0,diff_cntry,895244.41
49009,5395156,128.0.94.75,1102.0,cash_out,-1,1261,807400201,DEBIT,1,active,2028-05-21,2022-12-04 03:38:28,557.89,bad,895244.41
49010,5454998,88.210.0.210,360.0,atm,451,6197,807400201,DEBIT,0,active,2028-05-21,2022-12-11 14:39:48,557.88,payment,894686.53
49011,5555600,88.210.0.210,360.0,atm,30,6197,807400201,DEBIT,0,active,2028-05-21,2022-12-21 13:37:15,558.02,transfer,894128.51
49012,5607840,128.0.94.75,1102.0,cash_out,30,6197,807400201,DEBIT,0,active,2028-05-21,2023-02-06 23:48:22,557.85,transfer,893570.66
49013,5640724,88.210.0.210,360.0,atm,451,5842,807400201,DEBIT,0,active,2028-05-21,2023-03-04 16:19:18,558.12,payment,893012.54
49014,6390540,88.210.0.210,360.0,atm,30,8657,807400201,DEBIT,0,active,2028-05-21,2023-03-08 23:08:57,557.76,transfer,892454.78
49015,6472280,188.43.0.225,1422.0,cash_in,10,8657,807400201,DEBIT,0,active,2028-05-21,2023-04-29 04:42:30,557.66,in,893012.44
49016,6485388,95.181.0.225,266.0,cash_out,30,2396,807400201,DEBIT,0,active,2028-05-21,2023-04-29 15:34:03,557.97,transfer,892454.47
49017,6688539,46.0.176.240,135.0,cash_out,-1,8632,807400201,DEBIT,1,active,2028-05-21,2023-05-19 02:04:44,557.97,err_code,892454.47
49018,6816467,37.0.123.195,334.0,ATM,10,6751,807400201,DEBIT,0,active,2028-05-21,2023-05-20 01:12:19,558.11,add_on_acc,893012.58
49019,7149584,88.210.0.210,360.0,atm,30,7638,807400201,DEBIT,0,active,2028-05-21,2023-06-15 11:51:20,558.11,transfer,892454.47
49020,7249621,95.181.0.225,266.0,cash_out,451,2396,807400201,DEBIT,0,active,2028-05-21,2023-07-07 19:14:08,558.08,payment,891896.39
49021,7339759,188.18.0.195,239.0,cash_in,10,6197,807400201,DEBIT,0,active,2028-05-21,2023-07-22 19:13:23,558.1,in_acc,892454.49
49022,7488443,46.0.176.240,135.0,cash_out,451,1261,807400201,DEBIT,0,active,2028-05-21,2023-08-24 20:21:57,558.22,payment,891896.27
49023,7580352,128.0.94.75,1102.0,cash_out,-1,1261,807400201,DEBIT,1,active,2028-05-21,2023-09-13 13:52:46,558.29,err_code,891896.27
49024,7937366,95.106.0.90,550.0,atm,20,5783,807400201,DEBIT,0,active,2028-05-21,2023-09-22 02:29:43,557.97,decrease_on_acc,891338.3
49025,8081213,128.0.94.180,1111.0,ATM,451,6751,807400201,DEBIT,0,active,2028-05-21,2023-11-25 03:31:46,558.11,payment,890780.19
49026,8104953,46.0.176.240,135.0,cash_out,25,2936,807400201,DEBIT,0,active,2028-05-21,2024-01-12 15:26:10,558.06,diff_cntry,890222.13
49027,8292377,94.243.0.135,108.0,cash_out,20,8632,807400201,DEBIT,0,active,2028-05-21,2024-01-16 10:28:17,558.34,out,889663.79
49028,8401859,95.167.0.75,205.0,ATM,20,4487,807400201,DEBIT,0,active,2028-05-21,2024-02-14 06:25:15,558.03,out,889105.76
49029,8540049,46.0.176.240,135.0,cash_out,451,2396,807400201,DEBIT,0,active,2028-05-21,2024-02-22 03:10:04,557.84,payment,888547.92
49030,8658087,188.18.0.165,235.0,port_trm,25,8632,807400201,DEBIT,0,active,2028-05-21,2024-03-02 04:24:14,557.93,country_transfer,887989.99
49031,8678177,217.112.0.15,1473.0,Portable term,451,5682,807400201,DEBIT,0,active,2028-05-21,2024-03-09 19:25:41,558.02,payment,887431.97
49032,8694498,193.0.151.180,68.0,atm,10,1261,807400201,DEBIT,0,active,2028-05-21,2024-03-25 17:26:57,558.02,in,887989.99
49033,8701069,37.0.123.90,327.0,atm,25,8657,807400201,DEBIT,0,active,2028-05-21,2024-04-01 23:43:50,558.08,country_transfer,887431.91
49034,8979790,46.0.176.240,135.0,cash_out,25,4487,807400201,DEBIT,0,active,2028-05-21,2024-04-04 10:44:20,557.86,diff_cntry,886874.05
49035,8997486,88.210.0.210,360.0,atm,-1,6751,807400201,DEBIT,1,active,2028-05-21,2024-04-12 08:09:54,557.85,err,886874.05
49036,9119724,195.58.0.105,1434.0,ATM,10,1261,807400201,DEBIT,0,active,2028-05-21,2024-04-13 09:41:34,558.13,add_on_acc,887432.18
49037,9127266,217.112.0.15,1473.0,Portable term,451,6751,807400201,DEBIT,0,active,2028-05-21,2024-06-04 03:22:32,558.05,payment,886874.13
49038,9217701,46.173.0.195,512.0,ATM,10,8632,807400201,DEBIT,0,active,2028-05-21,2024-08-21 15:10:45,558.03,in_acc,887432.16
49039,9271198,88.210.0.210,360.0,atm,451,5682,807400201,DEBIT,0,active,2028-05-21,2024-08-23 09:04:23,557.93,payment,886874.23
49040,9345977,37.0.123.90,327.0,atm,451,7777,807400201,DEBIT,0,active,2028-05-21,2024-09-27 13:47:14,557.69,payment,886316.54
49041,9464368,37.0.123.90,327.0,atm,451,5783,807400201,DEBIT,0,active,2028-05-21,2024-10-11 17:20:59,558.17,payment,885758.37
49042,9708134,95.181.0.240,267.0,ATM,10,5842,807400201,DEBIT,0,active,2028-05-21,2024-10-14 08:24:46,557.84,add_on_acc,886316.21
49043,9830782,88.210.0.210,360.0,atm,-1,7777,807400201,DEBIT,1,active,2028-05-21,2024-10-18 00:13:39,558.15,bad,886316.21
49044,9913086,217.112.0.15,1473.0,Portable term,-1,8632,807400201,DEBIT,2,active,2028-05-21,2024-10-26 10:16:09,557.84,err,886316.21
49045,1019131,37.0.127.180,1035.0,atm,20,8965,951062689,CREDIT,0,active,2026-01-24,2022-01-17 16:42:55,785.15,out,453168.85
49046,1415960,5.189.0.120,865.0,ATM,10,7390,951062689,CREDIT,0,active,2026-01-24,2022-01-26 18:34:01,785.13,in,453953.98
49047,2087991,95.167.0.105,208.0,atm,20,7592,951062689,CREDIT,0,active,2026-01-24,2022-03-11 23:33:39,784.91,from_acc,453169.07
49048,2329369,128.0.94.135,1108.0,cash_in,10,7558,951062689,CREDIT,0,active,2026-01-24,2022-04-05 05:20:39,785.05,add_on_acc,453954.12
49049,2462727,46.8.0.120,776.0,pos trm,30,4827,951062689,CREDIT,0,active,2026-01-24,2022-04-09 07:10:41,785.08,transfer,453169.04
49050,2536851,95.106.0.150,557.0,cash_in,-1,5800,951062689,CREDIT,1,active,2026-01-24,2022-04-11 04:58:24,784.94,err_code,453169.04
49051,2607987,128.0.82.135,622.0,port_trm,451,2699,951062689,CREDIT,0,active,2026-01-24,2022-04-20 22:07:29,784.96,payment,452384.08
49052,2886635,46.0.128.225,716.0,ATM,10,2699,951062689,CREDIT,0,active,2026-01-24,2022-05-02 17:12:36,784.83,in,453168.91
49053,3028685,195.58.0.15,1425.0,atm,20,6744,951062689,CREDIT,0,active,2026-01-24,2022-05-23 21:02:07,785.12,out,452383.79
49054,3197562,193.31.0.195,605.0,atm,20,7630,951062689,CREDIT,0,active,2026-01-24,2022-06-19 04:48:31,784.85,out,451598.94
49055,3223042,188.0.166.165,1311.0,cash_out,451,7558,951062689,CREDIT,0,active,2026-01-24,2022-06-20 15:45:47,785.12,payment,450813.82
49056,3252598,45.154.0.180,309.0,atm,30,2952,951062689,CREDIT,0,active,2026-01-24,2022-07-01 16:53:27,785.12,transfer,450028.7
49057,3415002,95.106.0.150,557.0,cash_in,25,2955,951062689,CREDIT,0,active,2026-01-24,2022-07-03 22:54:18,785.16,country_transfer,449243.54
49058,3439243,45.154.0.180,309.0,atm,451,2952,951062689,CREDIT,0,active,2026-01-24,2022-07-28 22:32:07,785.03,payment,448458.51
49059,3571262,46.0.2.15,182.0,cash_in,10,2952,951062689,CREDIT,0,active,2026-01-24,2022-08-26 08:15:33,785.01,in,449243.52
49060,3752134,46.8.0.120,776.0,pos trm,25,6744,951062689,CREDIT,0,active,2026-01-24,2022-09-09 14:42:09,784.75,country_transfer,448458.77
49061,4008719,46.0.176.165,129.0,ATM,20,3897,951062689,CREDIT,0,active,2026-01-24,2022-09-13 22:51:27,785.15,decrease_on_acc,447673.62
49062,4092620,188.0.166.165,1311.0,cash_out,451,2699,951062689,CREDIT,0,active,2026-01-24,2022-11-19 01:46:48,784.91,payment,446888.71
49063,4125123,45.154.0.180,309.0,atm,451,4346,951062689,CREDIT,0,active,2026-01-24,2022-12-25 04:53:34,785.25,payment,446103.46
49064,4348601,128.0.82.135,622.0,port_trm,451,7630,951062689,CREDIT,0,active,2026-01-24,2023-02-01 09:06:23,785.16,payment,445318.3
49065,4476817,95.106.0.150,557.0,cash_in,-1,4827,951062689,CREDIT,1,active,2026-01-24,2023-03-04 19:07:14,785.27,err_code,445318.3
49066,4628411,188.0.166.75,1304.0,atm,10,6744,951062689,CREDIT,0,active,2026-01-24,2023-03-22 02:57:52,785.06,in_acc,446103.36
49067,4632441,188.0.166.165,1311.0,cash_out,451,2760,951062689,CREDIT,0,active,2026-01-24,2023-03-25 15:35:39,784.98,payment,445318.38
49068,4771416,95.106.0.150,557.0,cash_in,451,6744,951062689,CREDIT,0,active,2026-01-24,2023-05-16 17:08:23,785.2,payment,444533.18
49069,4893519,188.0.166.165,1311.0,cash_out,-1,8915,951062689,CREDIT,1,active,2026-01-24,2023-05-20 14:22:42,784.73,bad,444533.18
49070,5074422,95.181.0.15,249.0,ATM,20,7592,951062689,CREDIT,0,active,2026-01-24,2023-06-05 01:03:42,784.81,out,443748.37
49071,5090735,217.112.0.195,1488.0,atm,20,7592,951062689,CREDIT,0,active,2026-01-24,2023-06-10 23:37:52,784.98,from_acc,442963.39
49072,5234045,46.8.0.120,776.0,pos trm,451,3395,951062689,CREDIT,0,active,2026-01-24,2023-06-30 10:42:18,784.82,payment,442178.57
49073,5263126,45.154.0.180,309.0,atm,30,2952,951062689,CREDIT,0,active,2026-01-24,2023-07-10 19:47:54,785.04,transfer,441393.53
49074,5313245,45.154.0.180,309.0,atm,451,2952,951062689,CREDIT,0,active,2026-01-24,2023-07-27 10:37:26,784.76,payment,440608.77
49075,5659899,46.8.0.120,776.0,pos trm,-1,2955,951062689,CREDIT,1,active,2026-01-24,2023-08-18 17:14:10,784.89,bad,440608.77
49076,5709629,188.0.166.165,1311.0,cash_out,25,7592,951062689,CREDIT,0,active,2026-01-24,2023-08-19 07:33:37,784.94,country_transfer,439823.83
49077,5709651,109.126.0.150,376.0,atm,25,4346,951062689,CREDIT,0,active,2026-01-24,2023-08-22 04:15:57,784.78,country_transfer,439039.05
49078,5712876,128.0.82.135,622.0,port_trm,25,8080,951062689,CREDIT,0,active,2026-01-24,2023-10-05 21:15:07,784.81,diff_cntry,438254.24
49079,6136304,188.0.166.165,1311.0,cash_out,451,3395,951062689,CREDIT,0,active,2026-01-24,2023-10-22 05:53:34,784.98,payment,437469.26
49080,6180682,195.161.0.105,1170.0,atm,20,7558,951062689,CREDIT,0,active,2026-01-24,2023-11-14 13:35:45,784.96,decrease_on_acc,436684.3
49081,6220696,109.126.0.150,376.0,atm,-1,2699,951062689,CREDIT,1,active,2026-01-24,2023-12-08 14:30:04,785.18,err_code,436684.3
49082,6277153,95.106.0.150,557.0,cash_in,25,2699,951062689,CREDIT,0,active,2026-01-24,2023-12-09 03:02:59,785.12,country_transfer,435899.18
49083,6517434,95.106.0.150,557.0,cash_in,25,6744,951062689,CREDIT,0,active,2026-01-24,2023-12-27 20:57:37,785.32,country_transfer,435113.86
49084,6549013,45.154.0.180,309.0,atm,451,5626,951062689,CREDIT,0,active,2026-01-24,2024-01-20 16:24:27,785.15,payment,434328.71
49085,6558896,213.151.0.60,1000.0,ATM,20,4532,951062689,CREDIT,0,active,2026-01-24,2024-01-20 17:22:37,784.93,from_acc,433543.78
49086,7106146,45.154.0.180,309.0,atm,451,8344,951062689,CREDIT,0,active,2026-01-24,2024-02-02 04:58:17,784.94,payment,432758.84
49087,7160487,45.154.0.180,309.0,atm,451,7390,951062689,CREDIT,0,active,2026-01-24,2024-02-12 15:04:57,784.88,payment,431973.96
49088,7165216,151.0.38.225,406.0,cash_in,10,8915,951062689,CREDIT,0,active,2026-01-24,2024-02-15 05:17:00,784.93,in,432758.89
49089,7211603,128.0.82.135,622.0,port_trm,30,7630,951062689,CREDIT,0,active,2026-01-24,2024-04-19 03:18:01,785.02,transfer,431973.87
49090,7279559,188.0.166.165,1311.0,cash_out,25,7592,951062689,CREDIT,0,active,2026-01-24,2024-04-26 22:56:52,784.78,diff_cntry,431189.09
49091,7369002,37.0.127.180,1035.0,atm,10,7630,951062689,CREDIT,0,active,2026-01-24,2024-05-18 13:34:08,784.94,in,431974.03
49092,7591247,45.154.0.180,309.0,atm,30,8344,951062689,CREDIT,0,active,2026-01-24,2024-05-25 14:32:35,784.87,transfer,431189.16
49093,7980760,188.191.0.0,1139.0,pos trm,-1,2302,951062689,CREDIT,1,active,2026-01-24,2024-06-21 19:16:54,785.08,err,431189.16
49094,8035371,188.0.0.60,1210.0,ATM,20,3897,951062689,CREDIT,0,active,2026-01-24,2024-07-11 18:55:36,785.2,out,430403.96
49095,8146524,109.126.0.150,376.0,atm,451,7558,951062689,CREDIT,0,active,2026-01-24,2024-08-01 05:02:27,784.97,payment,429618.99
49096,8372102,45.154.0.180,309.0,atm,25,2760,951062689,CREDIT,0,active,2026-01-24,2024-08-02 17:31:00,785.2,country_transfer,428833.79
49097,8612120,188.0.166.165,1311.0,cash_out,30,2699,951062689,CREDIT,0,active,2026-01-24,2024-09-03 06:39:14,785.18,transfer,428048.61
49098,8814788,91.107.0.180,990.0,atm,20,3395,951062689,CREDIT,0,active,2026-01-24,2024-09-09 18:59:48,784.91,from_acc,427263.7
49099,8868051,188.191.0.0,1139.0,pos trm,25,5800,951062689,CREDIT,0,active,2026-01-24,2024-09-23 22:41:02,784.97,country_transfer,426478.73
49100,9061268,109.126.0.150,376.0,atm,451,6744,951062689,CREDIT,0,active,2026-01-24,2024-09-27 13:25:01,784.79,payment,425693.94
49101,9630267,79.104.0.225,652.0,atm,10,8965,951062689,CREDIT,0,active,2026-01-24,2024-10-03 21:32:13,784.74,add_on_acc,426478.68
49102,9632541,46.8.0.120,776.0,pos trm,451,7592,951062689,CREDIT,0,active,2026-01-24,2024-11-02 22:05:07,785.22,payment,425693.46
49103,9641663,45.154.0.180,309.0,atm,451,2302,951062689,CREDIT,0,active,2026-01-24,2024-11-17 06:45:43,785.01,payment,424908.45
49104,1016657,46.0.2.240,199.0,ATM,10,2289,581175235,DEBIT,0,act,2028-08-22,2022-03-14 11:23:12,777.97,in,608153.97
49105,1154488,193.31.0.120,597.0,prtbl trm,25,6797,581175235,DEBIT,0,act,2028-08-22,2022-04-03 03:11:25,778.01,diff_cntry,607375.96
49106,1293523,194.87.0.180,579.0,atm,20,3888,581175235,DEBIT,0,act,2028-08-22,2022-04-16 19:59:33,778.11,out,606597.85
49107,1562869,46.0.54.45,1072.0,atm,20,2289,581175235,DEBIT,0,act,2028-08-22,2022-04-26 05:33:13,778.0,from_acc,605819.85
49108,1755006,95.167.0.30,202.0,prtbl trm,25,1083,581175235,DEBIT,0,act,2028-08-22,2022-04-26 13:05:16,777.93,diff_cntry,605041.92
49109,1796041,193.31.0.120,597.0,prtbl trm,-1,9070,581175235,DEBIT,1,act,2028-08-22,2022-05-22 01:19:08,777.84,err_code,605041.92
49110,1987572,194.156.0.45,25.0,pos trm,451,9070,581175235,DEBIT,0,act,2028-08-22,2022-06-20 14:57:09,778.01,payment,604263.91
49111,2046226,95.167.0.30,202.0,prtbl trm,451,9178,581175235,DEBIT,0,act,2028-08-22,2022-07-12 12:10:32,778.1,payment,603485.81
49112,2141192,193.31.0.120,597.0,prtbl trm,451,8891,581175235,DEBIT,0,act,2028-08-22,2022-08-23 11:42:56,778.13,payment,602707.68
49113,2231858,212.20.0.30,448.0,ATM,30,7070,581175235,DEBIT,0,act,2028-08-22,2022-09-27 08:08:01,778.32,transfer,601929.36
49114,2294986,46.0.0.210,670.0,ATM,20,8708,581175235,DEBIT,0,act,2028-08-22,2022-10-27 08:10:28,777.87,decrease_on_acc,601151.49
49115,2645212,62.118.0.105,529.0,cash_out,451,1083,581175235,DEBIT,0,act,2028-08-22,2022-10-28 18:24:54,778.13,payment,600373.36
49116,2829571,194.156.0.45,25.0,pos trm,451,7780,581175235,DEBIT,0,act,2028-08-22,2022-12-04 18:45:36,778.07,payment,599595.29
49117,3002815,194.156.0.45,25.0,pos trm,451,3888,581175235,DEBIT,0,act,2028-08-22,2023-01-10 02:18:43,777.86,payment,598817.43
49118,3138861,62.118.0.105,529.0,cash_out,30,2703,581175235,DEBIT,0,act,2028-08-22,2023-01-21 17:01:48,778.05,transfer,598039.38
49119,3603628,62.118.0.105,529.0,cash_out,30,1175,581175235,DEBIT,0,act,2028-08-22,2023-04-03 14:09:44,777.96,transfer,597261.42
49120,4063716,88.210.0.75,346.0,atm,20,8708,581175235,DEBIT,0,act,2028-08-22,2023-05-02 17:53:43,777.94,out,596483.48
49121,4495462,194.156.0.45,25.0,pos trm,25,1412,581175235,DEBIT,0,act,2028-08-22,2023-05-29 01:14:32,778.01,diff_cntry,595705.47
49122,5166933,151.0.38.120,398.0,ATM,10,4548,581175235,DEBIT,0,act,2028-08-22,2023-06-05 02:37:43,778.17,in_acc,596483.64
49123,5543935,194.156.0.45,25.0,pos trm,30,5915,581175235,DEBIT,0,act,2028-08-22,2023-06-11 13:44:47,778.03,transfer,595705.61
49124,5646519,46.8.0.225,785.0,ATM,20,9070,581175235,DEBIT,0,act,2028-08-22,2023-07-18 16:40:02,778.1,decrease_on_acc,594927.51
49125,5989949,195.58.0.135,1436.0,atm,20,7589,581175235,DEBIT,0,act,2028-08-22,2023-08-21 08:42:13,778.07,decrease_on_acc,594149.44
49126,6095089,212.20.0.30,448.0,ATM,30,5915,581175235,DEBIT,0,act,2028-08-22,2023-08-26 16:18:36,778.04,transfer,593371.4
49127,6241251,95.106.0.240,564.0,ATM,10,2014,581175235,DEBIT,0,act,2028-08-22,2023-10-02 22:24:13,777.8,in_acc,594149.2
49128,6375303,194.156.0.45,25.0,pos trm,25,5182,581175235,DEBIT,0,act,2028-08-22,2023-12-27 12:24:30,777.93,diff_cntry,593371.27
49129,6652273,193.31.0.120,597.0,prtbl trm,25,1412,581175235,DEBIT,0,act,2028-08-22,2024-01-11 23:43:27,778.0,diff_cntry,592593.27
49130,6858918,62.118.0.105,529.0,cash_out,451,2703,581175235,DEBIT,0,act,2028-08-22,2024-01-18 10:41:01,777.84,payment,591815.43
49131,7242825,46.0.2.195,195.0,cash_in,10,7070,581175235,DEBIT,0,act,2028-08-22,2024-01-26 00:46:38,777.86,add_on_acc,592593.29
49132,7336745,193.31.0.120,597.0,prtbl trm,-1,9070,581175235,DEBIT,1,act,2028-08-22,2024-02-11 13:00:59,778.03,err_code,592593.29
49133,7424277,193.31.0.120,597.0,prtbl trm,451,1083,581175235,DEBIT,0,act,2028-08-22,2024-03-22 16:26:02,777.84,payment,591815.45
49134,7960303,212.20.0.30,448.0,ATM,30,7057,581175235,DEBIT,0,act,2028-08-22,2024-03-25 19:02:43,778.12,transfer,591037.33
49135,8217989,193.31.0.120,597.0,prtbl trm,25,5825,581175235,DEBIT,0,act,2028-08-22,2024-04-10 23:32:28,777.95,diff_cntry,590259.38
49136,8296854,212.20.0.30,448.0,ATM,-1,2703,581175235,DEBIT,1,act,2028-08-22,2024-04-12 08:46:57,778.13,bad,590259.38
49137,8329992,188.18.0.105,228.0,atm,10,7780,581175235,DEBIT,0,act,2028-08-22,2024-04-14 23:34:37,777.97,in_acc,591037.35
49138,8414292,193.31.0.120,597.0,prtbl trm,30,7780,581175235,DEBIT,0,act,2028-08-22,2024-05-04 17:12:25,777.93,transfer,590259.42
49139,8499656,193.31.0.120,597.0,prtbl trm,-1,7589,581175235,DEBIT,1,act,2028-08-22,2024-05-31 10:46:41,777.77,err_code,590259.42
49140,8516076,195.58.0.45,1428.0,cash_in,10,5182,581175235,DEBIT,0,act,2028-08-22,2024-07-02 10:33:31,777.73,add_on_acc,591037.15
49141,8549836,193.31.0.120,597.0,prtbl trm,-1,2289,581175235,DEBIT,1,act,2028-08-22,2024-07-04 13:18:03,777.86,bad,591037.15
49142,8682704,212.20.0.30,448.0,ATM,-1,1412,581175235,DEBIT,2,act,2028-08-22,2024-07-15 12:39:28,778.1,err_code,591037.15
49143,8711953,95.167.0.30,202.0,prtbl trm,451,5182,581175235,DEBIT,0,act,2028-08-22,2024-07-16 07:50:40,778.4,payment,590258.75
49144,8998909,212.20.0.30,448.0,ATM,451,1175,581175235,DEBIT,0,act,2028-08-22,2024-08-07 11:18:26,777.96,payment,589480.79
49145,9102065,193.31.0.120,597.0,prtbl trm,451,7057,581175235,DEBIT,0,act,2028-08-22,2024-08-23 23:08:21,778.02,payment,588702.77
49146,9222748,212.20.0.30,448.0,ATM,30,5915,581175235,DEBIT,0,act,2028-08-22,2024-09-15 09:42:57,778.03,transfer,587924.74
49147,9339888,212.20.0.30,448.0,ATM,25,8702,581175235,DEBIT,0,act,2028-08-22,2024-09-25 17:54:58,777.84,diff_cntry,587146.9
49148,9352541,194.156.0.45,25.0,pos trm,451,7057,581175235,DEBIT,0,act,2028-08-22,2024-10-10 05:04:51,777.99,payment,586368.91
49149,9455957,194.156.0.45,25.0,pos trm,25,6797,581175235,DEBIT,0,act,2028-08-22,2024-10-30 13:01:52,778.19,diff_cntry,585590.72
49150,9461338,212.20.0.30,448.0,ATM,30,7070,581175235,DEBIT,0,act,2028-08-22,2024-11-08 09:42:46,777.96,transfer,584812.76
49151,9580558,95.167.0.30,202.0,prtbl trm,30,1083,581175235,DEBIT,0,act,2028-08-22,2024-11-08 22:07:07,778.06,transfer,584034.7
49152,9692180,62.118.0.105,529.0,cash_out,451,4952,581175235,DEBIT,0,act,2028-08-22,2024-11-27 21:08:31,777.77,payment,583256.93
49153,9985959,195.161.0.30,1164.0,ATM,20,6539,581175235,DEBIT,0,act,2028-08-22,2024-11-28 08:41:22,777.78,from_acc,582479.15
49154,1149750,80.234.0.0,410.0,prtbl trm,30,2445,588156384,DEBIT,0,act,2025-07-12,2022-01-05 21:00:14,899.17,transfer,882353.83
49155,1201213,217.112.0.45,1475.0,pos trm,25,7458,588156384,DEBIT,0,act,2025-07-12,2022-02-06 10:20:17,898.95,diff_cntry,881454.88
49156,1349934,128.0.94.165,1110.0,atm,10,6349,588156384,DEBIT,0,act,2025-07-12,2022-02-17 03:13:30,898.68,in_acc,882353.56
49157,1473140,185.17.0.225,1066.0,Portable term,-1,1679,588156384,DEBIT,1,act,2025-07-12,2022-04-26 12:11:05,898.87,err,882353.56
49158,1942820,188.0.166.195,1313.0,Portable term,25,7458,588156384,DEBIT,0,act,2025-07-12,2022-05-18 09:32:50,899.09,country_transfer,881454.47
49159,2147747,217.112.0.45,1475.0,pos trm,-1,4985,588156384,DEBIT,1,act,2025-07-12,2022-06-03 12:56:24,898.92,bad,881454.47
49160,2582471,185.17.0.225,1066.0,Portable term,-1,7819,588156384,DEBIT,2,act,2025-07-12,2022-06-10 05:05:35,899.08,err_code,881454.47
49161,2670038,46.0.123.75,916.0,ATM,20,7458,588156384,DEBIT,0,act,2025-07-12,2022-06-12 21:57:19,899.08,decrease_on_acc,880555.39
49162,2909195,185.17.0.30,1044.0,ATM,10,5140,588156384,DEBIT,0,act,2025-07-12,2022-07-15 02:40:02,899.05,in,881454.44
49163,3466031,88.210.0.30,342.0,ATM,20,8000,588156384,DEBIT,0,act,2025-07-12,2022-07-22 20:25:57,899.23,decrease_on_acc,880555.21
49164,3640620,88.210.0.45,343.0,cash_in,25,1187,588156384,DEBIT,0,act,2025-07-12,2022-07-23 18:37:36,898.96,country_transfer,879656.25
49165,4304257,185.17.0.225,1066.0,Portable term,451,8721,588156384,DEBIT,0,act,2025-07-12,2022-08-10 04:37:38,899.07,payment,878757.18
49166,4459488,88.210.0.45,343.0,cash_in,30,4565,588156384,DEBIT,0,act,2025-07-12,2022-08-23 00:37:34,898.96,transfer,877858.22
49167,4730685,185.17.0.225,1066.0,Portable term,30,5126,588156384,DEBIT,0,act,2025-07-12,2022-09-12 16:46:12,898.67,transfer,876959.55
49168,5022140,194.156.0.90,28.0,cash_in,10,8721,588156384,DEBIT,0,act,2025-07-12,2022-09-14 14:45:57,898.79,add_on_acc,877858.34
49169,5149008,88.210.0.45,343.0,cash_in,30,6289,588156384,DEBIT,0,act,2025-07-12,2022-10-30 00:10:05,899.06,transfer,876959.28
49170,5199781,185.17.0.225,1066.0,Portable term,451,8421,588156384,DEBIT,0,act,2025-07-12,2022-11-11 01:03:22,899.04,payment,876060.24
49171,5385491,88.210.0.45,343.0,cash_in,30,5881,588156384,DEBIT,0,act,2025-07-12,2022-11-14 00:25:31,899.05,transfer,875161.19
49172,5428619,185.17.0.225,1066.0,Portable term,25,2445,588156384,DEBIT,0,act,2025-07-12,2022-11-22 12:02:01,898.84,diff_cntry,874262.35
49173,6006612,188.0.189.195,848.0,cash_out,20,7458,588156384,DEBIT,0,act,2025-07-12,2022-12-21 17:12:47,899.23,out,873363.12
49174,6300499,194.87.0.195,580.0,ATM,20,8000,588156384,DEBIT,0,act,2025-07-12,2023-01-26 11:27:41,898.81,from_acc,872464.31
49175,6412974,77.242.0.90,278.0,cash_in,25,8000,588156384,DEBIT,0,act,2025-07-12,2023-02-07 03:17:09,899.05,diff_cntry,871565.26
49176,6565498,188.0.166.195,1313.0,Portable term,30,1217,588156384,DEBIT,0,act,2025-07-12,2023-02-13 08:37:25,898.99,transfer,870666.27
49177,6613716,185.173.0.45,1276.0,port_trm,-1,7169,588156384,DEBIT,1,act,2025-07-12,2023-03-29 12:51:40,898.85,err,870666.27
49178,6995911,46.0.9.210,1336.0,cash_out,20,5126,588156384,DEBIT,0,act,2025-07-12,2023-04-13 00:53:57,898.94,from_acc,869767.33
49179,7001595,217.112.0.45,1475.0,pos trm,25,8000,588156384,DEBIT,0,act,2025-07-12,2023-05-16 19:39:21,899.07,country_transfer,868868.26
49180,7098487,46.0.9.225,1338.0,ATM,10,1051,588156384,DEBIT,0,act,2025-07-12,2023-05-29 17:36:43,899.21,in_acc,869767.47
49181,7126624,77.242.0.195,286.0,cash_in,10,1217,588156384,DEBIT,0,act,2025-07-12,2023-05-31 01:09:23,898.9,in_acc,870666.37
49182,7224192,46.0.123.225,929.0,ATM,10,5126,588156384,DEBIT,0,act,2025-07-12,2023-06-15 14:20:10,898.96,in,871565.33
49183,7244049,185.17.0.225,1066.0,Portable term,451,5140,588156384,DEBIT,0,act,2025-07-12,2023-09-16 07:45:12,899.17,payment,870666.16
49184,7332515,88.210.0.45,343.0,cash_in,30,1187,588156384,DEBIT,0,act,2025-07-12,2023-09-16 13:29:44,898.9,transfer,869767.26
49185,7449038,185.17.0.225,1066.0,Portable term,451,4985,588156384,DEBIT,0,act,2025-07-12,2023-11-07 08:14:05,899.02,payment,868868.24
49186,7458742,185.173.0.45,1276.0,port_trm,451,6349,588156384,DEBIT,0,act,2025-07-12,2023-11-24 07:53:14,899.22,payment,867969.02
49187,7538964,188.0.166.210,1314.0,cash_out,20,1217,588156384,DEBIT,0,act,2025-07-12,2024-01-07 07:12:08,899.12,decrease_on_acc,867069.9
49188,7543777,77.242.0.90,278.0,cash_in,25,5881,588156384,DEBIT,0,act,2025-07-12,2024-01-29 04:30:17,899.2,diff_cntry,866170.7
49189,7603561,188.43.0.105,1411.0,ATM,10,8201,588156384,DEBIT,0,act,2025-07-12,2024-02-04 00:49:25,899.08,add_on_acc,867069.78
49190,7624505,31.134.0.120,1124.0,ATM,20,1051,588156384,DEBIT,0,act,2025-07-12,2024-04-14 14:02:23,899.02,decrease_on_acc,866170.76
49191,7659250,217.112.0.45,1475.0,pos trm,451,8421,588156384,DEBIT,0,act,2025-07-12,2024-04-14 14:50:29,899.06,payment,865271.7
49192,7705971,193.0.151.90,58.0,cash_out,20,7819,588156384,DEBIT,0,act,2025-07-12,2024-04-18 04:48:17,899.18,out,864372.52
49193,7712069,77.242.0.90,278.0,cash_in,451,4359,588156384,DEBIT,0,act,2025-07-12,2024-05-06 20:19:45,898.88,payment,863473.64
49194,8762227,77.242.0.90,278.0,cash_in,-1,8330,588156384,DEBIT,1,act,2025-07-12,2024-05-15 13:24:12,899.19,err_code,863473.64
49195,8764576,188.0.166.195,1313.0,Portable term,-1,7169,588156384,DEBIT,2,act,2025-07-12,2024-05-15 17:41:35,898.7,bad,863473.64
49196,8815226,188.244.0.0,1448.0,Portable term,451,8721,588156384,DEBIT,0,act,2025-07-12,2024-05-24 00:51:27,899.16,payment,862574.48
49197,8862976,185.173.0.45,1276.0,port_trm,451,4985,588156384,DEBIT,0,act,2025-07-12,2024-07-12 15:25:05,898.92,payment,861675.56
49198,8911905,46.173.0.75,498.0,ATM,20,7819,588156384,DEBIT,0,act,2025-07-12,2024-08-13 12:42:27,898.8,decrease_on_acc,860776.76
49199,8934813,217.112.0.45,1475.0,pos trm,25,1217,588156384,DEBIT,0,act,2025-07-12,2024-08-23 12:31:31,898.85,country_transfer,859877.91
49200,9081496,217.112.0.45,1475.0,pos trm,-1,9805,588156384,DEBIT,1,act,2025-07-12,2024-08-26 23:01:44,898.95,bad,859877.91
49201,9431926,193.31.0.180,603.0,ATM,20,8421,588156384,DEBIT,0,act,2025-07-12,2024-09-23 08:18:31,899.13,from_acc,858978.78
49202,9445432,80.234.0.0,410.0,prtbl trm,451,1679,588156384,DEBIT,0,act,2025-07-12,2024-09-30 07:48:12,899.15,payment,858079.63
49203,9562473,185.17.0.225,1066.0,Portable term,451,4565,588156384,DEBIT,0,act,2025-07-12,2024-10-16 07:48:53,898.79,payment,857180.84
49204,9573960,80.234.0.0,410.0,prtbl trm,451,4565,588156384,DEBIT,0,act,2025-07-12,2024-10-21 23:34:29,898.99,payment,856281.85
49205,9763564,80.234.0.0,410.0,prtbl trm,451,6349,588156384,DEBIT,0,act,2025-07-12,2024-11-04 05:34:43,898.87,payment,855382.98
49206,9880134,185.17.0.225,1066.0,Portable term,451,1217,588156384,DEBIT,0,act,2025-07-12,2024-11-14 02:03:41,898.79,payment,854484.19
49207,1091206,86.111.0.90,1350.0,port_trm,-1,8478,521229176,CREDIT,1,active,2025-07-24,2022-01-03 02:12:38,239.96,err_code,575858.0
49208,1453780,185.233.0.60,81.0,ATM,20,8478,521229176,CREDIT,0,active,2025-07-24,2022-01-17 04:09:18,240.29,decrease_on_acc,575617.71
49209,1475138,31.134.0.60,1120.0,Portable term,-1,3978,521229176,CREDIT,1,active,2025-07-24,2022-02-27 17:32:04,240.06,err,575617.71
49210,1629802,194.0.144.150,172.0,prtbl trm,451,7014,521229176,CREDIT,0,active,2025-07-24,2022-03-23 08:56:40,240.05,payment,575377.66
49211,1747748,194.156.0.105,29.0,ATM,10,7014,521229176,CREDIT,0,active,2025-07-24,2022-05-07 01:45:58,239.79,in,575617.45
49212,1864757,195.143.0.30,1364.0,atm,451,8478,521229176,CREDIT,0,active,2025-07-24,2022-05-27 03:02:03,239.83,payment,575377.62
49213,1975547,185.17.0.180,1063.0,atm,10,3978,521229176,CREDIT,0,active,2025-07-24,2022-05-28 22:43:44,239.78,add_on_acc,575617.4
49214,2017767,194.156.0.165,34.0,cash_in,25,9436,521229176,CREDIT,0,active,2025-07-24,2022-06-06 23:25:23,240.12,country_transfer,575377.28
49215,2455661,128.0.94.105,1105.0,cash_out,20,5553,521229176,CREDIT,0,active,2025-07-24,2022-06-27 01:43:42,240.09,out,575137.19
49216,2547715,195.58.0.30,1426.0,cash_in,10,4392,521229176,CREDIT,0,active,2025-07-24,2022-07-11 00:44:15,240.11,in,575377.3
49217,2549780,193.31.0.180,603.0,ATM,10,6657,521229176,CREDIT,0,active,2025-07-24,2022-07-26 09:05:20,240.19,in,575617.49
49218,2764102,79.104.0.45,639.0,Portable term,30,2430,521229176,CREDIT,0,active,2025-07-24,2022-07-29 05:06:22,239.91,transfer,575377.58
49219,2789573,194.87.0.180,579.0,atm,20,9300,521229176,CREDIT,0,active,2025-07-24,2022-10-04 18:56:14,240.37,decrease_on_acc,575137.21
49220,3145401,31.134.0.60,1120.0,Portable term,30,3978,521229176,CREDIT,0,active,2025-07-24,2022-10-24 01:59:53,239.89,transfer,574897.32
49221,3279569,195.143.0.30,1364.0,atm,451,3464,521229176,CREDIT,0,active,2025-07-24,2022-11-29 05:49:20,239.95,payment,574657.37
49222,3397891,195.143.0.30,1364.0,atm,-1,1940,521229176,CREDIT,1,active,2025-07-24,2022-12-09 01:22:10,239.92,bad,574657.37
49223,3665478,88.210.0.120,350.0,atm,25,9494,521229176,CREDIT,0,active,2025-07-24,2022-12-24 10:41:44,240.05,diff_cntry,574417.32
49224,3843996,86.111.0.90,1350.0,port_trm,25,7014,521229176,CREDIT,0,active,2025-07-24,2023-02-22 09:48:37,239.84,country_transfer,574177.48
49225,4063384,85.140.0.105,1256.0,cash_out,451,5094,521229176,CREDIT,0,active,2025-07-24,2023-03-14 06:49:12,239.78,payment,573937.7
49226,4120703,91.107.0.150,988.0,pos trm,25,8429,521229176,CREDIT,0,active,2025-07-24,2023-04-02 17:47:38,239.85,diff_cntry,573697.85
49227,4249676,194.0.144.150,172.0,prtbl trm,451,6657,521229176,CREDIT,0,active,2025-07-24,2023-04-05 18:32:53,240.03,payment,573457.82
49228,4892220,31.134.0.60,1120.0,Portable term,30,9493,521229176,CREDIT,0,active,2025-07-24,2023-04-09 12:26:05,240.25,transfer,573217.57
49229,4961293,31.134.0.60,1120.0,Portable term,25,7014,521229176,CREDIT,0,active,2025-07-24,2023-05-06 18:19:24,240.18,country_transfer,572977.39
49230,5039579,194.0.144.150,172.0,prtbl trm,451,4182,521229176,CREDIT,0,active,2025-07-24,2023-05-23 09:18:26,239.96,payment,572737.43
49231,5438485,91.107.0.150,988.0,pos trm,-1,8618,521229176,CREDIT,1,active,2025-07-24,2023-08-05 18:51:26,239.73,err,572737.43
49232,5734251,185.173.0.15,1273.0,ATM,10,3464,521229176,CREDIT,0,active,2025-07-24,2023-08-27 23:58:02,239.89,in_acc,572977.32
49233,5742834,86.111.0.90,1350.0,port_trm,451,7014,521229176,CREDIT,0,active,2025-07-24,2023-09-04 12:42:31,240.2,payment,572737.12
49234,5755661,195.143.0.30,1364.0,atm,30,8478,521229176,CREDIT,0,active,2025-07-24,2023-09-10 16:35:33,239.76,transfer,572497.36
49235,5936160,85.140.0.105,1256.0,cash_out,30,4392,521229176,CREDIT,0,active,2025-07-24,2023-09-16 01:05:12,239.91,transfer,572257.45
49236,5951999,85.140.0.105,1256.0,cash_out,451,4392,521229176,CREDIT,0,active,2025-07-24,2023-10-06 02:55:18,239.65,payment,572017.8
49237,6172564,88.210.0.120,350.0,atm,25,9494,521229176,CREDIT,0,active,2025-07-24,2023-10-19 03:48:38,240.08,country_transfer,571777.72
49238,6604475,95.106.0.165,558.0,ATM,10,8478,521229176,CREDIT,0,active,2025-07-24,2023-11-04 13:31:41,239.98,in,572017.7
49239,6645269,79.104.0.45,639.0,Portable term,451,5094,521229176,CREDIT,0,active,2025-07-24,2023-11-05 02:50:10,240.02,payment,571777.68
49240,6870896,37.0.124.90,727.0,atm,10,4182,521229176,CREDIT,0,active,2025-07-24,2024-01-29 07:07:25,240.18,in,572017.86
49241,7328718,77.242.0.210,287.0,atm,20,9436,521229176,CREDIT,0,active,2025-07-24,2024-02-27 15:01:12,239.88,decrease_on_acc,571777.98
49242,7423370,79.104.0.45,639.0,Portable term,25,3464,521229176,CREDIT,0,active,2025-07-24,2024-03-04 20:53:58,239.92,country_transfer,571538.06
49243,7467949,77.242.0.15,269.0,atm,20,2898,521229176,CREDIT,0,active,2025-07-24,2024-03-08 08:34:48,239.85,from_acc,571298.21
49244,7516514,85.140.0.105,1256.0,cash_out,451,7014,521229176,CREDIT,0,active,2025-07-24,2024-03-13 11:14:14,239.77,payment,571058.44
49245,7765053,195.161.0.30,1164.0,ATM,20,1955,521229176,CREDIT,0,active,2025-07-24,2024-03-15 15:01:09,240.05,out,570818.39
49246,7809620,88.210.0.120,350.0,atm,30,9300,521229176,CREDIT,0,active,2025-07-24,2024-03-31 00:12:07,240.0,transfer,570578.39
49247,7853384,195.143.0.30,1364.0,atm,-1,5450,521229176,CREDIT,1,active,2025-07-24,2024-05-20 00:57:32,239.78,bad,570578.39
49248,7875517,195.143.0.30,1364.0,atm,-1,4392,521229176,CREDIT,2,active,2025-07-24,2024-06-30 14:09:15,239.96,bad,570578.39
49249,7894845,86.111.0.90,1350.0,port_trm,25,2898,521229176,CREDIT,0,active,2025-07-24,2024-07-09 22:20:19,239.83,diff_cntry,570338.56
49250,7931046,195.143.0.30,1364.0,atm,451,3978,521229176,CREDIT,0,active,2025-07-24,2024-07-16 07:38:23,239.95,payment,570098.61
49251,7956300,91.107.0.150,988.0,pos trm,25,3978,521229176,CREDIT,0,active,2025-07-24,2024-07-25 22:14:05,240.12,country_transfer,569858.49
49252,8087220,85.140.0.105,1256.0,cash_out,-1,5450,521229176,CREDIT,1,active,2025-07-24,2024-08-23 14:53:29,240.02,err,569858.49
49253,8178312,193.0.151.90,58.0,cash_out,20,6657,521229176,CREDIT,0,active,2025-07-24,2024-09-08 13:00:28,240.02,decrease_on_acc,569618.47
49254,8386154,88.210.0.30,342.0,ATM,20,9493,521229176,CREDIT,0,active,2025-07-24,2024-09-11 14:12:38,239.97,decrease_on_acc,569378.5
49255,8952205,194.156.0.165,34.0,cash_in,30,2430,521229176,CREDIT,0,active,2025-07-24,2024-09-19 15:42:45,239.79,transfer,569138.71
49256,9316764,79.104.0.45,639.0,Portable term,30,5094,521229176,CREDIT,0,active,2025-07-24,2024-09-23 23:07:35,239.97,transfer,568898.74
49257,9334973,185.173.0.75,1278.0,ATM,20,9436,521229176,CREDIT,0,active,2025-07-24,2024-09-28 08:06:58,239.98,from_acc,568658.76
49258,9376852,194.156.0.165,34.0,cash_in,-1,4182,521229176,CREDIT,1,active,2025-07-24,2024-10-31 00:05:40,240.03,err_code,568658.76
49259,9853886,45.154.0.30,297.0,ATM,20,8429,521229176,CREDIT,0,active,2025-07-24,2024-11-05 01:38:39,240.27,decrease_on_acc,568418.49
49260,9959739,195.143.0.30,1364.0,atm,451,5553,521229176,CREDIT,0,active,2025-07-24,2024-11-18 22:18:15,240.15,payment,568178.34
49261,1067600,188.0.169.105,475.0,port_trm,451,1036,400417528,CREDIT,0,active,2028-09-16,2022-01-26 21:14:59,469.87,payment,989258.13
49262,1466929,46.0.2.45,184.0,ATM,20,1710,400417528,CREDIT,0,active,2028-09-16,2022-02-08 09:47:28,470.38,decrease_on_acc,988787.75
49263,1839503,188.0.169.105,475.0,port_trm,451,2942,400417528,CREDIT,0,active,2028-09-16,2022-02-23 09:38:32,469.94,payment,988317.81
49264,1897219,95.181.0.150,259.0,port_trm,25,3936,400417528,CREDIT,0,active,2028-09-16,2022-03-06 16:09:48,469.99,diff_cntry,987847.82
49265,1973929,188.0.166.75,1304.0,atm,451,4849,400417528,CREDIT,0,active,2028-09-16,2022-03-27 16:15:42,470.07,payment,987377.75
49266,2579096,46.173.0.75,498.0,ATM,20,2869,400417528,CREDIT,0,active,2028-09-16,2022-07-06 08:56:00,470.12,from_acc,986907.63
49267,2684939,95.181.0.150,259.0,port_trm,30,8621,400417528,CREDIT,0,active,2028-09-16,2022-07-12 00:36:08,470.07,transfer,986437.56
49268,2756260,188.0.169.105,475.0,port_trm,-1,2502,400417528,CREDIT,1,active,2028-09-16,2022-07-13 05:17:58,469.75,err_code,986437.56
49269,2908434,212.20.0.30,448.0,ATM,10,1036,400417528,CREDIT,0,active,2028-09-16,2022-07-18 10:25:59,469.52,add_on_acc,986907.08
49270,2923570,195.161.0.240,1181.0,cash_out,451,1523,400417528,CREDIT,0,active,2028-09-16,2022-07-25 10:56:22,470.31,payment,986436.77
49271,2936798,188.0.166.75,1304.0,atm,451,1523,400417528,CREDIT,0,active,2028-09-16,2022-08-02 02:08:56,469.99,payment,985966.78
49272,2980586,188.0.166.75,1304.0,atm,25,4849,400417528,CREDIT,0,active,2028-09-16,2022-08-04 06:13:22,469.94,diff_cntry,985496.84
49273,3123187,80.234.0.60,415.0,Portable term,30,7485,400417528,CREDIT,0,active,2028-09-16,2022-08-31 23:52:46,469.9,transfer,985026.94
49274,3146138,80.234.0.60,415.0,Portable term,25,7485,400417528,CREDIT,0,active,2028-09-16,2022-09-18 20:25:29,470.0,country_transfer,984556.94
49275,3562250,188.43.0.90,1410.0,cash_in,10,2502,400417528,CREDIT,0,active,2028-09-16,2022-09-21 09:41:41,469.99,in,985026.93
49276,3638001,80.234.0.60,415.0,Portable term,451,7646,400417528,CREDIT,0,active,2028-09-16,2022-10-03 02:26:34,469.84,payment,984557.09
49277,3937754,95.181.0.150,259.0,port_trm,25,6108,400417528,CREDIT,0,active,2028-09-16,2022-10-07 18:01:06,469.84,country_transfer,984087.25
49278,4046540,188.0.169.105,475.0,port_trm,30,2502,400417528,CREDIT,0,active,2028-09-16,2022-12-03 22:05:57,470.09,transfer,983617.16
49279,4234788,195.161.0.240,1181.0,cash_out,451,1710,400417528,CREDIT,0,active,2028-09-16,2022-12-06 18:58:31,469.89,payment,983147.27
49280,4278776,78.24.158.129,942.0,ATM,10,5697,400417528,CREDIT,0,active,2028-09-16,2022-12-06 22:02:32,470.12,add_on_acc,983617.39
49281,4772419,188.0.166.75,1304.0,atm,25,8466,400417528,CREDIT,0,active,2028-09-16,2022-12-11 09:10:01,470.23,country_transfer,983147.16
49282,5048130,95.181.0.150,259.0,port_trm,25,2120,400417528,CREDIT,0,active,2028-09-16,2022-12-29 00:22:42,469.86,diff_cntry,982677.3
49283,5498446,195.161.0.240,1181.0,cash_out,451,3661,400417528,CREDIT,0,active,2028-09-16,2023-02-27 12:09:10,469.99,payment,982207.31
49284,5509773,80.234.0.60,415.0,Portable term,451,3661,400417528,CREDIT,0,active,2028-09-16,2023-03-01 08:41:40,470.31,payment,981737.0
49285,5577845,88.210.0.90,348.0,atm,20,5697,400417528,CREDIT,0,active,2028-09-16,2023-05-22 14:08:01,470.04,out,981266.96
49286,5758850,46.0.176.165,129.0,ATM,20,2120,400417528,CREDIT,0,active,2028-09-16,2023-05-26 20:09:22,469.74,decrease_on_acc,980797.22
49287,5855935,188.0.169.105,475.0,port_trm,25,2704,400417528,CREDIT,0,active,2028-09-16,2023-06-05 23:05:05,469.9,diff_cntry,980327.32
49288,5901278,188.0.166.75,1304.0,atm,25,1710,400417528,CREDIT,0,active,2028-09-16,2023-06-14 03:49:38,470.24,country_transfer,979857.08
49289,6188787,195.161.0.240,1181.0,cash_out,25,4849,400417528,CREDIT,0,active,2028-09-16,2023-07-13 03:58:52,469.76,country_transfer,979387.32
49290,6310080,212.20.0.225,465.0,atm,20,2869,400417528,CREDIT,0,active,2028-09-16,2023-08-17 00:52:47,469.76,out,978917.56
49291,6886764,213.151.0.105,1007.0,cash_out,20,1523,400417528,CREDIT,0,active,2028-09-16,2023-08-26 09:31:22,470.04,from_acc,978447.52
49292,7122028,185.17.0.0,1041.0,atm,10,2502,400417528,CREDIT,0,active,2028-09-16,2023-09-04 22:52:24,469.93,add_on_acc,978917.45
49293,7322887,188.0.169.105,475.0,port_trm,25,1036,400417528,CREDIT,0,active,2028-09-16,2023-10-04 09:57:21,469.92,diff_cntry,978447.53
49294,7469879,80.234.0.60,415.0,Portable term,30,8586,400417528,CREDIT,0,active,2028-09-16,2023-10-28 13:43:09,470.11,transfer,977977.42
49295,7756663,195.161.0.240,1181.0,cash_out,30,3936,400417528,CREDIT,0,active,2028-09-16,2023-12-04 01:07:39,470.08,transfer,977507.34
49296,8060587,188.0.166.75,1304.0,atm,-1,7485,400417528,CREDIT,1,active,2028-09-16,2023-12-04 15:31:20,469.85,err_code,977507.34
49297,8176741,195.161.0.240,1181.0,cash_out,30,2704,400417528,CREDIT,0,active,2028-09-16,2023-12-20 04:44:21,470.02,transfer,977037.32
49298,8237336,80.234.0.60,415.0,Portable term,451,3936,400417528,CREDIT,0,active,2028-09-16,2024-01-04 22:26:38,469.83,payment,976567.49
49299,8467646,46.0.176.180,130.0,ATM,10,1036,400417528,CREDIT,0,active,2028-09-16,2024-01-10 04:12:49,469.82,add_on_acc,977037.31
49300,8659835,80.234.0.60,415.0,Portable term,25,1036,400417528,CREDIT,0,active,2028-09-16,2024-01-13 09:37:50,469.87,country_transfer,976567.44
49301,8759409,217.112.0.0,1471.0,ATM,10,7646,400417528,CREDIT,0,active,2028-09-16,2024-02-26 13:32:22,470.0,in,977037.44
49302,8776517,46.0.123.225,929.0,ATM,10,7646,400417528,CREDIT,0,active,2028-09-16,2024-03-29 18:06:08,469.98,in,977507.42
49303,8927595,91.107.0.210,993.0,atm,10,2942,400417528,CREDIT,0,active,2028-09-16,2024-05-25 05:34:42,469.99,in_acc,977977.41
49304,9266059,195.161.0.240,1181.0,cash_out,451,5697,400417528,CREDIT,0,active,2028-09-16,2024-06-24 15:44:21,469.95,payment,977507.46
49305,9439445,195.161.0.240,1181.0,cash_out,30,5455,400417528,CREDIT,0,active,2028-09-16,2024-07-07 00:04:56,469.78,transfer,977037.68
49306,9524006,95.167.0.240,219.0,ATM,20,8621,400417528,CREDIT,0,active,2028-09-16,2024-07-09 20:52:31,470.01,out,976567.67
49307,9688358,128.0.82.180,628.0,atm,10,3936,400417528,CREDIT,0,active,2028-09-16,2024-09-04 20:06:16,470.13,in_acc,977037.8
49308,9860543,195.161.0.240,1181.0,cash_out,-1,6108,400417528,CREDIT,1,active,2028-09-16,2024-10-04 08:42:05,470.14,bad,977037.8
49309,9904314,80.234.0.60,415.0,Portable term,-1,4849,400417528,CREDIT,2,active,2028-09-16,2024-10-18 18:42:45,470.19,bad,977037.8
49310,9996513,188.0.166.75,1304.0,atm,30,2704,400417528,CREDIT,0,active,2028-09-16,2024-11-14 11:48:10,470.04,transfer,976567.76
49311,9999729,95.181.0.150,259.0,port_trm,30,1523,400417528,CREDIT,0,active,2028-09-16,2024-11-19 22:07:26,469.93,transfer,976097.83
49312,1323233,81.17.0.105,1391.0,cash_out,20,3434,417914526,CREDIT,0,active,2026-04-29,2022-01-08 18:01:24,177.11,decrease_on_acc,310088.89
49313,1547409,188.162.0.0,952.0,atm,451,1343,417914526,CREDIT,0,active,2026-04-29,2022-03-09 21:51:13,177.1,payment,309911.79
49314,1833329,188.162.0.0,952.0,atm,25,6095,417914526,CREDIT,0,active,2026-04-29,2022-04-06 16:53:25,176.8,country_transfer,309734.99
49315,2066158,188.162.0.0,952.0,atm,451,3453,417914526,CREDIT,0,active,2026-04-29,2022-05-12 10:42:34,176.87,payment,309558.12
49316,2313563,188.18.0.135,233.0,port_trm,25,4689,417914526,CREDIT,0,active,2026-04-29,2022-05-22 17:42:39,177.04,country_transfer,309381.08
49317,3070387,85.140.0.105,1256.0,cash_out,20,3434,417914526,CREDIT,0,active,2026-04-29,2022-07-09 14:40:05,177.14,from_acc,309203.94
49318,3134087,188.244.0.90,1456.0,prtbl trm,451,4689,417914526,CREDIT,0,active,2026-04-29,2022-07-15 15:27:53,177.03,payment,309026.91
49319,3150117,188.162.0.0,952.0,atm,-1,4689,417914526,CREDIT,1,active,2026-04-29,2022-07-23 20:09:57,176.9,err_code,309026.91
49320,3217619,195.143.0.30,1364.0,atm,25,1576,417914526,CREDIT,0,active,2026-04-29,2022-09-03 19:12:28,176.97,country_transfer,308849.94
49321,3366101,128.0.82.0,610.0,atm,20,2962,417914526,CREDIT,0,active,2026-04-29,2022-10-07 23:59:35,176.85,out,308673.09
49322,3712401,37.0.123.105,328.0,ATM,10,4238,417914526,CREDIT,0,active,2026-04-29,2022-10-19 01:46:13,177.1,in,308850.19
49323,3912743,81.17.0.135,1393.0,pos trm,451,2279,417914526,CREDIT,0,active,2026-04-29,2022-11-04 09:13:13,177.11,payment,308673.08
49324,3999149,88.210.0.150,355.0,cash_in,10,1343,417914526,CREDIT,0,active,2026-04-29,2022-11-29 22:32:14,177.02,in_acc,308850.1
49325,4028675,80.234.0.225,427.0,cash_out,30,4238,417914526,CREDIT,0,active,2026-04-29,2023-01-04 22:58:44,176.87,transfer,308673.23
49326,4220532,188.244.0.90,1456.0,prtbl trm,25,1576,417914526,CREDIT,0,active,2026-04-29,2023-01-10 03:44:19,177.03,country_transfer,308496.2
49327,4640104,195.143.0.30,1364.0,atm,30,5980,417914526,CREDIT,0,active,2026-04-29,2023-01-17 01:13:26,177.11,transfer,308319.09
49328,4743819,188.18.0.135,233.0,port_trm,-1,3434,417914526,CREDIT,1,active,2026-04-29,2023-03-02 00:12:21,177.24,err,308319.09
49329,4746001,188.162.0.0,952.0,atm,30,9353,417914526,CREDIT,0,active,2026-04-29,2023-03-09 12:57:01,177.34,transfer,308141.75
49330,4759918,188.0.189.60,835.0,prtbl trm,25,5980,417914526,CREDIT,0,active,2026-04-29,2023-03-18 12:31:36,177.08,diff_cntry,307964.67
49331,5522865,188.0.189.60,835.0,prtbl trm,451,2279,417914526,CREDIT,0,active,2026-04-29,2023-03-31 06:11:27,177.07,payment,307787.6
49332,5581508,95.167.0.225,218.0,ATM,20,5989,417914526,CREDIT,0,active,2026-04-29,2023-04-21 01:35:17,176.97,decrease_on_acc,307610.63
49333,5697668,95.106.0.0,540.0,Portable term,451,4238,417914526,CREDIT,0,active,2026-04-29,2023-05-16 16:35:56,176.9,payment,307433.73
49334,5828613,195.143.0.30,1364.0,atm,451,4689,417914526,CREDIT,0,active,2026-04-29,2023-05-16 18:38:40,177.0,payment,307256.73
49335,5934481,95.106.0.0,540.0,Portable term,30,3434,417914526,CREDIT,0,active,2026-04-29,2023-05-24 09:15:23,177.05,transfer,307079.68
49336,6091636,81.17.0.135,1393.0,pos trm,25,1620,417914526,CREDIT,0,active,2026-04-29,2023-05-31 21:18:17,177.01,country_transfer,306902.67
49337,6243646,128.0.82.0,610.0,atm,20,2962,417914526,CREDIT,0,active,2026-04-29,2023-06-11 14:57:40,176.93,decrease_on_acc,306725.74
49338,6355261,188.0.189.60,835.0,prtbl trm,451,5980,417914526,CREDIT,0,active,2026-04-29,2023-06-30 21:24:42,176.93,payment,306548.81
49339,6373701,95.106.0.0,540.0,Portable term,25,4238,417914526,CREDIT,0,active,2026-04-29,2023-07-25 04:57:00,177.0,country_transfer,306371.81
49340,6532831,188.244.0.90,1456.0,prtbl trm,-1,4976,417914526,CREDIT,1,active,2026-04-29,2023-07-30 13:45:49,176.38,err_code,306371.81
49341,6652021,188.162.0.0,952.0,atm,-1,2962,417914526,CREDIT,2,active,2026-04-29,2023-10-20 02:38:41,177.27,bad,306371.81
49342,6688927,128.0.82.180,628.0,atm,10,5989,417914526,CREDIT,0,active,2026-04-29,2023-10-21 16:46:38,177.0,in,306548.81
49343,6895966,95.106.0.0,540.0,Portable term,30,2113,417914526,CREDIT,0,active,2026-04-29,2023-10-31 14:27:05,177.15,transfer,306371.66
49344,6931937,45.154.0.120,304.0,ATM,10,5989,417914526,CREDIT,0,active,2026-04-29,2023-11-16 19:43:43,177.1,in_acc,306548.76
49345,6945516,188.18.0.135,233.0,port_trm,451,1576,417914526,CREDIT,0,active,2026-04-29,2023-11-20 17:10:17,176.94,payment,306371.82
49346,7011376,195.143.0.30,1364.0,atm,30,9478,417914526,CREDIT,0,active,2026-04-29,2023-11-24 10:44:59,176.83,transfer,306194.99
49347,7792980,128.0.24.165,895.0,ATM,20,4768,417914526,CREDIT,0,active,2026-04-29,2024-01-11 23:52:19,176.82,out,306018.17
49348,7808162,188.244.0.90,1456.0,prtbl trm,25,1343,417914526,CREDIT,0,active,2026-04-29,2024-04-15 14:53:34,176.8,country_transfer,305841.37
49349,8306574,46.0.8.240,156.0,prtbl trm,451,9197,417914526,CREDIT,0,active,2026-04-29,2024-04-16 13:32:47,177.1,payment,305664.27
49350,8631605,188.0.189.60,835.0,prtbl trm,25,8732,417914526,CREDIT,0,active,2026-04-29,2024-04-17 02:43:35,177.11,diff_cntry,305487.16
49351,8646933,188.18.0.135,233.0,port_trm,-1,5498,417914526,CREDIT,1,active,2026-04-29,2024-05-22 04:47:52,176.86,bad,305487.16
49352,8653114,188.0.189.60,835.0,prtbl trm,451,2962,417914526,CREDIT,0,active,2026-04-29,2024-05-24 18:13:04,177.02,payment,305310.14
49353,8694649,188.18.0.135,233.0,port_trm,30,1343,417914526,CREDIT,0,active,2026-04-29,2024-05-26 02:59:59,177.18,transfer,305132.96
49354,8696257,193.31.0.180,603.0,ATM,20,2113,417914526,CREDIT,0,active,2026-04-29,2024-05-27 01:17:26,177.17,from_acc,304955.79
49355,8856506,46.0.8.240,156.0,prtbl trm,451,1343,417914526,CREDIT,0,active,2026-04-29,2024-06-25 19:38:05,177.19,payment,304778.6
49356,8884426,81.17.0.180,1399.0,ATM,10,9197,417914526,CREDIT,0,active,2026-04-29,2024-07-25 18:24:28,177.1,in_acc,304955.7
49357,8971529,95.167.0.0,200.0,ATM,20,2962,417914526,CREDIT,0,active,2026-04-29,2024-08-16 17:03:32,177.32,decrease_on_acc,304778.38
49358,8986271,185.173.0.165,1284.0,cash_out,20,5498,417914526,CREDIT,0,active,2026-04-29,2024-08-27 20:58:53,177.26,from_acc,304601.12
49359,9005670,188.18.0.105,228.0,atm,10,3453,417914526,CREDIT,0,active,2026-04-29,2024-09-12 20:14:53,176.88,in_acc,304778.0
49360,9427498,188.244.0.90,1456.0,prtbl trm,451,4976,417914526,CREDIT,0,active,2026-04-29,2024-09-26 22:04:53,176.75,payment,304601.25
49361,9521432,213.151.0.60,1000.0,ATM,10,4238,417914526,CREDIT,0,active,2026-04-29,2024-10-03 17:54:08,177.03,in,304778.28
49362,9684486,188.18.0.135,233.0,port_trm,-1,7920,417914526,CREDIT,1,active,2026-04-29,2024-10-29 21:13:54,177.06,err,304778.28
49363,9820229,80.234.0.225,427.0,cash_out,30,2962,417914526,CREDIT,0,active,2026-04-29,2024-11-08 06:10:36,176.93,transfer,304601.35
49364,1201052,213.151.0.15,997.0,pos trm,-1,5685,156921566,CREDIT,1,act,2026-07-21,2022-01-29 18:51:48,764.89,err,302332.0
49365,1368276,185.17.0.105,1053.0,cash_in,25,1075,156921566,CREDIT,0,act,2026-07-21,2022-03-07 02:50:37,765.14,country_transfer,301566.86
49366,1417399,185.17.0.105,1053.0,cash_in,451,5534,156921566,CREDIT,0,act,2026-07-21,2022-03-25 10:51:37,765.0,payment,300801.86
49367,1624523,188.244.0.210,1468.0,cash_in,-1,3535,156921566,CREDIT,1,act,2026-07-21,2022-04-13 10:08:19,765.12,err_code,300801.86
49368,1870042,188.0.189.225,850.0,cash_in,10,6901,156921566,CREDIT,0,act,2026-07-21,2022-06-10 05:10:12,765.12,add_on_acc,301566.98
49369,2109987,5.189.0.120,865.0,ATM,10,8601,156921566,CREDIT,0,act,2026-07-21,2022-06-20 05:42:11,765.09,in_acc,302332.07
49370,2360848,185.17.0.105,1053.0,cash_in,25,8970,156921566,CREDIT,0,act,2026-07-21,2022-07-01 11:01:35,764.99,diff_cntry,301567.08
49371,3026661,188.244.0.210,1468.0,cash_in,25,2595,156921566,CREDIT,0,act,2026-07-21,2022-07-11 00:08:19,765.02,diff_cntry,300802.06
49372,3246528,194.156.0.150,32.0,pos trm,30,2595,156921566,CREDIT,0,act,2026-07-21,2022-07-26 17:15:07,765.16,transfer,300036.9
49373,3263524,188.244.0.240,1470.0,port_trm,451,8750,156921566,CREDIT,0,act,2026-07-21,2022-08-02 04:12:21,764.88,payment,299272.02
49374,3309071,188.244.0.240,1470.0,port_trm,451,9876,156921566,CREDIT,0,act,2026-07-21,2022-10-07 17:53:08,764.91,payment,298507.11
49375,3332286,37.0.127.30,1023.0,cash_out,20,4385,156921566,CREDIT,0,act,2026-07-21,2022-10-11 16:47:36,764.82,from_acc,297742.29
49376,3470035,128.0.94.195,1112.0,cash_in,25,1534,156921566,CREDIT,0,act,2026-07-21,2022-10-13 07:36:36,764.76,diff_cntry,296977.53
49377,3475205,194.156.0.150,32.0,pos trm,25,6432,156921566,CREDIT,0,act,2026-07-21,2022-11-05 09:15:22,764.93,country_transfer,296212.6
49378,3624737,195.161.0.225,1180.0,cash_in,10,1534,156921566,CREDIT,0,act,2026-07-21,2022-12-07 01:05:14,764.96,in,296977.56
49379,3678826,185.17.0.105,1053.0,cash_in,30,8750,156921566,CREDIT,0,act,2026-07-21,2022-12-31 21:49:35,765.12,transfer,296212.44
49380,4266413,185.17.0.105,1053.0,cash_in,451,8601,156921566,CREDIT,0,act,2026-07-21,2023-01-01 14:31:31,764.97,payment,295447.47
49381,4287291,188.244.0.210,1468.0,cash_in,451,5685,156921566,CREDIT,0,act,2026-07-21,2023-04-05 13:05:59,765.14,payment,294682.33
49382,4399268,188.244.0.210,1468.0,cash_in,30,4385,156921566,CREDIT,0,act,2026-07-21,2023-04-24 21:13:21,765.37,transfer,293916.96
49383,4432357,194.156.0.150,32.0,pos trm,451,6432,156921566,CREDIT,0,act,2026-07-21,2023-05-28 09:43:22,765.17,payment,293151.79
49384,4806065,188.43.0.210,1421.0,ATM,20,6432,156921566,CREDIT,0,act,2026-07-21,2023-06-05 13:41:20,765.26,out,292386.53
49385,4978153,188.244.0.240,1470.0,port_trm,451,4385,156921566,CREDIT,0,act,2026-07-21,2023-06-09 16:42:25,764.96,payment,291621.57
49386,5004057,185.17.0.105,1053.0,cash_in,451,2595,156921566,CREDIT,0,act,2026-07-21,2023-06-26 12:11:56,764.92,payment,290856.65
49387,5226244,46.0.2.180,194.0,cash_in,10,3535,156921566,CREDIT,0,act,2026-07-21,2023-08-28 16:09:41,764.79,in,291621.44
49388,5353937,194.87.0.225,584.0,atm,10,6095,156921566,CREDIT,0,act,2026-07-21,2023-09-06 21:16:12,764.91,add_on_acc,292386.35
49389,5447338,46.173.0.165,509.0,ATM,20,6095,156921566,CREDIT,0,act,2026-07-21,2023-09-27 06:00:44,765.05,from_acc,291621.3
49390,5511948,128.0.94.195,1112.0,cash_in,451,6432,156921566,CREDIT,0,act,2026-07-21,2023-10-02 02:10:28,765.42,payment,290855.88
49391,5808472,185.17.0.105,1053.0,cash_in,451,6432,156921566,CREDIT,0,act,2026-07-21,2023-10-12 15:13:51,764.89,payment,290090.99
49392,5859246,46.0.188.135,1238.0,atm,10,6951,156921566,CREDIT,0,act,2026-07-21,2023-11-18 10:36:00,765.02,in,290856.01
49393,6068096,194.156.0.150,32.0,pos trm,451,6095,156921566,CREDIT,0,act,2026-07-21,2023-12-13 02:55:29,765.19,payment,290090.82
49394,6104548,213.151.0.15,997.0,pos trm,25,4385,156921566,CREDIT,0,act,2026-07-21,2023-12-27 16:33:57,765.09,country_transfer,289325.73
49395,6178574,185.17.0.105,1053.0,cash_in,-1,6901,156921566,CREDIT,1,act,2026-07-21,2024-01-27 07:18:16,765.04,err_code,289325.73
49396,6317533,213.151.0.15,997.0,pos trm,451,1075,156921566,CREDIT,0,act,2026-07-21,2024-02-28 14:15:56,764.97,payment,288560.76
49397,6504527,185.17.0.105,1053.0,cash_in,451,6901,156921566,CREDIT,0,act,2026-07-21,2024-03-18 18:22:51,765.12,payment,287795.64
49398,6560550,185.17.0.105,1053.0,cash_in,451,5685,156921566,CREDIT,0,act,2026-07-21,2024-04-17 23:55:41,764.94,payment,287030.7
49399,6592956,128.0.94.195,1112.0,cash_in,-1,6951,156921566,CREDIT,1,act,2026-07-21,2024-04-25 00:43:05,765.27,err_code,287030.7
49400,6755952,77.242.0.60,275.0,atm,10,6095,156921566,CREDIT,0,act,2026-07-21,2024-05-01 15:22:04,764.98,in_acc,287795.68
49401,6848185,194.156.0.150,32.0,pos trm,25,4385,156921566,CREDIT,0,act,2026-07-21,2024-05-07 21:17:00,765.18,country_transfer,287030.5
49402,7249870,128.0.94.195,1112.0,cash_in,451,1075,156921566,CREDIT,0,act,2026-07-21,2024-05-14 17:37:28,765.1,payment,286265.4
49403,7275627,213.151.0.15,997.0,pos trm,-1,6095,156921566,CREDIT,1,act,2026-07-21,2024-05-19 20:08:55,764.84,err,286265.4
49404,7307276,37.0.124.120,729.0,atm,20,9876,156921566,CREDIT,0,act,2026-07-21,2024-05-26 11:42:17,764.97,decrease_on_acc,285500.43
49405,7455044,188.191.0.210,1156.0,cash_in,10,4385,156921566,CREDIT,0,act,2026-07-21,2024-06-04 18:53:32,764.88,in,286265.31
49406,7643155,95.106.0.180,560.0,cash_out,20,6432,156921566,CREDIT,0,act,2026-07-21,2024-06-13 14:32:53,765.16,out,285500.15
49407,7922558,185.17.0.105,1053.0,cash_in,451,8970,156921566,CREDIT,0,act,2026-07-21,2024-06-18 18:38:35,765.15,payment,284735.0
49408,8383703,185.17.0.105,1053.0,cash_in,25,6951,156921566,CREDIT,0,act,2026-07-21,2024-07-11 03:20:23,765.19,country_transfer,283969.81
49409,8617622,185.17.0.105,1053.0,cash_in,25,8601,156921566,CREDIT,0,act,2026-07-21,2024-08-01 16:34:41,764.89,country_transfer,283204.92
49410,8723217,194.156.0.150,32.0,pos trm,30,5534,156921566,CREDIT,0,act,2026-07-21,2024-08-03 13:29:37,765.13,transfer,282439.79
49411,9038597,188.244.0.240,1470.0,port_trm,25,6432,156921566,CREDIT,0,act,2026-07-21,2024-09-02 17:05:41,764.77,diff_cntry,281675.02
49412,9185331,128.0.94.195,1112.0,cash_in,30,4385,156921566,CREDIT,0,act,2026-07-21,2024-10-07 03:19:44,764.84,transfer,280910.18
49413,9225712,185.17.0.105,1053.0,cash_in,25,8601,156921566,CREDIT,0,act,2026-07-21,2024-10-16 09:00:49,764.83,country_transfer,280145.35
49414,9549766,5.189.0.165,869.0,cash_out,20,8970,156921566,CREDIT,0,act,2026-07-21,2024-11-11 22:04:26,764.8,from_acc,279380.55
49415,9592768,194.156.0.150,32.0,pos trm,451,6095,156921566,CREDIT,0,act,2026-07-21,2024-11-21 11:19:50,765.14,payment,278615.41
49416,1067841,46.0.54.0,1068.0,cash_out,20,7977,854575575,CREDIT,0,active,2028-03-11,2022-01-24 02:57:11,703.1,out,486717.9
49417,1311515,91.107.0.150,988.0,pos trm,451,4037,854575575,CREDIT,0,active,2028-03-11,2022-03-04 13:06:47,703.07,payment,486014.83
49418,1516120,195.58.0.60,1429.0,ATM,25,7419,854575575,CREDIT,0,active,2028-03-11,2022-12-14 18:02:39,703.01,diff_cntry,485311.82
49419,1523521,91.107.0.150,988.0,pos trm,451,6231,854575575,CREDIT,0,active,2028-03-11,2023-02-14 12:57:26,703.0,payment,484608.82
49420,1586533,91.107.0.150,988.0,pos trm,451,7697,854575575,CREDIT,0,active,2028-03-11,2023-07-12 01:04:26,702.97,payment,483905.85
49421,2330425,46.0.176.135,127.0,cash_in,25,7419,854575575,CREDIT,0,active,2028-03-11,2023-07-29 13:13:49,703.06,country_transfer,483202.79
49422,2563385,46.0.176.135,127.0,cash_in,451,7120,854575575,CREDIT,0,active,2028-03-11,2024-01-11 06:12:33,703.03,payment,482499.76
49423,2664477,217.112.0.240,1495.0,pos trm,-1,5168,854575575,CREDIT,1,active,2028-03-11,2024-02-11 12:17:06,702.93,bad,482499.76
49424,2807671,109.126.0.75,370.0,prtbl trm,451,7120,854575575,CREDIT,0,active,2028-03-11,2024-06-24 03:05:29,703.29,payment,481796.47
49425,2899872,46.0.176.135,127.0,cash_in,-1,3576,854575575,CREDIT,1,active,2028-03-11,2024-07-30 05:12:25,703.07,err,481796.47
49426,2929876,217.112.0.240,1495.0,pos trm,-1,3222,854575575,CREDIT,2,active,2028-03-11,2024-09-03 18:07:29,702.99,bad,481796.47
49427,2959930,217.112.0.240,1495.0,pos trm,-1,5168,854575575,CREDIT,3,blk,2028-03-11,2024-11-27 10:34:47,702.84,err,0.0
49428,1022625,128.0.24.90,889.0,ATM,451,4816,683184176,DEBIT,0,act,2028-12-31,2022-03-22 18:13:07,1147.08,payment,962892.92
49429,1532921,77.242.0.15,269.0,atm,20,4226,683184176,DEBIT,0,act,2028-12-31,2022-06-19 20:45:13,1146.71,out,961746.21
49430,1659115,195.58.0.165,1439.0,Portable term,-1,7959,683184176,DEBIT,1,act,2028-12-31,2022-07-23 18:53:04,1147.21,err_code,961746.21
49431,1756935,194.87.0.165,577.0,atm,10,3211,683184176,DEBIT,0,act,2028-12-31,2022-09-16 07:39:56,1147.15,in,962893.36
49432,1804452,188.0.0.210,1220.0,pos trm,451,4252,683184176,DEBIT,0,act,2028-12-31,2023-01-09 08:57:41,1146.91,payment,961746.45
49433,1860866,80.234.0.210,425.0,prtbl trm,25,5718,683184176,DEBIT,0,act,2028-12-31,2023-02-14 13:12:52,1147.26,diff_cntry,960599.19
49434,1861434,193.0.151.195,71.0,cash_in,451,4224,683184176,DEBIT,0,act,2028-12-31,2023-02-26 20:53:58,1147.04,payment,959452.15
49435,1885398,193.0.151.195,71.0,cash_in,-1,5185,683184176,DEBIT,1,act,2028-12-31,2023-06-14 02:11:00,1146.83,err_code,959452.15
49436,2043097,46.0.2.90,187.0,prtbl trm,30,4226,683184176,DEBIT,0,act,2028-12-31,2023-06-21 19:51:49,1147.03,transfer,958305.12
49437,2512439,151.0.38.120,398.0,ATM,20,8953,683184176,DEBIT,0,act,2028-12-31,2023-11-30 06:42:59,1146.75,from_acc,957158.37
49438,2549072,188.128.16.211,1201.0,ATM,10,6622,683184176,DEBIT,0,act,2028-12-31,2024-01-04 16:02:23,1147.04,add_on_acc,958305.41
49439,2790858,80.234.0.210,425.0,prtbl trm,-1,9019,683184176,DEBIT,1,act,2028-12-31,2024-02-22 04:11:16,1147.14,bad,958305.41
49440,2800373,188.0.0.210,1220.0,pos trm,451,8953,683184176,DEBIT,0,act,2028-12-31,2024-03-13 14:02:17,1146.89,payment,957158.52
49441,3023761,128.0.82.15,611.0,ATM,10,4438,683184176,DEBIT,0,act,2028-12-31,2024-04-06 00:43:29,1147.06,add_on_acc,958305.58
49442,3198193,217.112.0.0,1471.0,ATM,20,6501,683184176,DEBIT,0,act,2028-12-31,2024-05-10 19:24:12,1146.77,decrease_on_acc,957158.81
49443,3505169,195.58.0.165,1439.0,Portable term,25,6622,683184176,DEBIT,0,act,2028-12-31,2024-05-18 02:47:05,1146.84,country_transfer,956011.97
49444,3693123,80.234.0.210,425.0,prtbl trm,25,5709,683184176,DEBIT,0,act,2028-12-31,2024-06-02 02:59:07,1146.83,country_transfer,954865.14
49445,3929017,195.58.0.165,1439.0,Portable term,-1,4252,683184176,DEBIT,1,act,2028-12-31,2024-06-03 17:29:48,1147.01,err,954865.14
49446,3972237,193.0.151.195,71.0,cash_in,-1,3678,683184176,DEBIT,2,act,2028-12-31,2024-07-26 05:15:32,1147.13,err,954865.14
49447,4035345,195.58.0.165,1439.0,Portable term,-1,6501,683184176,DEBIT,3,blocked,2028-12-31,2024-10-26 00:52:53,1146.88,err,954865.14
49448,1017264,46.0.128.60,703.0,ATM,30,7825,320794190,DEBIT,0,act,2027-05-16,2022-01-08 05:10:55,1184.0,transfer,336891.0
49449,1100173,46.0.176.75,123.0,atm,10,9674,320794190,DEBIT,0,act,2027-05-16,2022-05-14 23:49:45,1183.89,add_on_acc,338074.89
49450,1534098,46.0.143.120,820.0,cash_in,10,4267,320794190,DEBIT,0,act,2027-05-16,2022-06-29 04:33:36,1183.92,in,339258.81
49451,1607520,46.0.2.150,192.0,cash_out,30,9328,320794190,DEBIT,0,act,2027-05-16,2022-07-10 10:46:54,1184.1,transfer,338074.71
49452,1638915,128.0.82.180,628.0,atm,451,4859,320794190,DEBIT,0,act,2027-05-16,2022-07-12 06:28:02,1183.95,payment,336890.76
49453,1657500,81.17.0.15,1385.0,Portable term,30,4859,320794190,DEBIT,0,act,2027-05-16,2022-07-18 04:55:37,1184.07,transfer,335706.69
49454,2128067,128.0.82.180,628.0,atm,451,5899,320794190,DEBIT,0,act,2027-05-16,2022-08-09 18:53:14,1183.99,payment,334522.7
49455,2433436,109.126.0.150,376.0,atm,20,4746,320794190,DEBIT,0,act,2027-05-16,2022-08-18 08:51:39,1184.04,out,333338.66
49456,2467252,46.0.128.60,703.0,ATM,25,5324,320794190,DEBIT,0,act,2027-05-16,2022-08-20 01:18:43,1183.69,diff_cntry,332154.97
49457,2652812,46.0.128.60,703.0,ATM,25,4859,320794190,DEBIT,0,act,2027-05-16,2022-09-18 07:45:16,1184.22,country_transfer,330970.75
49458,2891367,46.0.2.150,192.0,cash_out,25,9328,320794190,DEBIT,0,act,2027-05-16,2022-10-01 14:59:48,1183.96,country_transfer,329786.79
49459,3062467,95.106.0.150,557.0,cash_in,30,2924,320794190,DEBIT,0,act,2027-05-16,2022-10-28 01:48:02,1184.33,transfer,328602.46
49460,3764474,95.106.0.150,557.0,cash_in,30,4859,320794190,DEBIT,0,act,2027-05-16,2022-11-02 00:12:14,1184.06,transfer,327418.4
49461,3842489,95.106.0.150,557.0,cash_in,451,5306,320794190,DEBIT,0,act,2027-05-16,2022-11-04 02:18:16,1184.01,payment,326234.39
49462,3912445,46.0.2.150,192.0,cash_out,30,9991,320794190,DEBIT,0,act,2027-05-16,2022-11-21 15:34:18,1183.86,transfer,325050.53
49463,4045982,128.0.82.180,628.0,atm,-1,3571,320794190,DEBIT,1,act,2027-05-16,2022-12-03 00:25:30,1184.29,err,325050.53
49464,4576195,46.8.0.45,767.0,atm,10,5306,320794190,DEBIT,0,act,2027-05-16,2022-12-07 15:40:54,1183.7,in_acc,326234.23
49465,4795500,188.244.0.195,1467.0,atm,10,4267,320794190,DEBIT,0,act,2027-05-16,2023-01-19 00:38:12,1183.95,in_acc,327418.18
49466,4980745,95.106.0.150,557.0,cash_in,451,6848,320794190,DEBIT,0,act,2027-05-16,2023-01-24 12:34:22,1184.14,payment,326234.04
49467,5105497,85.140.0.0,1246.0,atm,10,9674,320794190,DEBIT,0,act,2027-05-16,2023-03-13 11:47:34,1184.24,in,327418.28
49468,5130459,81.17.0.15,1385.0,Portable term,30,9328,320794190,DEBIT,0,act,2027-05-16,2023-04-11 13:54:12,1184.0,transfer,326234.28
49469,5154114,128.0.82.180,628.0,atm,25,9300,320794190,DEBIT,0,act,2027-05-16,2023-04-24 09:57:31,1183.99,country_transfer,325050.29
49470,5192016,46.0.128.60,703.0,ATM,451,8305,320794190,DEBIT,0,act,2027-05-16,2023-05-11 14:18:41,1184.14,payment,323866.15
49471,5426771,128.0.82.180,628.0,atm,30,2810,320794190,DEBIT,0,act,2027-05-16,2023-05-19 00:53:54,1184.09,transfer,322682.06
49472,5498871,81.17.0.15,1385.0,Portable term,451,8305,320794190,DEBIT,0,act,2027-05-16,2023-06-05 15:29:22,1184.09,payment,321497.97
49473,5641677,95.106.0.150,557.0,cash_in,451,8911,320794190,DEBIT,0,act,2027-05-16,2023-06-09 02:26:00,1183.95,payment,320314.02
49474,5742466,128.0.82.180,628.0,atm,451,6621,320794190,DEBIT,0,act,2027-05-16,2023-06-23 07:37:52,1184.28,payment,319129.74
49475,5889640,194.156.0.165,34.0,cash_in,10,9991,320794190,DEBIT,0,act,2027-05-16,2023-07-25 16:06:01,1184.03,in,320313.77
49476,6075683,95.106.0.150,557.0,cash_in,25,9674,320794190,DEBIT,0,act,2027-05-16,2023-09-23 00:39:04,1183.99,diff_cntry,319129.78
49477,6647266,46.0.128.60,703.0,ATM,-1,2491,320794190,DEBIT,1,act,2027-05-16,2023-09-24 12:12:37,1183.89,err_code,319129.78
49478,6806446,81.17.0.15,1385.0,Portable term,-1,1904,320794190,DEBIT,2,act,2027-05-16,2023-10-03 17:25:31,1184.13,err_code,319129.78
49479,6894793,46.0.128.60,703.0,ATM,451,2810,320794190,DEBIT,0,act,2027-05-16,2023-10-15 09:03:42,1183.88,payment,317945.9
49480,6914852,128.0.82.180,628.0,atm,30,6848,320794190,DEBIT,0,act,2027-05-16,2023-10-26 12:37:30,1184.01,transfer,316761.89
49481,6917674,46.0.2.150,192.0,cash_out,-1,5306,320794190,DEBIT,1,act,2027-05-16,2023-10-31 07:48:35,1183.75,err,316761.89
49482,6991775,46.0.9.75,1322.0,cash_out,20,7599,320794190,DEBIT,0,act,2027-05-16,2023-11-02 08:15:27,1184.26,out,315577.63
49483,7030133,188.244.0.45,1451.0,cash_in,10,8426,320794190,DEBIT,0,act,2027-05-16,2023-11-03 11:30:15,1183.88,in,316761.51
49484,7182551,81.17.0.15,1385.0,Portable term,-1,8426,320794190,DEBIT,1,act,2027-05-16,2023-11-24 19:34:26,1183.87,err_code,316761.51
49485,7215579,46.0.128.60,703.0,ATM,-1,7825,320794190,DEBIT,2,act,2027-05-16,2023-12-04 09:16:34,1183.8,err_code,316761.51
49486,7308685,128.0.82.180,628.0,atm,451,5324,320794190,DEBIT,0,act,2027-05-16,2024-01-18 08:46:22,1184.09,payment,315577.42
49487,7395162,128.0.82.180,628.0,atm,451,5899,320794190,DEBIT,0,act,2027-05-16,2024-02-03 17:06:54,1183.9,payment,314393.52
49488,7506378,95.106.0.150,557.0,cash_in,25,6848,320794190,DEBIT,0,act,2027-05-16,2024-03-01 18:54:19,1184.16,country_transfer,313209.36
49489,7598873,81.17.0.15,1385.0,Portable term,30,8292,320794190,DEBIT,0,act,2027-05-16,2024-03-05 20:17:26,1183.82,transfer,312025.54
49490,7698409,128.0.82.180,628.0,atm,451,3788,320794190,DEBIT,0,act,2027-05-16,2024-03-11 09:08:52,1184.0,payment,310841.54
49491,7886841,46.0.128.60,703.0,ATM,-1,4267,320794190,DEBIT,1,act,2027-05-16,2024-03-12 08:45:15,1183.91,bad,310841.54
49492,7931335,46.0.2.150,192.0,cash_out,451,6659,320794190,DEBIT,0,act,2027-05-16,2024-03-17 18:57:14,1184.08,payment,309657.46
49493,8067021,46.8.0.105,774.0,cash_out,20,8292,320794190,DEBIT,0,act,2027-05-16,2024-03-27 14:39:04,1183.64,from_acc,308473.82
49494,8195069,81.17.0.15,1385.0,Portable term,451,7028,320794190,DEBIT,0,act,2027-05-16,2024-04-03 10:35:27,1183.96,payment,307289.86
49495,8503952,46.0.128.60,703.0,ATM,451,9328,320794190,DEBIT,0,act,2027-05-16,2024-04-07 04:53:02,1183.76,payment,306106.1
49496,8583726,188.0.166.60,1303.0,atm,10,7517,320794190,DEBIT,0,act,2027-05-16,2024-04-10 23:53:26,1183.91,in_acc,307290.01
49497,8662622,95.106.0.150,557.0,cash_in,30,9991,320794190,DEBIT,0,act,2027-05-16,2024-04-21 06:50:30,1183.97,transfer,306106.04
49498,8688495,128.0.82.180,628.0,atm,-1,1904,320794190,DEBIT,1,act,2027-05-16,2024-05-03 19:07:57,1184.17,err,306106.04
49499,8991457,95.106.0.90,550.0,atm,10,4859,320794190,DEBIT,0,act,2027-05-16,2024-05-11 02:04:48,1184.08,add_on_acc,307290.12
49500,9053458,95.106.0.150,557.0,cash_in,25,7599,320794190,DEBIT,0,act,2027-05-16,2024-05-13 08:46:32,1184.02,country_transfer,306106.1
49501,9369509,46.0.128.180,713.0,ATM,10,8305,320794190,DEBIT,0,act,2027-05-16,2024-05-30 18:54:36,1183.64,in,307289.74
49502,9401138,46.0.2.150,192.0,cash_out,30,4170,320794190,DEBIT,0,act,2027-05-16,2024-06-05 12:49:26,1184.28,transfer,306105.46
49503,9586293,128.0.82.180,628.0,atm,451,3788,320794190,DEBIT,0,act,2027-05-16,2024-09-09 04:10:38,1183.96,payment,304921.5
49504,9591069,81.17.0.15,1385.0,Portable term,30,4170,320794190,DEBIT,0,act,2027-05-16,2024-09-12 02:51:47,1183.98,transfer,303737.52
49505,9745023,95.106.0.150,557.0,cash_in,451,5306,320794190,DEBIT,0,act,2027-05-16,2024-09-15 01:34:59,1184.09,payment,302553.43
49506,1113704,185.17.0.60,1047.0,pos trm,-1,4959,441416548,DEBIT,1,act,2025-01-03,2022-01-15 13:37:48,486.87,err,420029.0
49507,1316703,46.173.0.45,496.0,cash_in,30,4959,441416548,DEBIT,0,act,2025-01-03,2022-01-21 01:16:19,486.91,transfer,419542.09
49508,1482043,62.118.0.90,528.0,pos trm,25,6471,441416548,DEBIT,0,act,2025-01-03,2022-02-03 04:08:46,486.92,diff_cntry,419055.17
49509,1510837,195.143.0.30,1364.0,atm,10,6013,441416548,DEBIT,0,act,2025-01-03,2022-03-15 07:06:32,487.06,in_acc,419542.23
49510,1707489,185.17.0.60,1047.0,pos trm,451,7853,441416548,DEBIT,0,act,2025-01-03,2022-03-17 02:35:18,487.01,payment,419055.22
49511,2504723,195.143.0.60,1366.0,port_trm,-1,8965,441416548,DEBIT,1,act,2025-01-03,2022-05-13 09:00:30,486.63,bad,419055.22
49512,2693147,194.84.192.237,47.0,cash_in,10,2260,441416548,DEBIT,0,act,2025-01-03,2022-05-24 08:09:48,487.01,in,419542.23
49513,2712634,46.0.123.225,929.0,ATM,10,8899,441416548,DEBIT,0,act,2025-01-03,2022-05-25 19:41:17,487.07,add_on_acc,420029.3
49514,2728337,91.107.0.180,990.0,atm,20,4557,441416548,DEBIT,0,act,2025-01-03,2022-06-18 13:02:31,487.08,from_acc,419542.22
49515,2794984,62.118.0.90,528.0,pos trm,-1,3176,441416548,DEBIT,1,act,2025-01-03,2022-06-23 05:50:20,487.06,err,419542.22
49516,3057598,46.173.0.45,496.0,cash_in,451,2514,441416548,DEBIT,0,act,2025-01-03,2022-07-12 16:07:21,486.89,payment,419055.33
49517,3185055,185.17.0.60,1047.0,pos trm,30,2260,441416548,DEBIT,0,act,2025-01-03,2022-08-16 01:39:39,486.86,transfer,418568.47
49518,3198178,62.118.0.90,528.0,pos trm,451,4705,441416548,DEBIT,0,act,2025-01-03,2022-08-25 00:53:41,487.1,payment,418081.37
49519,3265081,62.118.0.90,528.0,pos trm,25,9365,441416548,DEBIT,0,act,2025-01-03,2022-08-25 14:53:06,486.87,diff_cntry,417594.5
49520,3290191,46.0.9.15,1318.0,ATM,10,3912,441416548,DEBIT,0,act,2025-01-03,2022-08-26 23:30:19,487.08,in,418081.58
49521,3326147,193.0.151.180,68.0,atm,10,3176,441416548,DEBIT,0,act,2025-01-03,2022-09-11 22:16:03,486.84,in,418568.42
49522,3662791,62.118.0.45,523.0,cash_out,20,4392,441416548,DEBIT,0,act,2025-01-03,2022-09-29 19:18:04,487.02,from_acc,418081.4
49523,3845586,188.18.0.30,223.0,cash_out,20,3176,441416548,DEBIT,0,act,2025-01-03,2022-10-18 07:12:43,487.08,out,417594.32
49524,3876416,62.118.0.90,528.0,pos trm,30,6013,441416548,DEBIT,0,act,2025-01-03,2022-10-22 06:17:25,486.91,transfer,417107.41
49525,3897307,151.0.38.135,399.0,cash_out,20,4705,441416548,DEBIT,0,act,2025-01-03,2022-11-27 22:52:44,486.74,from_acc,416620.67
49526,4067835,46.0.54.150,1086.0,ATM,20,6013,441416548,DEBIT,0,act,2025-01-03,2022-12-25 19:58:53,487.08,out,416133.59
49527,4221327,195.143.0.60,1366.0,port_trm,30,9149,441416548,DEBIT,0,act,2025-01-03,2023-02-15 17:48:47,487.15,transfer,415646.44
49528,4263198,62.118.0.90,528.0,pos trm,451,9592,441416548,DEBIT,0,act,2025-01-03,2023-03-13 16:21:53,487.0,payment,415159.44
49529,4436491,188.0.189.135,842.0,cash_out,25,7853,441416548,DEBIT,0,act,2025-01-03,2023-05-22 02:00:41,486.86,country_transfer,414672.58
49530,4614508,188.0.166.60,1303.0,atm,20,3912,441416548,DEBIT,0,act,2025-01-03,2023-05-24 17:17:37,487.19,from_acc,414185.39
49531,5050336,62.118.0.90,528.0,pos trm,451,3912,441416548,DEBIT,0,act,2025-01-03,2023-06-23 12:44:06,487.02,payment,413698.37
49532,5401931,185.17.0.60,1047.0,pos trm,30,4557,441416548,DEBIT,0,act,2025-01-03,2023-07-17 09:55:27,487.13,transfer,413211.24
49533,5464723,195.143.0.60,1366.0,port_trm,-1,9592,441416548,DEBIT,1,act,2025-01-03,2023-07-19 13:12:07,487.2,err_code,413211.24
49534,5547913,151.0.38.90,394.0,ATM,10,4392,441416548,DEBIT,0,act,2025-01-03,2023-07-25 02:17:08,487.24,in_acc,413698.48
49535,6115682,188.0.189.135,842.0,cash_out,451,1186,441416548,DEBIT,0,act,2025-01-03,2023-07-26 06:21:59,486.92,payment,413211.56
49536,6274094,46.173.0.45,496.0,cash_in,451,9149,441416548,DEBIT,0,act,2025-01-03,2023-08-09 02:13:23,487.11,payment,412724.45
49537,6346603,195.143.0.60,1366.0,port_trm,451,6471,441416548,DEBIT,0,act,2025-01-03,2023-08-22 06:24:56,486.71,payment,412237.74
49538,6400027,95.106.0.105,551.0,atm,20,1186,441416548,DEBIT,0,act,2025-01-03,2023-08-22 19:33:53,487.11,decrease_on_acc,411750.63
49539,6747663,185.17.0.60,1047.0,pos trm,25,6013,441416548,DEBIT,0,act,2025-01-03,2023-09-11 00:53:10,486.85,country_transfer,411263.78
49540,6843851,46.0.123.90,917.0,atm,20,6013,441416548,DEBIT,0,act,2025-01-03,2023-10-03 07:58:53,487.04,decrease_on_acc,410776.74
49541,7160369,62.118.0.90,528.0,pos trm,451,8965,441416548,DEBIT,0,act,2025-01-03,2023-10-08 15:55:03,487.07,payment,410289.67
49542,7163849,188.0.189.135,842.0,cash_out,30,3176,441416548,DEBIT,0,act,2025-01-03,2023-10-10 07:48:53,487.0,transfer,409802.67
49543,7278029,195.143.0.60,1366.0,port_trm,451,9592,441416548,DEBIT,0,act,2025-01-03,2023-11-03 16:18:39,486.92,payment,409315.75
49544,7518256,62.118.0.90,528.0,pos trm,25,4959,441416548,DEBIT,0,act,2025-01-03,2023-11-24 09:54:02,486.99,country_transfer,408828.76
49545,7575440,46.0.8.105,145.0,atm,20,2514,441416548,DEBIT,0,act,2025-01-03,2023-11-26 20:06:07,486.84,out,408341.92
49546,7739994,195.143.0.60,1366.0,port_trm,25,3176,441416548,DEBIT,0,act,2025-01-03,2023-12-14 01:31:46,487.12,country_transfer,407854.8
49547,7811213,86.111.0.150,1354.0,ATM,10,6471,441416548,DEBIT,0,act,2025-01-03,2023-12-28 02:21:46,486.85,in,408341.65
49548,7811444,195.143.0.60,1366.0,port_trm,30,4255,441416548,DEBIT,0,act,2025-01-03,2024-01-08 09:16:40,486.74,transfer,407854.91
49549,7852236,193.31.0.60,591.0,atm,20,8899,441416548,DEBIT,0,act,2025-01-03,2024-01-23 11:13:06,486.96,decrease_on_acc,407367.95
49550,7924445,62.118.0.90,528.0,pos trm,25,8648,441416548,DEBIT,0,act,2025-01-03,2024-02-10 10:34:56,487.3,diff_cntry,406880.65
49551,8145651,194.0.144.90,167.0,cash_out,20,5951,441416548,DEBIT,0,act,2025-01-03,2024-03-24 12:38:12,486.98,from_acc,406393.67
49552,8171989,188.0.189.135,842.0,cash_out,30,2260,441416548,DEBIT,0,act,2025-01-03,2024-04-16 10:50:06,486.93,transfer,405906.74
49553,8220113,85.140.0.150,1262.0,atm,20,4959,441416548,DEBIT,0,act,2025-01-03,2024-04-19 08:09:41,486.86,from_acc,405419.88
49554,8283230,46.0.0.150,665.0,cash_out,20,4959,441416548,DEBIT,0,act,2025-01-03,2024-05-21 01:21:45,486.96,out,404932.92
49555,8326616,62.118.0.90,528.0,pos trm,451,4392,441416548,DEBIT,0,act,2025-01-03,2024-06-11 17:33:00,487.01,payment,404445.91
49556,8419277,188.162.0.75,958.0,cash_out,20,2260,441416548,DEBIT,0,act,2025-01-03,2024-06-23 20:09:08,487.03,out,403958.88
49557,8628119,46.173.0.45,496.0,cash_in,25,4392,441416548,DEBIT,0,act,2025-01-03,2024-07-22 04:37:13,486.92,country_transfer,403471.96
49558,8731337,188.0.189.135,842.0,cash_out,25,7853,441416548,DEBIT,0,act,2025-01-03,2024-07-25 13:31:12,487.05,diff_cntry,402984.91
49559,9110036,195.143.0.60,1366.0,port_trm,30,4255,441416548,DEBIT,0,act,2025-01-03,2024-07-31 18:56:29,487.23,transfer,402497.68
49560,9220641,188.0.189.135,842.0,cash_out,451,3912,441416548,DEBIT,0,act,2025-01-03,2024-08-17 01:48:32,486.85,payment,402010.83
49561,9550185,195.143.0.60,1366.0,port_trm,-1,4255,441416548,DEBIT,1,act,2025-01-03,2024-08-25 21:57:34,486.94,bad,402010.83
49562,9677789,185.17.0.60,1047.0,pos trm,451,9149,441416548,DEBIT,0,act,2025-01-03,2024-09-03 21:13:25,487.16,payment,401523.67
49563,9690474,37.0.124.210,735.0,cash_in,10,2514,441416548,DEBIT,0,act,2025-01-03,2024-11-18 10:48:09,486.87,add_on_acc,402010.54
49564,1092643,46.0.54.0,1068.0,cash_out,20,3423,180567478,CREDIT,0,active,2029-05-29,2022-01-01 23:11:50,325.75,out,530722.25
49565,1199563,185.233.0.135,86.0,port_trm,25,2926,180567478,CREDIT,0,active,2029-05-29,2022-03-16 04:11:39,325.82,country_transfer,530396.43
49566,1573829,128.0.82.45,613.0,Portable term,-1,1736,180567478,CREDIT,1,active,2029-05-29,2022-03-17 07:31:33,326.03,err_code,530396.43
49567,1640795,128.0.82.45,613.0,Portable term,30,2714,180567478,CREDIT,0,active,2029-05-29,2022-04-02 23:31:24,325.93,transfer,530070.5
49568,1709084,128.0.82.45,613.0,Portable term,-1,1831,180567478,CREDIT,1,active,2029-05-29,2022-04-27 21:32:07,325.91,err,530070.5
49569,1798678,128.0.24.90,889.0,ATM,451,4405,180567478,CREDIT,0,active,2029-05-29,2022-04-29 06:52:56,326.18,payment,529744.32
49570,1813327,194.0.144.210,177.0,port_trm,451,6471,180567478,CREDIT,0,active,2029-05-29,2022-05-26 01:56:13,325.95,payment,529418.37
49571,2016521,78.24.158.189,947.0,cash_out,-1,2130,180567478,CREDIT,1,active,2029-05-29,2022-06-21 23:11:57,326.1,err_code,529418.37
49572,2112814,79.104.60.240,444.0,cash_out,20,4405,180567478,CREDIT,0,active,2029-05-29,2022-07-11 22:54:22,326.27,decrease_on_acc,529092.1
49573,2603829,194.0.144.210,177.0,port_trm,451,9040,180567478,CREDIT,0,active,2029-05-29,2022-07-19 03:52:48,325.96,payment,528766.14
49574,2652971,194.0.144.210,177.0,port_trm,-1,6715,180567478,CREDIT,1,active,2029-05-29,2022-07-30 14:06:48,326.27,err,528766.14
49575,2821426,195.58.0.45,1428.0,cash_in,451,9853,180567478,CREDIT,0,active,2029-05-29,2022-11-04 04:34:03,326.13,payment,528440.01
49576,3317623,46.0.2.240,199.0,ATM,-1,6715,180567478,CREDIT,1,active,2029-05-29,2022-12-07 11:50:29,326.04,err,528440.01
49577,3410384,46.0.9.60,1321.0,ATM,10,4052,180567478,CREDIT,0,active,2029-05-29,2022-12-07 14:26:31,325.79,in_acc,528765.8
49578,3941024,46.0.2.240,199.0,ATM,30,9853,180567478,CREDIT,0,active,2029-05-29,2022-12-08 02:00:41,325.91,transfer,528439.89
49579,3957157,194.0.144.210,177.0,port_trm,25,2857,180567478,CREDIT,0,active,2029-05-29,2023-02-11 04:31:06,326.06,diff_cntry,528113.83
49580,4208613,217.112.0.150,1483.0,ATM,20,7981,180567478,CREDIT,0,active,2029-05-29,2023-02-24 16:14:07,326.07,from_acc,527787.76
49581,4482767,193.31.0.195,605.0,atm,10,4275,180567478,CREDIT,0,active,2029-05-29,2023-02-28 16:40:50,326.07,in_acc,528113.83
49582,4658021,188.43.0.195,1419.0,cash_in,10,2857,180567478,CREDIT,0,active,2029-05-29,2023-03-22 00:43:59,325.94,in,528439.77
49583,4805161,46.0.188.75,1233.0,ATM,20,1696,180567478,CREDIT,0,active,2029-05-29,2023-03-24 06:49:09,326.06,decrease_on_acc,528113.71
49584,4980778,194.0.144.210,177.0,port_trm,451,4700,180567478,CREDIT,0,active,2029-05-29,2023-04-08 20:56:05,325.95,payment,527787.76
49585,5273000,78.24.158.189,947.0,cash_out,-1,8249,180567478,CREDIT,1,active,2029-05-29,2023-04-14 02:51:37,325.94,bad,527787.76
49586,5463321,128.0.82.45,613.0,Portable term,25,3693,180567478,CREDIT,0,active,2029-05-29,2023-06-06 11:42:40,325.94,diff_cntry,527461.82
49587,5694651,194.0.144.210,177.0,port_trm,451,1736,180567478,CREDIT,0,active,2029-05-29,2023-06-27 20:18:16,325.99,payment,527135.83
49588,5710857,195.58.0.45,1428.0,cash_in,-1,4405,180567478,CREDIT,1,active,2029-05-29,2023-07-02 16:30:10,326.14,bad,527135.83
49589,5891563,185.17.0.195,1064.0,ATM,20,7981,180567478,CREDIT,0,active,2029-05-29,2023-07-11 14:10:34,326.29,from_acc,526809.54
49590,5955835,128.0.24.90,889.0,ATM,25,2714,180567478,CREDIT,0,active,2029-05-29,2023-08-02 21:18:08,325.92,country_transfer,526483.62
49591,6063675,188.43.0.135,1413.0,ATM,10,3075,180567478,CREDIT,0,active,2029-05-29,2023-08-09 21:49:40,325.89,in,526809.51
49592,6160255,194.0.144.210,177.0,port_trm,451,5080,180567478,CREDIT,0,active,2029-05-29,2023-08-11 01:35:36,326.21,payment,526483.3
49593,6479802,195.58.0.45,1428.0,cash_in,30,4960,180567478,CREDIT,0,active,2029-05-29,2023-08-24 19:48:44,326.0,transfer,526157.3
49594,6554552,194.0.144.210,177.0,port_trm,-1,2926,180567478,CREDIT,1,active,2029-05-29,2023-09-04 15:49:20,326.16,err,526157.3
49595,6586985,195.58.0.45,1428.0,cash_in,30,7473,180567478,CREDIT,0,active,2029-05-29,2023-09-08 12:09:12,325.88,transfer,525831.42
49596,6822650,212.20.0.0,445.0,ATM,10,7747,180567478,CREDIT,0,active,2029-05-29,2023-10-29 23:41:23,326.12,add_on_acc,526157.54
49597,7074336,188.0.169.120,476.0,cash_in,10,6715,180567478,CREDIT,0,active,2029-05-29,2023-11-05 11:24:04,326.09,in,526483.63
49598,7113253,128.0.24.90,889.0,ATM,25,4700,180567478,CREDIT,0,active,2029-05-29,2023-11-06 04:54:00,326.0,country_transfer,526157.63
49599,7163348,46.0.2.240,199.0,ATM,30,3492,180567478,CREDIT,0,active,2029-05-29,2023-11-14 04:37:09,326.23,transfer,525831.4
49600,7250705,128.0.24.90,889.0,ATM,451,9853,180567478,CREDIT,0,active,2029-05-29,2023-11-27 08:09:57,326.02,payment,525505.38
49601,7338908,78.24.158.189,947.0,cash_out,25,3693,180567478,CREDIT,0,active,2029-05-29,2023-11-27 20:51:57,325.88,diff_cntry,525179.5
49602,7506120,95.167.0.75,205.0,ATM,20,4052,180567478,CREDIT,0,active,2029-05-29,2023-12-26 16:55:21,325.85,out,524853.65
49603,7728302,78.24.158.189,947.0,cash_out,30,3075,180567478,CREDIT,0,active,2029-05-29,2023-12-27 07:11:12,326.13,transfer,524527.52
49604,7949742,194.0.144.210,177.0,port_trm,451,4052,180567478,CREDIT,0,active,2029-05-29,2024-02-04 07:51:08,326.27,payment,524201.25
49605,8211354,78.24.158.189,947.0,cash_out,30,9040,180567478,CREDIT,0,active,2029-05-29,2024-03-28 05:07:26,326.22,transfer,523875.03
49606,8499245,128.0.24.90,889.0,ATM,-1,3423,180567478,CREDIT,1,active,2029-05-29,2024-04-03 05:37:08,325.89,err,523875.03
49607,8616800,128.0.82.45,613.0,Portable term,30,9040,180567478,CREDIT,0,active,2029-05-29,2024-04-29 17:40:31,326.0,transfer,523549.03
49608,8625757,128.0.24.90,889.0,ATM,451,2926,180567478,CREDIT,0,active,2029-05-29,2024-05-03 04:18:48,326.19,payment,523222.84
49609,8675151,195.58.0.45,1428.0,cash_in,-1,6241,180567478,CREDIT,1,active,2029-05-29,2024-05-23 06:06:48,326.0,err_code,523222.84
49610,8780963,128.0.82.45,613.0,Portable term,451,3746,180567478,CREDIT,0,active,2029-05-29,2024-06-27 09:04:15,325.93,payment,522896.91
49611,8807860,194.0.144.210,177.0,port_trm,451,3075,180567478,CREDIT,0,active,2029-05-29,2024-07-08 03:35:07,326.07,payment,522570.84
49612,9111595,46.173.0.195,512.0,ATM,10,8249,180567478,CREDIT,0,active,2029-05-29,2024-07-11 11:47:53,325.98,add_on_acc,522896.82
49613,9118043,185.233.0.135,86.0,port_trm,30,4405,180567478,CREDIT,0,active,2029-05-29,2024-07-29 05:39:48,325.9,transfer,522570.92
49614,9133722,185.233.0.135,86.0,port_trm,-1,4700,180567478,CREDIT,1,active,2029-05-29,2024-08-28 23:32:44,326.23,bad,522570.92
49615,9472012,193.31.0.60,591.0,atm,10,2130,180567478,CREDIT,0,active,2029-05-29,2024-08-29 19:52:56,326.04,in_acc,522896.96
49616,9521938,185.233.0.135,86.0,port_trm,25,4700,180567478,CREDIT,0,active,2029-05-29,2024-09-22 23:47:34,326.14,country_transfer,522570.82
49617,9592416,195.58.0.45,1428.0,cash_in,-1,2857,180567478,CREDIT,1,active,2029-05-29,2024-10-10 18:30:20,326.14,err,522570.82
49618,9706475,79.104.0.75,641.0,atm,20,1736,180567478,CREDIT,0,active,2029-05-29,2024-10-15 12:25:39,325.96,out,522244.86
49619,9730387,194.0.144.210,177.0,port_trm,451,3693,180567478,CREDIT,0,active,2029-05-29,2024-10-26 21:29:45,325.9,payment,521918.96
49620,1104934,195.143.0.105,1370.0,prtbl trm,30,4779,323237454,CREDIT,0,active,2025-12-13,2022-01-19 21:22:38,419.85,transfer,735134.15
49621,1322456,195.143.0.105,1370.0,prtbl trm,-1,5729,323237454,CREDIT,1,active,2025-12-13,2022-01-29 15:19:37,419.92,err,735134.15
49622,1429676,128.0.82.210,631.0,pos trm,25,1088,323237454,CREDIT,0,active,2025-12-13,2022-02-20 14:33:11,420.08,diff_cntry,734714.07
49623,1493889,188.18.0.105,228.0,atm,451,5729,323237454,CREDIT,0,active,2025-12-13,2022-03-29 23:50:30,420.1,payment,734293.97
49624,1678409,46.0.176.75,123.0,atm,-1,7857,323237454,CREDIT,1,active,2025-12-13,2022-04-08 03:16:55,420.07,err,734293.97
49625,1758045,188.162.0.75,958.0,cash_out,20,7857,323237454,CREDIT,0,active,2025-12-13,2022-05-20 02:17:38,419.86,out,733874.11
49626,2108622,195.143.0.105,1370.0,prtbl trm,30,8388,323237454,CREDIT,0,active,2025-12-13,2022-06-23 05:31:09,420.08,transfer,733454.03
49627,2531793,37.0.127.45,1025.0,cash_in,10,8388,323237454,CREDIT,0,active,2025-12-13,2022-08-01 05:54:52,420.23,in,733874.26
49628,2668757,134.0.98.195,806.0,cash_in,10,1070,323237454,CREDIT,0,active,2025-12-13,2022-08-27 22:39:13,419.9,add_on_acc,734294.16
49629,2840905,128.0.82.210,631.0,pos trm,-1,8388,323237454,CREDIT,1,active,2025-12-13,2022-09-02 17:16:00,420.01,err_code,734294.16
49630,2842769,194.84.192.252,48.0,prtbl trm,25,8683,323237454,CREDIT,0,active,2025-12-13,2022-10-11 11:55:40,420.11,diff_cntry,733874.05
49631,3033455,195.143.0.105,1370.0,prtbl trm,25,2098,323237454,CREDIT,0,active,2025-12-13,2022-10-30 14:12:14,420.06,country_transfer,733453.99
49632,3228214,128.0.82.210,631.0,pos trm,30,5729,323237454,CREDIT,0,active,2025-12-13,2022-11-03 07:54:38,419.78,transfer,733034.21
49633,3281032,188.191.0.165,1152.0,atm,10,5729,323237454,CREDIT,0,active,2025-12-13,2022-12-16 06:00:30,420.1,in,733454.31
49634,3399317,128.0.24.105,890.0,prtbl trm,30,5729,323237454,CREDIT,0,active,2025-12-13,2023-01-06 21:12:44,420.12,transfer,733034.19
49635,3433849,188.18.0.105,228.0,atm,25,7857,323237454,CREDIT,0,active,2025-12-13,2023-01-29 21:58:46,419.85,country_transfer,732614.34
49636,3623246,188.244.0.150,1463.0,cash_out,30,4779,323237454,CREDIT,0,active,2025-12-13,2023-02-07 01:52:53,420.01,transfer,732194.33
49637,3992461,188.18.0.105,228.0,atm,-1,3292,323237454,CREDIT,1,active,2025-12-13,2023-02-17 11:42:13,419.84,err_code,732194.33
49638,4007576,46.0.176.75,123.0,atm,451,2098,323237454,CREDIT,0,active,2025-12-13,2023-02-18 02:18:38,420.06,payment,731774.27
49639,4195908,128.0.82.210,631.0,pos trm,451,3292,323237454,CREDIT,0,active,2025-12-13,2023-02-19 03:13:47,420.05,payment,731354.22
49640,5006542,194.0.144.165,174.0,pos trm,451,1070,323237454,CREDIT,0,active,2025-12-13,2023-02-25 00:44:51,420.06,payment,730934.16
49641,5610555,46.0.0.150,665.0,cash_out,20,7857,323237454,CREDIT,0,active,2025-12-13,2023-03-06 00:24:20,420.13,from_acc,730514.03
49642,5980797,188.162.0.60,956.0,cash_in,10,1070,323237454,CREDIT,0,active,2025-12-13,2023-03-14 21:32:59,419.95,add_on_acc,730933.98
49643,6085652,188.244.0.150,1463.0,cash_out,30,3292,323237454,CREDIT,0,active,2025-12-13,2023-03-19 07:49:46,419.91,transfer,730514.07
49644,6153359,128.0.24.105,890.0,prtbl trm,25,3693,323237454,CREDIT,0,active,2025-12-13,2023-03-23 12:39:38,419.84,diff_cntry,730094.23
49645,6235582,188.244.0.150,1463.0,cash_out,-1,9752,323237454,CREDIT,1,active,2025-12-13,2023-05-07 14:29:31,419.89,err,730094.23
49646,6307366,194.0.144.165,174.0,pos trm,451,8388,323237454,CREDIT,0,active,2025-12-13,2023-05-14 03:53:54,420.09,payment,729674.14
49647,6521654,188.0.169.225,485.0,cash_in,10,7723,323237454,CREDIT,0,active,2025-12-13,2023-05-21 09:36:40,419.99,in_acc,730094.13
49648,6568011,217.112.0.60,1476.0,atm,20,1088,323237454,CREDIT,0,active,2025-12-13,2023-05-23 06:05:15,419.88,out,729674.25
49649,6630497,128.0.82.210,631.0,pos trm,451,8388,323237454,CREDIT,0,active,2025-12-13,2023-05-27 23:57:40,420.09,payment,729254.16
49650,6777968,128.0.82.210,631.0,pos trm,-1,7857,323237454,CREDIT,1,active,2025-12-13,2023-06-18 07:14:11,420.0,err_code,729254.16
49651,6941007,128.0.82.210,631.0,pos trm,30,8683,323237454,CREDIT,0,active,2025-12-13,2023-06-25 14:25:52,420.17,transfer,728833.99
49652,7010325,128.0.24.105,890.0,prtbl trm,30,1079,323237454,CREDIT,0,active,2025-12-13,2023-07-14 05:30:50,419.95,transfer,728414.04
49653,7031415,188.244.0.150,1463.0,cash_out,451,2469,323237454,CREDIT,0,active,2025-12-13,2023-09-11 18:09:38,420.08,payment,727993.96
49654,7255362,194.84.192.252,48.0,prtbl trm,25,8388,323237454,CREDIT,0,active,2025-12-13,2023-11-10 01:54:49,419.6,country_transfer,727574.36
49655,7274275,195.143.0.105,1370.0,prtbl trm,-1,4779,323237454,CREDIT,1,active,2025-12-13,2023-11-16 01:47:11,420.12,err_code,727574.36
49656,7416729,188.18.0.105,228.0,atm,25,1079,323237454,CREDIT,0,active,2025-12-13,2023-11-27 08:12:42,420.19,diff_cntry,727154.17
49657,7522306,195.143.0.105,1370.0,prtbl trm,30,1002,323237454,CREDIT,0,active,2025-12-13,2023-12-23 00:43:58,419.72,transfer,726734.45
49658,7811729,194.84.192.252,48.0,prtbl trm,30,5568,323237454,CREDIT,0,active,2025-12-13,2023-12-27 12:22:58,419.8,transfer,726314.65
49659,7859175,188.0.189.0,831.0,cash_in,30,1088,323237454,CREDIT,0,active,2025-12-13,2024-01-24 02:35:19,419.98,transfer,725894.67
49660,7897043,188.18.0.105,228.0,atm,25,9752,323237454,CREDIT,0,active,2025-12-13,2024-02-11 16:14:11,419.86,diff_cntry,725474.81
49661,8057970,188.244.0.150,1463.0,cash_out,-1,2469,323237454,CREDIT,1,active,2025-12-13,2024-03-18 01:16:25,419.82,bad,725474.81
49662,8107345,195.143.0.105,1370.0,prtbl trm,25,5729,323237454,CREDIT,0,active,2025-12-13,2024-04-09 03:55:28,420.09,country_transfer,725054.72
49663,8388811,217.26.0.195,694.0,cash_out,20,3292,323237454,CREDIT,0,active,2025-12-13,2024-06-24 14:52:39,420.01,out,724634.71
49664,8963163,128.0.82.210,631.0,pos trm,30,1079,323237454,CREDIT,0,active,2025-12-13,2024-08-16 08:41:47,419.97,transfer,724214.74
49665,9363579,188.0.169.45,470.0,cash_in,10,7857,323237454,CREDIT,0,active,2025-12-13,2024-09-05 03:29:09,420.08,in_acc,724634.82
49666,9533269,151.0.0.90,20.0,ATM,10,1002,323237454,CREDIT,0,active,2025-12-13,2024-09-29 20:35:25,419.9,in_acc,725054.72
49667,9636365,188.18.0.105,228.0,atm,451,3292,323237454,CREDIT,0,active,2025-12-13,2024-10-11 07:38:05,420.02,payment,724634.7
49668,9669044,188.244.0.150,1463.0,cash_out,30,1002,323237454,CREDIT,0,active,2025-12-13,2024-10-17 03:25:48,419.8,transfer,724214.9
49669,9760285,128.0.24.105,890.0,prtbl trm,451,1088,323237454,CREDIT,0,active,2025-12-13,2024-10-21 21:10:40,420.05,payment,723794.85
49670,9822533,188.18.0.105,228.0,atm,30,3292,323237454,CREDIT,0,active,2025-12-13,2024-11-17 02:15:46,420.4,transfer,723374.45
49671,1118182,91.107.0.210,993.0,atm,451,3559,760910214,DEBIT,0,act,2025-10-15,2022-01-02 00:03:01,387.88,payment,528282.12
49672,1175108,151.0.38.105,395.0,prtbl trm,-1,7864,760910214,DEBIT,1,act,2025-10-15,2022-01-06 08:43:49,388.13,bad,528282.12
49673,1285336,128.0.24.225,903.0,pos trm,451,9474,760910214,DEBIT,0,act,2025-10-15,2022-02-17 22:21:53,387.88,payment,527894.24
49674,1541461,85.140.0.135,1260.0,ATM,25,7515,760910214,DEBIT,0,act,2025-10-15,2022-03-03 11:02:51,387.94,diff_cntry,527506.3
49675,1703807,86.111.0.60,1347.0,Portable term,25,2356,760910214,DEBIT,0,act,2025-10-15,2022-04-16 03:30:36,387.85,diff_cntry,527118.45
49676,1758799,62.118.0.210,537.0,ATM,451,7582,760910214,DEBIT,0,act,2025-10-15,2022-05-02 22:56:24,387.91,payment,526730.54
49677,1956391,94.243.0.15,98.0,ATM,451,6612,760910214,DEBIT,0,act,2025-10-15,2022-05-07 04:18:06,387.72,payment,526342.82
49678,2162678,86.111.0.75,1349.0,pos trm,-1,2916,760910214,DEBIT,1,act,2025-10-15,2022-06-24 11:57:24,387.86,err_code,526342.82
49679,2238971,46.0.188.45,1231.0,cash_out,20,8060,760910214,DEBIT,0,act,2025-10-15,2022-07-10 08:26:09,388.1,out,525954.72
49680,2422408,46.0.54.165,1087.0,port_trm,451,6048,760910214,DEBIT,0,act,2025-10-15,2022-07-13 12:50:48,387.81,payment,525566.91
49681,2441801,91.107.0.210,993.0,atm,451,3559,760910214,DEBIT,0,act,2025-10-15,2022-08-09 15:52:27,387.96,payment,525178.95
49682,2505239,45.154.0.195,312.0,atm,10,7429,760910214,DEBIT,0,act,2025-10-15,2022-08-16 13:15:49,388.04,add_on_acc,525566.99
49683,3614233,134.0.98.180,804.0,atm,20,6245,760910214,DEBIT,0,act,2025-10-15,2022-10-19 08:23:54,387.76,from_acc,525179.23
49684,3834096,86.111.0.60,1347.0,Portable term,25,3451,760910214,DEBIT,0,act,2025-10-15,2022-10-30 02:34:50,388.18,country_transfer,524791.05
49685,4200975,85.140.0.135,1260.0,ATM,451,3974,760910214,DEBIT,0,act,2025-10-15,2022-11-06 02:16:37,388.24,payment,524402.81
49686,4299403,194.156.0.75,27.0,atm,20,3091,760910214,DEBIT,0,act,2025-10-15,2022-11-14 13:46:12,387.97,decrease_on_acc,524014.84
49687,4530328,128.0.24.225,903.0,pos trm,-1,3559,760910214,DEBIT,1,act,2025-10-15,2022-11-24 05:21:38,388.26,err_code,524014.84
49688,4839229,85.140.0.135,1260.0,ATM,451,9722,760910214,DEBIT,0,act,2025-10-15,2022-12-18 12:45:55,388.02,payment,523626.82
49689,5037427,151.0.38.105,395.0,prtbl trm,-1,7269,760910214,DEBIT,1,act,2025-10-15,2022-12-22 02:26:37,387.81,err,523626.82
49690,5104909,91.107.0.210,993.0,atm,451,2916,760910214,DEBIT,0,act,2025-10-15,2023-01-07 10:45:36,388.05,payment,523238.77
49691,5254471,46.0.54.165,1087.0,port_trm,451,3749,760910214,DEBIT,0,act,2025-10-15,2023-01-13 19:49:03,387.92,payment,522850.85
49692,6721985,62.118.0.210,537.0,ATM,20,3451,760910214,DEBIT,0,act,2025-10-15,2023-02-20 02:41:26,387.9,out,522462.95
49693,6761424,151.0.38.105,395.0,prtbl trm,-1,7313,760910214,DEBIT,1,act,2025-10-15,2023-03-12 19:59:20,387.9,bad,522462.95
49694,6836332,151.0.38.105,395.0,prtbl trm,451,4400,760910214,DEBIT,0,act,2025-10-15,2023-03-18 04:44:53,387.66,payment,522075.29
49695,7129189,91.107.0.210,993.0,atm,25,3451,760910214,DEBIT,0,act,2025-10-15,2023-03-25 19:12:03,388.06,diff_cntry,521687.23
49696,7271127,151.0.38.105,395.0,prtbl trm,30,7515,760910214,DEBIT,0,act,2025-10-15,2023-04-05 13:08:06,388.36,transfer,521298.87
49697,7275030,188.244.0.195,1467.0,atm,20,9474,760910214,DEBIT,0,act,2025-10-15,2023-04-07 01:22:05,388.02,decrease_on_acc,520910.85
49698,7321937,195.58.0.225,1446.0,cash_in,10,6048,760910214,DEBIT,0,act,2025-10-15,2023-04-14 08:08:13,387.97,in,521298.82
49699,7352750,195.143.0.225,1382.0,ATM,10,9722,760910214,DEBIT,0,act,2025-10-15,2023-05-08 00:32:45,387.95,add_on_acc,521686.77
49700,7378303,85.140.0.135,1260.0,ATM,451,3974,760910214,DEBIT,0,act,2025-10-15,2023-05-09 17:02:21,388.04,payment,521298.73
49701,7439262,91.107.0.210,993.0,atm,-1,7864,760910214,DEBIT,1,act,2025-10-15,2023-06-09 13:47:03,387.62,err,521298.73
49702,7447983,128.0.94.0,1094.0,atm,10,8043,760910214,DEBIT,0,act,2025-10-15,2023-06-19 22:31:04,387.91,in_acc,521686.64
49703,7572477,188.0.166.120,1307.0,ATM,10,9683,760910214,DEBIT,0,act,2025-10-15,2023-07-25 11:27:50,388.07,add_on_acc,522074.71
49704,7604239,128.0.24.225,903.0,pos trm,451,3749,760910214,DEBIT,0,act,2025-10-15,2023-08-03 13:37:50,388.34,payment,521686.37
49705,7647752,86.111.0.60,1347.0,Portable term,25,7313,760910214,DEBIT,0,act,2025-10-15,2023-08-30 11:19:23,388.34,diff_cntry,521298.03
49706,7914475,86.111.0.60,1347.0,Portable term,451,4400,760910214,DEBIT,0,act,2025-10-15,2023-10-20 07:09:32,387.98,payment,520910.05
49707,8070442,62.118.0.210,537.0,ATM,451,3749,760910214,DEBIT,0,act,2025-10-15,2023-11-14 04:04:42,388.01,payment,520522.04
49708,8254251,31.134.0.0,1116.0,atm,20,7269,760910214,DEBIT,0,act,2025-10-15,2023-11-25 23:51:02,387.94,out,520134.1
49709,8291567,94.243.0.15,98.0,ATM,451,9683,760910214,DEBIT,0,act,2025-10-15,2023-12-31 08:51:36,387.91,payment,519746.19
49710,8294460,62.118.0.210,537.0,ATM,451,8060,760910214,DEBIT,0,act,2025-10-15,2024-01-01 11:03:15,387.99,payment,519358.2
49711,8549024,86.111.0.75,1349.0,pos trm,-1,7429,760910214,DEBIT,1,act,2025-10-15,2024-01-06 13:01:24,387.99,err_code,519358.2
49712,8593253,85.140.0.135,1260.0,ATM,451,7864,760910214,DEBIT,0,act,2025-10-15,2024-03-16 19:02:27,388.05,payment,518970.15
49713,8880993,91.107.0.210,993.0,atm,25,3559,760910214,DEBIT,0,act,2025-10-15,2024-04-13 14:52:45,388.23,country_transfer,518581.92
49714,9001460,94.243.0.15,98.0,ATM,30,4564,760910214,DEBIT,0,act,2025-10-15,2024-06-14 17:55:33,387.88,transfer,518194.04
49715,9048969,195.58.0.60,1429.0,ATM,20,3091,760910214,DEBIT,0,act,2025-10-15,2024-07-10 10:17:34,388.01,out,517806.03
49716,9145201,193.0.151.240,76.0,atm,10,9624,760910214,DEBIT,0,act,2025-10-15,2024-09-28 01:13:16,388.13,add_on_acc,518194.16
49717,9545829,188.191.0.165,1152.0,atm,20,1459,760910214,DEBIT,0,act,2025-10-15,2024-09-28 10:24:09,387.93,from_acc,517806.23
49718,9613602,217.112.0.195,1488.0,atm,10,9624,760910214,DEBIT,0,act,2025-10-15,2024-09-30 23:57:38,388.13,in,518194.36
49719,9685842,128.0.24.225,903.0,pos trm,30,3974,760910214,DEBIT,0,act,2025-10-15,2024-10-11 09:16:33,387.8,transfer,517806.56
49720,9802420,151.0.38.105,395.0,prtbl trm,-1,3451,760910214,DEBIT,1,act,2025-10-15,2024-10-27 13:29:24,388.23,err,517806.56
49721,9928838,151.0.38.105,395.0,prtbl trm,451,9474,760910214,DEBIT,0,act,2025-10-15,2024-11-10 22:06:23,388.14,payment,517418.42
49722,1039016,128.0.82.75,616.0,cash_in,30,7294,728575156,DEBIT,0,act,2028-02-20,2022-01-05 08:01:44,113.88,transfer,126893.12
49723,1314881,46.0.2.45,184.0,ATM,10,7080,728575156,DEBIT,0,act,2028-02-20,2022-01-28 17:48:55,114.09,in_acc,127007.21
49724,1540800,46.0.9.30,1319.0,cash_in,10,7603,728575156,DEBIT,0,act,2028-02-20,2022-01-31 02:10:12,113.99,in_acc,127121.2
49725,1560053,88.210.0.210,360.0,atm,10,9681,728575156,DEBIT,0,act,2028-02-20,2022-02-04 01:42:03,114.17,in,127235.37
49726,1992901,88.210.0.30,342.0,ATM,20,6261,728575156,DEBIT,0,act,2028-02-20,2022-02-13 23:16:29,113.77,from_acc,127121.6
49727,2036994,95.181.0.30,250.0,Portable term,30,7363,728575156,DEBIT,0,act,2028-02-20,2022-05-27 08:28:48,113.75,transfer,127007.85
49728,2159165,81.17.0.90,1390.0,atm,10,1573,728575156,DEBIT,0,act,2028-02-20,2022-06-19 17:21:42,114.15,in,127122.0
49729,2260562,95.181.0.30,250.0,Portable term,451,2319,728575156,DEBIT,0,act,2028-02-20,2022-07-26 07:12:33,113.99,payment,127008.01
49730,2333417,5.189.0.45,859.0,cash_out,20,9940,728575156,DEBIT,0,act,2028-02-20,2022-08-14 08:00:07,113.86,out,126894.15
49731,2358968,95.181.0.30,250.0,Portable term,451,5611,728575156,DEBIT,0,act,2028-02-20,2022-09-22 13:12:27,114.1,payment,126780.05
49732,2401672,46.0.9.240,1339.0,cash_out,20,4352,728575156,DEBIT,0,act,2028-02-20,2022-10-01 18:45:42,114.05,decrease_on_acc,126666.0
49733,2419641,46.0.2.225,198.0,ATM,20,6911,728575156,DEBIT,0,act,2028-02-20,2022-10-15 10:50:10,113.79,out,126552.21
49734,2863957,78.24.158.144,943.0,port_trm,451,4352,728575156,DEBIT,0,act,2028-02-20,2022-12-16 03:38:39,113.99,payment,126438.22
49735,2960187,85.140.0.225,1270.0,cash_in,10,4352,728575156,DEBIT,0,act,2028-02-20,2023-01-26 21:13:29,113.97,add_on_acc,126552.19
49736,3312611,95.181.0.30,250.0,Portable term,25,6435,728575156,DEBIT,0,act,2028-02-20,2023-02-12 15:03:41,113.92,diff_cntry,126438.27
49737,3328737,46.0.8.105,145.0,atm,451,7582,728575156,DEBIT,0,act,2028-02-20,2023-02-21 09:45:41,113.94,payment,126324.33
49738,3957378,86.111.0.135,1353.0,prtbl trm,451,1573,728575156,DEBIT,0,act,2028-02-20,2023-02-25 15:18:50,114.0,payment,126210.33
49739,4017007,128.0.82.75,616.0,cash_in,25,8414,728575156,DEBIT,0,act,2028-02-20,2023-03-02 23:44:21,114.17,diff_cntry,126096.16
49740,4117140,95.167.0.165,214.0,port_trm,30,7363,728575156,DEBIT,0,act,2028-02-20,2023-03-12 22:39:39,114.18,transfer,125981.98
49741,4223834,213.151.0.60,1000.0,ATM,10,5611,728575156,DEBIT,0,act,2028-02-20,2023-03-14 13:25:43,113.93,add_on_acc,126095.91
49742,4463037,37.0.124.195,734.0,ATM,-1,2319,728575156,DEBIT,1,act,2028-02-20,2023-03-15 23:47:03,114.23,bad,126095.91
49743,4617123,194.0.162.105,747.0,cash_in,10,6842,728575156,DEBIT,0,act,2028-02-20,2023-03-26 09:49:13,113.81,in_acc,126209.72
49744,4910492,78.24.158.144,943.0,port_trm,451,4352,728575156,DEBIT,0,act,2028-02-20,2023-04-06 22:44:03,114.16,payment,126095.56
49745,4967247,78.24.158.144,943.0,port_trm,451,8393,728575156,DEBIT,0,act,2028-02-20,2023-04-11 23:10:43,113.91,payment,125981.65
49746,5014499,37.0.124.195,734.0,ATM,25,5611,728575156,DEBIT,0,act,2028-02-20,2023-04-21 16:20:21,113.77,diff_cntry,125867.88
49747,5095715,95.167.0.165,214.0,port_trm,451,7482,728575156,DEBIT,0,act,2028-02-20,2023-04-29 23:33:17,114.19,payment,125753.69
49748,5177212,95.181.0.30,250.0,Portable term,30,4975,728575156,DEBIT,0,act,2028-02-20,2023-05-02 06:14:30,113.89,transfer,125639.8
49749,5400430,46.0.8.105,145.0,atm,451,6435,728575156,DEBIT,0,act,2028-02-20,2023-06-07 22:41:47,114.23,payment,125525.57
49750,5446434,86.111.0.135,1353.0,prtbl trm,451,7363,728575156,DEBIT,0,act,2028-02-20,2023-06-22 10:23:42,114.28,payment,125411.29
49751,5507483,95.106.0.120,553.0,cash_in,10,2272,728575156,DEBIT,0,act,2028-02-20,2023-07-05 10:00:01,114.09,add_on_acc,125525.38
49752,5638262,185.173.0.15,1273.0,ATM,10,7363,728575156,DEBIT,0,act,2028-02-20,2023-07-06 10:15:02,113.94,add_on_acc,125639.32
49753,5694910,46.0.123.225,929.0,ATM,20,4975,728575156,DEBIT,0,act,2028-02-20,2023-07-17 23:35:14,113.76,out,125525.56
49754,5792040,188.0.189.210,849.0,cash_in,10,5555,728575156,DEBIT,0,act,2028-02-20,2023-07-29 23:54:32,114.09,in_acc,125639.65
49755,5803270,95.167.0.165,214.0,port_trm,25,7080,728575156,DEBIT,0,act,2028-02-20,2023-07-30 00:09:52,113.84,diff_cntry,125525.81
49756,6115006,37.0.124.195,734.0,ATM,451,6261,728575156,DEBIT,0,act,2028-02-20,2023-08-02 18:43:16,113.98,payment,125411.83
49757,6166938,37.0.127.45,1025.0,cash_in,10,4352,728575156,DEBIT,0,act,2028-02-20,2023-09-11 02:27:18,113.9,in_acc,125525.73
49758,6212005,78.24.158.144,943.0,port_trm,30,2615,728575156,DEBIT,0,act,2028-02-20,2023-10-12 11:58:29,113.88,transfer,125411.85
49759,6213199,46.0.8.105,145.0,atm,25,7226,728575156,DEBIT,0,act,2028-02-20,2023-11-14 11:03:29,114.08,diff_cntry,125297.77
49760,6295050,194.0.162.225,759.0,atm,20,8393,728575156,DEBIT,0,act,2028-02-20,2023-11-17 10:36:53,113.9,decrease_on_acc,125183.87
49761,6359000,37.0.124.120,729.0,atm,20,7363,728575156,DEBIT,0,act,2028-02-20,2023-11-27 09:02:11,114.21,out,125069.66
49762,6425934,78.24.158.144,943.0,port_trm,25,6842,728575156,DEBIT,0,act,2028-02-20,2023-12-03 05:12:45,113.85,country_transfer,124955.81
49763,6502137,128.0.82.75,616.0,cash_in,451,4975,728575156,DEBIT,0,act,2028-02-20,2023-12-13 15:54:24,114.04,payment,124841.77
49764,6787266,217.26.0.135,688.0,ATM,10,7363,728575156,DEBIT,0,act,2028-02-20,2024-01-04 00:58:42,113.99,in_acc,124955.76
49765,6945352,128.0.82.75,616.0,cash_in,30,6911,728575156,DEBIT,0,act,2028-02-20,2024-02-03 01:36:28,114.03,transfer,124841.73
49766,7116174,128.0.82.75,616.0,cash_in,451,7363,728575156,DEBIT,0,act,2028-02-20,2024-02-19 11:55:34,113.78,payment,124727.95
49767,7277502,46.0.8.105,145.0,atm,25,7363,728575156,DEBIT,0,act,2028-02-20,2024-02-23 05:49:37,113.84,country_transfer,124614.11
49768,7328087,46.0.8.105,145.0,atm,451,2759,728575156,DEBIT,0,act,2028-02-20,2024-03-22 20:03:29,113.89,payment,124500.22
49769,7535519,62.118.0.45,523.0,cash_out,20,4352,728575156,DEBIT,0,act,2028-02-20,2024-04-29 14:13:05,113.92,out,124386.3
49770,8309347,37.0.124.195,734.0,ATM,30,2615,728575156,DEBIT,0,act,2028-02-20,2024-05-13 02:30:12,114.09,transfer,124272.21
49771,8341251,37.0.124.195,734.0,ATM,-1,2615,728575156,DEBIT,1,act,2028-02-20,2024-06-08 23:57:24,114.01,bad,124272.21
49772,8358329,128.0.82.75,616.0,cash_in,451,9940,728575156,DEBIT,0,act,2028-02-20,2024-06-23 00:37:41,114.23,payment,124157.98
49773,8639053,78.24.158.144,943.0,port_trm,-1,6435,728575156,DEBIT,1,act,2028-02-20,2024-08-12 20:45:10,114.08,bad,124157.98
49774,8713541,95.167.0.180,215.0,ATM,10,2615,728575156,DEBIT,0,act,2028-02-20,2024-09-10 03:48:47,113.88,in,124271.86
49775,8722391,37.0.124.195,734.0,ATM,30,7603,728575156,DEBIT,0,act,2028-02-20,2024-09-14 22:03:58,114.1,transfer,124157.76
49776,9015647,128.0.82.75,616.0,cash_in,-1,5555,728575156,DEBIT,1,act,2028-02-20,2024-10-03 04:33:31,113.9,bad,124157.76
49777,9040235,193.0.151.105,59.0,ATM,10,7603,728575156,DEBIT,0,act,2028-02-20,2024-11-02 05:33:27,114.1,in,124271.86
49778,9078098,128.0.82.75,616.0,cash_in,451,9681,728575156,DEBIT,0,act,2028-02-20,2024-11-26 14:28:23,114.15,payment,124157.71
49779,1011914,217.112.0.150,1483.0,ATM,10,4638,225348021,DEBIT,0,active,2026-11-02,2022-01-07 05:21:22,985.1,in_acc,372056.1
49780,1303875,46.0.8.165,149.0,cash_out,20,5574,225348021,DEBIT,0,active,2026-11-02,2022-01-12 20:45:05,984.84,decrease_on_acc,371071.26
49781,1570730,37.0.127.135,1032.0,port_trm,30,4333,225348021,DEBIT,0,active,2026-11-02,2022-01-19 19:33:59,984.98,transfer,370086.28
49782,1747676,134.0.98.105,798.0,prtbl trm,451,3009,225348021,DEBIT,0,active,2026-11-02,2022-02-17 06:08:35,985.24,payment,369101.04
49783,1902426,46.0.8.135,147.0,atm,10,4638,225348021,DEBIT,0,active,2026-11-02,2022-03-11 12:06:08,985.04,in,370086.08
49784,1975935,46.0.143.120,820.0,cash_in,10,6472,225348021,DEBIT,0,active,2026-11-02,2022-03-25 00:57:40,985.3,in_acc,371071.38
49785,1976055,37.0.127.135,1032.0,port_trm,451,8428,225348021,DEBIT,0,active,2026-11-02,2022-04-11 02:40:22,984.93,payment,370086.45
49786,2218012,194.0.162.165,752.0,atm,451,5574,225348021,DEBIT,0,active,2026-11-02,2022-04-20 13:59:58,985.08,payment,369101.37
49787,2269636,31.134.0.90,1122.0,cash_in,10,4333,225348021,DEBIT,0,active,2026-11-02,2022-05-12 22:54:25,984.82,in,370086.19
49788,2447427,46.0.54.75,1075.0,ATM,451,9119,225348021,DEBIT,0,active,2026-11-02,2022-05-30 14:37:47,984.91,payment,369101.28
49789,2538225,134.0.98.105,798.0,prtbl trm,25,4458,225348021,DEBIT,0,active,2026-11-02,2022-06-14 11:56:23,985.17,diff_cntry,368116.11
49790,2625818,37.0.127.135,1032.0,port_trm,451,6472,225348021,DEBIT,0,active,2026-11-02,2022-09-19 11:03:59,984.92,payment,367131.19
49791,2919683,46.8.0.165,780.0,ATM,20,5574,225348021,DEBIT,0,active,2026-11-02,2022-09-22 02:28:35,985.01,from_acc,366146.18
49792,3503324,37.0.127.135,1032.0,port_trm,25,3175,225348021,DEBIT,0,active,2026-11-02,2022-09-30 15:03:05,984.93,country_transfer,365161.25
49793,4003261,188.0.0.180,1218.0,port_trm,-1,3283,225348021,DEBIT,1,active,2026-11-02,2022-11-07 12:36:48,985.16,bad,365161.25
49794,4015470,134.0.98.105,798.0,prtbl trm,-1,9104,225348021,DEBIT,2,active,2026-11-02,2022-12-09 01:06:06,984.99,err_code,365161.25
49795,4064705,37.0.127.135,1032.0,port_trm,451,1422,225348021,DEBIT,0,active,2026-11-02,2022-12-15 05:28:09,984.79,payment,364176.46
49796,4279899,134.0.98.105,798.0,prtbl trm,451,8428,225348021,DEBIT,0,active,2026-11-02,2022-12-20 15:35:48,985.03,payment,363191.43
49797,4391646,94.243.0.15,98.0,ATM,25,6472,225348021,DEBIT,0,active,2026-11-02,2022-12-27 15:27:54,984.97,country_transfer,362206.46
49798,4568253,109.126.0.30,366.0,atm,20,5565,225348021,DEBIT,0,active,2026-11-02,2023-01-02 20:53:04,984.9,out,361221.56
49799,4790877,62.118.0.30,522.0,ATM,-1,6580,225348021,DEBIT,1,active,2026-11-02,2023-01-12 02:20:30,984.87,err,361221.56
49800,5320214,194.0.162.165,752.0,atm,25,7688,225348021,DEBIT,0,active,2026-11-02,2023-01-13 14:13:54,985.09,country_transfer,360236.47
49801,5333905,46.0.54.75,1075.0,ATM,30,4638,225348021,DEBIT,0,active,2026-11-02,2023-02-03 15:05:40,984.9,transfer,359251.57
49802,5536177,5.189.0.120,865.0,ATM,-1,3009,225348021,DEBIT,1,active,2026-11-02,2023-02-13 04:50:34,984.99,err,359251.57
49803,5558815,188.0.0.180,1218.0,port_trm,451,5565,225348021,DEBIT,0,active,2026-11-02,2023-03-10 09:32:39,985.21,payment,358266.36
49804,5983414,46.0.54.75,1075.0,ATM,451,3009,225348021,DEBIT,0,active,2026-11-02,2023-03-14 20:48:50,984.85,payment,357281.51
49805,6010037,62.118.0.30,522.0,ATM,25,5574,225348021,DEBIT,0,active,2026-11-02,2023-03-29 22:43:10,985.15,country_transfer,356296.36
49806,6049920,193.31.0.90,594.0,ATM,20,3175,225348021,DEBIT,0,active,2026-11-02,2023-05-04 20:16:40,985.27,out,355311.09
49807,6204318,85.140.0.135,1260.0,ATM,20,3009,225348021,DEBIT,0,active,2026-11-02,2023-05-11 06:29:10,984.89,decrease_on_acc,354326.2
49808,6285414,37.0.127.135,1032.0,port_trm,451,8591,225348021,DEBIT,0,active,2026-11-02,2023-05-22 14:52:53,984.81,payment,353341.39
49809,6477681,94.243.0.15,98.0,ATM,25,7142,225348021,DEBIT,0,active,2026-11-02,2023-05-24 08:23:00,985.0,diff_cntry,352356.39
49810,6584937,46.0.54.75,1075.0,ATM,30,9104,225348021,DEBIT,0,active,2026-11-02,2023-06-22 01:35:03,984.99,transfer,351371.4
49811,7162884,62.118.0.30,522.0,ATM,30,1422,225348021,DEBIT,0,active,2026-11-02,2023-07-01 08:09:23,984.96,transfer,350386.44
49812,7476220,213.151.0.60,1000.0,ATM,10,7142,225348021,DEBIT,0,active,2026-11-02,2023-07-18 02:16:25,984.93,add_on_acc,351371.37
49813,7569544,188.0.0.180,1218.0,port_trm,-1,3009,225348021,DEBIT,1,active,2026-11-02,2023-08-24 18:52:30,985.03,err,351371.37
49814,7628876,5.189.0.120,865.0,ATM,25,1422,225348021,DEBIT,0,active,2026-11-02,2023-10-03 04:31:02,985.11,diff_cntry,350386.26
49815,7853817,194.0.162.165,752.0,atm,451,4807,225348021,DEBIT,0,active,2026-11-02,2023-10-11 01:33:12,985.19,payment,349401.07
49816,7863094,79.104.0.225,652.0,atm,20,1305,225348021,DEBIT,0,active,2026-11-02,2023-10-20 00:18:29,985.02,decrease_on_acc,348416.05
49817,7880270,194.0.162.165,752.0,atm,30,7142,225348021,DEBIT,0,active,2026-11-02,2023-10-28 09:16:31,984.95,transfer,347431.1
49818,8030116,134.0.98.105,798.0,prtbl trm,451,6472,225348021,DEBIT,0,active,2026-11-02,2023-11-27 04:19:13,985.1,payment,346446.0
49819,8144328,134.0.98.105,798.0,prtbl trm,25,3283,225348021,DEBIT,0,active,2026-11-02,2024-02-05 22:41:05,985.0,country_transfer,345461.0
49820,8391328,94.243.0.15,98.0,ATM,-1,1675,225348021,DEBIT,1,active,2026-11-02,2024-02-24 07:39:49,985.01,bad,345461.0
49821,8449048,37.0.127.135,1032.0,port_trm,451,3197,225348021,DEBIT,0,active,2026-11-02,2024-03-03 09:17:45,985.1,payment,344475.9
49822,8481346,193.0.151.15,51.0,ATM,10,7142,225348021,DEBIT,0,active,2026-11-02,2024-03-04 16:40:51,984.92,in_acc,345460.82
49823,8624996,94.243.0.15,98.0,ATM,-1,8591,225348021,DEBIT,1,active,2026-11-02,2024-03-08 00:30:49,985.22,err_code,345460.82
49824,8788629,188.244.0.195,1467.0,atm,10,1422,225348021,DEBIT,0,active,2026-11-02,2024-03-09 20:34:27,984.71,in,346445.53
49825,8987310,94.243.0.15,98.0,ATM,25,4333,225348021,DEBIT,0,active,2026-11-02,2024-04-15 12:46:11,984.99,country_transfer,345460.54
49826,9043550,62.118.0.30,522.0,ATM,25,4333,225348021,DEBIT,0,active,2026-11-02,2024-06-16 11:44:22,984.99,diff_cntry,344475.55
49827,9183866,188.0.0.180,1218.0,port_trm,25,2835,225348021,DEBIT,0,active,2026-11-02,2024-07-26 08:52:02,985.13,country_transfer,343490.42
49828,9203073,80.234.0.195,424.0,cash_in,10,9104,225348021,DEBIT,0,active,2026-11-02,2024-08-19 18:11:29,984.92,in,344475.34
49829,9212349,194.0.162.165,752.0,atm,30,4807,225348021,DEBIT,0,active,2026-11-02,2024-08-29 14:07:25,985.18,transfer,343490.16
49830,9234624,46.0.2.0,180.0,atm,10,2835,225348021,DEBIT,0,active,2026-11-02,2024-09-29 08:40:21,984.94,add_on_acc,344475.1
49831,9334614,194.156.0.90,28.0,cash_in,10,5574,225348021,DEBIT,0,active,2026-11-02,2024-10-24 15:02:41,985.23,add_on_acc,345460.33
49832,9341739,37.0.127.135,1032.0,port_trm,25,4333,225348021,DEBIT,0,active,2026-11-02,2024-11-10 22:11:53,985.04,country_transfer,344475.29
49833,9713810,31.134.0.105,1123.0,cash_out,20,3009,225348021,DEBIT,0,active,2026-11-02,2024-11-24 19:44:51,984.88,out,343490.41
49834,1079288,128.0.82.150,626.0,cash_out,20,2164,556929405,DEBIT,0,active,2026-10-17,2022-01-13 23:55:28,971.01,decrease_on_acc,686982.99
49835,1185166,195.58.0.105,1434.0,ATM,20,1183,556929405,DEBIT,0,active,2026-10-17,2022-01-21 06:51:15,970.93,from_acc,686012.06
49836,1295818,46.0.0.135,664.0,cash_out,25,9899,556929405,DEBIT,0,active,2026-10-17,2022-02-06 03:47:35,971.07,country_transfer,685040.99
49837,1393662,188.0.169.210,484.0,atm,20,7277,556929405,DEBIT,0,active,2026-10-17,2022-03-12 02:23:12,971.01,out,684069.98
49838,1435295,31.134.0.165,1127.0,atm,20,3809,556929405,DEBIT,0,active,2026-10-17,2022-03-16 03:35:25,971.0,out,683098.98
49839,1468326,128.0.82.180,628.0,atm,10,7748,556929405,DEBIT,0,active,2026-10-17,2022-03-29 17:13:32,970.96,in,684069.94
49840,2282237,46.0.0.135,664.0,cash_out,451,4349,556929405,DEBIT,0,active,2026-10-17,2022-07-05 10:15:09,970.94,payment,683099.0
49841,2844602,134.0.98.120,799.0,cash_out,20,2164,556929405,DEBIT,0,active,2026-10-17,2022-07-20 04:45:55,971.14,from_acc,682127.86
49842,2858144,46.0.0.135,664.0,cash_out,25,2164,556929405,DEBIT,0,active,2026-10-17,2022-07-30 08:39:50,970.88,diff_cntry,681156.98
49843,3053072,46.0.0.135,664.0,cash_out,451,3573,556929405,DEBIT,0,active,2026-10-17,2022-08-08 13:48:27,971.06,payment,680185.92
49844,3319764,109.126.0.180,378.0,atm,451,9589,556929405,DEBIT,0,active,2026-10-17,2022-08-11 02:54:17,970.95,payment,679214.97
49845,3450444,188.0.166.165,1311.0,cash_out,451,4618,556929405,DEBIT,0,active,2026-10-17,2022-08-18 19:45:24,970.73,payment,678244.24
49846,3562725,109.126.0.180,378.0,atm,451,4349,556929405,DEBIT,0,active,2026-10-17,2022-08-22 20:36:53,971.05,payment,677273.19
49847,3780922,46.0.176.150,128.0,atm,20,1183,556929405,DEBIT,0,active,2026-10-17,2022-09-05 12:46:55,971.16,decrease_on_acc,676302.03
49848,3916092,79.104.0.240,653.0,cash_in,30,5792,556929405,DEBIT,0,active,2026-10-17,2022-10-02 03:26:29,971.23,transfer,675330.8
49849,4216121,134.0.98.0,790.0,atm,20,2164,556929405,DEBIT,0,active,2026-10-17,2022-11-23 19:07:39,970.7,out,674360.1
49850,4408078,46.0.0.135,664.0,cash_out,451,2308,556929405,DEBIT,0,active,2026-10-17,2022-11-29 15:34:57,970.91,payment,673389.19
49851,4485893,109.126.0.180,378.0,atm,25,2164,556929405,DEBIT,0,active,2026-10-17,2023-03-04 04:12:27,971.2,country_transfer,672417.99
49852,4579901,188.0.166.165,1311.0,cash_out,-1,4005,556929405,DEBIT,1,active,2026-10-17,2023-03-06 09:45:59,970.78,err,672417.99
49853,4626147,46.0.0.135,664.0,cash_out,451,4005,556929405,DEBIT,0,active,2026-10-17,2023-03-23 22:12:00,971.26,payment,671446.73
49854,4747590,46.0.0.135,664.0,cash_out,451,4349,556929405,DEBIT,0,active,2026-10-17,2023-04-10 12:06:06,970.99,payment,670475.74
49855,4774902,109.126.0.180,378.0,atm,451,3809,556929405,DEBIT,0,active,2026-10-17,2023-06-04 05:16:15,971.07,payment,669504.67
49856,4939250,79.104.0.240,653.0,cash_in,451,4226,556929405,DEBIT,0,active,2026-10-17,2023-06-12 03:42:09,971.1,payment,668533.57
49857,5108674,46.0.0.135,664.0,cash_out,25,3809,556929405,DEBIT,0,active,2026-10-17,2023-06-24 11:03:54,971.09,country_transfer,667562.48
49858,5281174,95.181.0.240,267.0,ATM,20,1182,556929405,DEBIT,0,active,2026-10-17,2023-07-05 13:06:37,971.24,decrease_on_acc,666591.24
49859,5468592,78.24.158.249,951.0,atm,10,4226,556929405,DEBIT,0,active,2026-10-17,2023-07-18 04:06:44,970.93,add_on_acc,667562.17
49860,5597100,79.104.0.240,653.0,cash_in,451,5792,556929405,DEBIT,0,active,2026-10-17,2023-09-03 06:10:08,970.77,payment,666591.4
49861,5618727,109.126.0.180,378.0,atm,451,2164,556929405,DEBIT,0,active,2026-10-17,2023-10-07 05:20:16,970.95,payment,665620.45
49862,5960712,79.104.0.240,653.0,cash_in,25,4226,556929405,DEBIT,0,active,2026-10-17,2023-11-28 15:51:20,971.15,country_transfer,664649.3
49863,6004020,188.0.166.165,1311.0,cash_out,25,4005,556929405,DEBIT,0,active,2026-10-17,2023-11-30 05:44:53,970.98,country_transfer,663678.32
49864,6106595,79.104.0.240,653.0,cash_in,-1,2164,556929405,DEBIT,1,active,2026-10-17,2023-12-09 11:37:26,971.08,err_code,663678.32
49865,6209016,95.167.0.180,215.0,ATM,20,2164,556929405,DEBIT,0,active,2026-10-17,2023-12-20 08:53:18,971.17,out,662707.15
49866,6234940,79.104.0.240,653.0,cash_in,451,7748,556929405,DEBIT,0,active,2026-10-17,2024-02-01 16:31:37,971.11,payment,661736.04
49867,6289504,188.0.166.165,1311.0,cash_out,25,9899,556929405,DEBIT,0,active,2026-10-17,2024-03-11 06:10:05,971.14,country_transfer,660764.9
49868,6661068,109.126.0.180,378.0,atm,25,3809,556929405,DEBIT,0,active,2026-10-17,2024-03-25 18:40:03,970.97,diff_cntry,659793.93
49869,6766119,79.104.0.240,653.0,cash_in,-1,3573,556929405,DEBIT,1,active,2026-10-17,2024-04-03 06:19:10,970.83,bad,659793.93
49870,6851636,188.0.166.165,1311.0,cash_out,25,3809,556929405,DEBIT,0,active,2026-10-17,2024-05-11 21:27:25,971.31,country_transfer,658822.62
49871,6919789,79.104.0.240,653.0,cash_in,451,3809,556929405,DEBIT,0,active,2026-10-17,2024-05-20 05:33:21,970.91,payment,657851.71
49872,6923622,188.0.166.60,1303.0,atm,20,7748,556929405,DEBIT,0,active,2026-10-17,2024-06-03 05:30:24,971.09,decrease_on_acc,656880.62
49873,7470753,188.18.0.105,228.0,atm,20,1910,556929405,DEBIT,0,active,2026-10-17,2024-06-14 11:09:06,971.13,out,655909.49
49874,7616418,80.234.0.75,416.0,cash_out,20,1910,556929405,DEBIT,0,active,2026-10-17,2024-07-04 19:10:00,971.0,decrease_on_acc,654938.49
49875,7673958,151.0.38.90,394.0,ATM,20,9899,556929405,DEBIT,0,active,2026-10-17,2024-07-06 16:56:29,971.32,decrease_on_acc,653967.17
49876,7772792,46.0.0.135,664.0,cash_out,451,3365,556929405,DEBIT,0,active,2026-10-17,2024-09-16 23:15:02,971.06,payment,652996.11
49877,8278372,79.104.0.240,653.0,cash_in,451,2308,556929405,DEBIT,0,active,2026-10-17,2024-09-29 22:30:35,970.94,payment,652025.17
49878,8542860,109.126.0.180,378.0,atm,451,3573,556929405,DEBIT,0,active,2026-10-17,2024-10-01 10:04:13,970.95,payment,651054.22
49879,9284552,109.126.0.180,378.0,atm,451,7748,556929405,DEBIT,0,active,2026-10-17,2024-10-11 14:24:02,970.96,payment,650083.26
49880,9296836,194.0.144.105,168.0,ATM,20,4877,556929405,DEBIT,0,active,2026-10-17,2024-10-18 15:41:41,970.97,from_acc,649112.29
49881,9387166,46.0.0.135,664.0,cash_out,451,3365,556929405,DEBIT,0,active,2026-10-17,2024-10-23 13:02:28,971.11,payment,648141.18
49882,9645199,79.104.0.240,653.0,cash_in,30,4618,556929405,DEBIT,0,active,2026-10-17,2024-10-25 19:18:52,970.8,transfer,647170.38
49883,9742610,188.0.166.165,1311.0,cash_out,30,2164,556929405,DEBIT,0,active,2026-10-17,2024-11-05 12:13:25,970.88,transfer,646199.5
49884,9853657,79.104.0.240,653.0,cash_in,-1,7748,556929405,DEBIT,1,active,2026-10-17,2024-11-23 05:49:40,971.01,err,646199.5
49885,1031767,80.234.0.135,420.0,prtbl trm,30,1654,277371852,DEBIT,0,active,2026-06-07,2022-01-08 05:09:35,395.91,transfer,138126.09
49886,1094472,5.189.0.30,858.0,cash_in,25,3246,277371852,DEBIT,0,active,2026-06-07,2022-01-21 21:06:30,395.91,diff_cntry,137730.18
49887,1166174,79.104.0.150,647.0,Portable term,25,3845,277371852,DEBIT,0,active,2026-06-07,2022-02-08 22:39:06,395.74,diff_cntry,137334.44
49888,1245211,91.107.0.15,975.0,prtbl trm,-1,3845,277371852,DEBIT,1,active,2026-06-07,2022-02-15 14:02:56,395.97,bad,137334.44
49889,1282596,91.107.0.15,975.0,prtbl trm,25,5736,277371852,DEBIT,0,active,2026-06-07,2022-03-06 22:43:24,396.04,diff_cntry,136938.4
49890,1319520,188.191.0.45,1142.0,cash_out,20,4031,277371852,DEBIT,0,active,2026-06-07,2022-03-24 04:49:33,395.78,decrease_on_acc,136542.62
49891,1685039,217.112.0.165,1485.0,ATM,20,4706,277371852,DEBIT,0,active,2026-06-07,2022-04-03 07:29:39,395.89,from_acc,136146.73
49892,1685156,80.234.0.135,420.0,prtbl trm,25,7730,277371852,DEBIT,0,active,2026-06-07,2022-05-08 23:27:06,395.81,diff_cntry,135750.92
49893,1720626,5.189.0.30,858.0,cash_in,25,3508,277371852,DEBIT,0,active,2026-06-07,2022-07-12 04:29:46,395.92,country_transfer,135355.0
49894,1904887,46.0.8.105,145.0,atm,10,3845,277371852,DEBIT,0,active,2026-06-07,2022-08-05 06:45:47,396.06,add_on_acc,135751.06
49895,2114101,91.107.0.15,975.0,prtbl trm,-1,7730,277371852,DEBIT,1,active,2026-06-07,2022-08-10 04:34:00,395.98,err,135751.06
49896,2193066,46.0.188.105,1235.0,cash_in,10,4706,277371852,DEBIT,0,active,2026-06-07,2022-08-13 04:28:15,395.99,in_acc,136147.05
49897,2394845,79.104.0.150,647.0,Portable term,30,1101,277371852,DEBIT,0,active,2026-06-07,2022-08-16 12:25:39,396.05,transfer,135751.0
49898,2911323,128.0.82.165,627.0,atm,10,3845,277371852,DEBIT,0,active,2026-06-07,2022-09-22 00:48:43,395.92,in,136146.92
49899,3080018,91.107.0.15,975.0,prtbl trm,451,3845,277371852,DEBIT,0,active,2026-06-07,2022-10-25 13:11:58,395.85,payment,135751.07
49900,3139294,91.107.0.15,975.0,prtbl trm,25,1654,277371852,DEBIT,0,active,2026-06-07,2022-10-27 12:14:23,396.02,diff_cntry,135355.05
49901,3157941,91.107.0.15,975.0,prtbl trm,-1,2491,277371852,DEBIT,1,active,2026-06-07,2022-10-27 15:19:36,395.84,bad,135355.05
49902,3434729,91.107.0.15,975.0,prtbl trm,25,1101,277371852,DEBIT,0,active,2026-06-07,2022-11-04 21:58:06,395.85,diff_cntry,134959.2
49903,3451446,79.104.0.150,647.0,Portable term,451,3246,277371852,DEBIT,0,active,2026-06-07,2022-12-10 15:03:03,396.21,payment,134562.99
49904,3907887,212.20.0.210,464.0,cash_in,10,1654,277371852,DEBIT,0,active,2026-06-07,2023-01-15 18:41:06,395.97,in,134958.96
49905,3975609,81.17.0.45,1387.0,cash_in,10,4031,277371852,DEBIT,0,active,2026-06-07,2023-01-27 10:33:36,396.05,add_on_acc,135355.01
49906,3987293,95.167.0.45,203.0,atm,20,3629,277371852,DEBIT,0,active,2026-06-07,2023-01-29 18:46:48,396.15,from_acc,134958.86
49907,4038818,88.210.0.30,342.0,ATM,20,3387,277371852,DEBIT,0,active,2026-06-07,2023-03-17 00:04:07,395.83,from_acc,134563.03
49908,4077316,81.17.0.180,1399.0,ATM,20,3387,277371852,DEBIT,0,active,2026-06-07,2023-03-17 10:34:24,395.88,out,134167.15
49909,4090321,5.189.0.30,858.0,cash_in,451,1415,277371852,DEBIT,0,active,2026-06-07,2023-03-20 01:19:48,395.9,payment,133771.25
49910,4137238,185.173.0.45,1276.0,port_trm,-1,7730,277371852,DEBIT,1,active,2026-06-07,2023-06-15 22:40:46,395.91,bad,133771.25
49911,4231037,185.173.0.45,1276.0,port_trm,30,2491,277371852,DEBIT,0,active,2026-06-07,2023-06-22 20:43:44,395.99,transfer,133375.26
49912,4696706,188.0.189.45,834.0,ATM,20,3246,277371852,DEBIT,0,active,2026-06-07,2023-08-11 03:24:42,396.28,out,132978.98
49913,4759048,5.189.0.30,858.0,cash_in,30,8921,277371852,DEBIT,0,active,2026-06-07,2023-08-27 17:04:45,396.06,transfer,132582.92
49914,4995315,193.0.151.180,68.0,atm,10,3629,277371852,DEBIT,0,active,2026-06-07,2023-09-08 23:36:01,396.08,in,132979.0
49915,5022356,193.31.0.180,603.0,ATM,10,8921,277371852,DEBIT,0,active,2026-06-07,2023-09-27 20:35:44,395.99,add_on_acc,133374.99
49916,5375091,91.107.0.15,975.0,prtbl trm,25,8921,277371852,DEBIT,0,active,2026-06-07,2023-10-28 01:25:40,395.83,country_transfer,132979.16
49917,5414527,185.173.0.45,1276.0,port_trm,451,1415,277371852,DEBIT,0,active,2026-06-07,2023-11-18 08:54:35,396.21,payment,132582.95
49918,5544653,195.143.0.195,1380.0,atm,20,4706,277371852,DEBIT,0,active,2026-06-07,2023-11-27 20:12:21,395.77,out,132187.18
49919,5545896,5.189.0.30,858.0,cash_in,-1,1101,277371852,DEBIT,1,active,2026-06-07,2024-01-07 01:13:43,396.3,bad,132187.18
49920,5605718,217.26.0.135,688.0,ATM,10,1101,277371852,DEBIT,0,active,2026-06-07,2024-01-10 19:01:25,396.01,in_acc,132583.19
49921,5620811,79.104.0.150,647.0,Portable term,25,7730,277371852,DEBIT,0,active,2026-06-07,2024-02-22 16:52:37,395.95,diff_cntry,132187.24
49922,6240631,185.173.0.45,1276.0,port_trm,30,8921,277371852,DEBIT,0,active,2026-06-07,2024-02-26 10:59:12,396.18,transfer,131791.06
49923,6512841,79.104.0.150,647.0,Portable term,30,7730,277371852,DEBIT,0,active,2026-06-07,2024-04-13 22:13:03,395.8,transfer,131395.26
49924,6664158,91.107.0.15,975.0,prtbl trm,25,3629,277371852,DEBIT,0,active,2026-06-07,2024-04-20 22:10:51,395.86,country_transfer,130999.4
49925,6696138,80.234.0.135,420.0,prtbl trm,-1,1654,277371852,DEBIT,1,active,2026-06-07,2024-04-21 12:03:04,396.29,err_code,130999.4
49926,6825864,80.234.0.135,420.0,prtbl trm,30,1654,277371852,DEBIT,0,active,2026-06-07,2024-04-29 21:40:43,396.14,transfer,130603.26
49927,7030581,217.26.0.120,687.0,atm,10,3508,277371852,DEBIT,0,active,2026-06-07,2024-06-05 18:12:49,395.91,add_on_acc,130999.17
49928,7058725,193.31.0.60,591.0,atm,20,4138,277371852,DEBIT,0,active,2026-06-07,2024-07-03 07:38:50,396.13,from_acc,130603.04
49929,7294941,185.173.0.45,1276.0,port_trm,-1,7985,277371852,DEBIT,1,active,2026-06-07,2024-07-05 00:33:08,395.98,bad,130603.04
49930,7646248,79.104.0.150,647.0,Portable term,451,1101,277371852,DEBIT,0,active,2026-06-07,2024-07-12 10:38:27,395.79,payment,130207.25
49931,7887287,91.107.0.15,975.0,prtbl trm,451,7985,277371852,DEBIT,0,active,2026-06-07,2024-07-20 22:35:08,395.79,payment,129811.46
49932,8617516,91.107.0.15,975.0,prtbl trm,30,3387,277371852,DEBIT,0,active,2026-06-07,2024-08-02 14:32:38,395.78,transfer,129415.68
49933,8711685,85.140.0.90,1255.0,ATM,10,7730,277371852,DEBIT,0,active,2026-06-07,2024-08-08 13:22:49,395.95,in_acc,129811.63
49934,8788140,5.189.0.30,858.0,cash_in,-1,3629,277371852,DEBIT,1,active,2026-06-07,2024-08-19 03:11:18,396.03,err,129811.63
49935,8789913,62.118.0.120,530.0,ATM,10,2491,277371852,DEBIT,0,active,2026-06-07,2024-10-02 00:32:15,395.83,in,130207.46
49936,9197994,37.0.124.195,734.0,ATM,10,1101,277371852,DEBIT,0,active,2026-06-07,2024-10-24 15:09:23,396.27,add_on_acc,130603.73
49937,9609681,79.104.0.150,647.0,Portable term,30,3508,277371852,DEBIT,0,active,2026-06-07,2024-11-06 14:07:14,396.05,transfer,130207.68
49938,9733344,79.104.0.150,647.0,Portable term,451,4138,277371852,DEBIT,0,active,2026-06-07,2024-11-08 20:52:52,395.78,payment,129811.9
49939,1167693,188.0.0.240,1224.0,port_trm,30,2244,242748823,DEBIT,0,active,2029-01-08,2022-01-21 22:42:40,570.98,transfer,852106.02
49940,1199746,85.140.0.165,1264.0,atm,-1,5331,242748823,DEBIT,1,active,2029-01-08,2022-03-01 08:59:58,570.84,bad,852106.02
49941,1521575,109.126.0.135,375.0,Portable term,451,6309,242748823,DEBIT,0,active,2029-01-08,2022-03-14 05:23:04,571.15,payment,851534.87
49942,1608844,95.181.0.105,255.0,cash_out,-1,9176,242748823,DEBIT,1,active,2029-01-08,2022-04-03 14:52:32,571.26,err,851534.87
49943,1797748,46.0.143.30,812.0,atm,20,3697,242748823,DEBIT,0,active,2029-01-08,2022-06-09 20:28:06,571.04,from_acc,850963.83
49944,1994379,217.112.0.195,1488.0,atm,-1,2244,242748823,DEBIT,1,active,2029-01-08,2022-06-12 15:07:05,570.71,err_code,850963.83
49945,2006458,185.233.0.60,81.0,ATM,10,6030,242748823,DEBIT,0,active,2029-01-08,2022-07-06 06:31:15,571.13,in,851534.96
49946,2053472,217.26.0.120,687.0,atm,10,8674,242748823,DEBIT,0,active,2029-01-08,2022-07-20 01:41:23,570.72,add_on_acc,852105.68
49947,2544959,95.181.0.105,255.0,cash_out,451,8781,242748823,DEBIT,0,active,2029-01-08,2022-07-25 22:30:29,571.1,payment,851534.58
49948,2587060,188.0.0.240,1224.0,port_trm,451,3697,242748823,DEBIT,0,active,2029-01-08,2022-08-20 16:36:03,570.74,payment,850963.84
49949,2888965,195.58.0.60,1429.0,ATM,20,6309,242748823,DEBIT,0,active,2029-01-08,2022-08-28 08:26:13,571.01,decrease_on_acc,850392.83
49950,3113344,95.181.0.105,255.0,cash_out,451,2654,242748823,DEBIT,0,active,2029-01-08,2022-11-15 10:06:25,570.92,payment,849821.91
49951,3442871,109.126.0.0,364.0,port_trm,-1,9176,242748823,DEBIT,1,active,2029-01-08,2022-11-29 11:27:15,571.39,err,849821.91
49952,3718023,85.140.0.165,1264.0,atm,25,9597,242748823,DEBIT,0,active,2029-01-08,2022-12-05 13:45:59,570.88,country_transfer,849251.03
49953,3828772,109.126.0.135,375.0,Portable term,25,6468,242748823,DEBIT,0,active,2029-01-08,2022-12-18 17:02:43,571.15,diff_cntry,848679.88
49954,3869123,217.112.0.195,1488.0,atm,451,6468,242748823,DEBIT,0,active,2029-01-08,2023-01-20 10:18:27,570.74,payment,848109.14
49955,4304142,81.17.0.210,1401.0,cash_in,10,6309,242748823,DEBIT,0,active,2029-01-08,2023-02-16 22:17:30,570.85,in_acc,848679.99
49956,4323355,194.87.0.90,572.0,atm,20,9386,242748823,DEBIT,0,active,2029-01-08,2023-03-16 22:29:13,570.95,out,848109.04
49957,4657919,95.181.0.105,255.0,cash_out,25,3697,242748823,DEBIT,0,active,2029-01-08,2023-03-26 13:32:35,570.96,diff_cntry,847538.08
49958,4821452,37.0.123.165,332.0,Portable term,451,6468,242748823,DEBIT,0,active,2029-01-08,2023-04-08 02:45:35,570.85,payment,846967.23
49959,4869118,128.0.24.90,889.0,ATM,20,7310,242748823,DEBIT,0,active,2029-01-08,2023-04-16 02:19:20,571.04,out,846396.19
49960,5010159,37.0.123.15,319.0,atm,10,4216,242748823,DEBIT,0,active,2029-01-08,2023-05-27 19:15:21,571.07,add_on_acc,846967.26
49961,5096905,188.244.0.30,1450.0,port_trm,-1,4404,242748823,DEBIT,1,active,2029-01-08,2023-05-30 10:42:07,570.88,bad,846967.26
49962,5517269,37.0.123.165,332.0,Portable term,451,6030,242748823,DEBIT,0,active,2029-01-08,2023-06-15 07:25:53,571.06,payment,846396.2
49963,5573015,109.126.0.0,364.0,port_trm,30,4216,242748823,DEBIT,0,active,2029-01-08,2023-06-16 02:35:32,570.96,transfer,845825.24
49964,5653588,85.140.0.240,1271.0,ATM,10,5830,242748823,DEBIT,0,active,2029-01-08,2023-06-16 18:28:32,571.04,in_acc,846396.28
49965,5978964,188.244.0.30,1450.0,port_trm,451,6030,242748823,DEBIT,0,active,2029-01-08,2023-06-20 04:07:01,571.03,payment,845825.25
49966,6517346,217.112.0.195,1488.0,atm,30,6683,242748823,DEBIT,0,active,2029-01-08,2023-06-21 21:19:17,570.72,transfer,845254.53
49967,6899349,217.112.0.195,1488.0,atm,25,4902,242748823,DEBIT,0,active,2029-01-08,2023-07-14 23:12:33,571.0,country_transfer,844683.53
49968,7030314,109.126.0.0,364.0,port_trm,30,3697,242748823,DEBIT,0,active,2029-01-08,2023-07-17 00:35:25,571.05,transfer,844112.48
49969,7246996,128.0.24.45,883.0,atm,20,9386,242748823,DEBIT,0,active,2029-01-08,2023-07-19 00:54:53,571.12,decrease_on_acc,843541.36
49970,7336691,188.0.166.15,1297.0,ATM,20,5830,242748823,DEBIT,0,active,2029-01-08,2023-07-21 02:26:11,571.1,from_acc,842970.26
49971,7429401,188.0.166.75,1304.0,atm,10,3697,242748823,DEBIT,0,active,2029-01-08,2023-07-26 18:15:13,571.08,in,843541.34
49972,7533257,109.126.0.135,375.0,Portable term,-1,6030,242748823,DEBIT,1,active,2029-01-08,2023-08-30 17:51:09,570.81,bad,843541.34
49973,7744076,95.181.0.105,255.0,cash_out,451,8674,242748823,DEBIT,0,active,2029-01-08,2023-09-05 13:47:07,571.24,payment,842970.1
49974,7780601,95.181.0.105,255.0,cash_out,30,5374,242748823,DEBIT,0,active,2029-01-08,2023-09-24 05:35:06,571.02,transfer,842399.08
49975,7836161,109.126.0.0,364.0,port_trm,451,4404,242748823,DEBIT,0,active,2029-01-08,2023-10-09 11:06:27,571.23,payment,841827.85
49976,7926401,212.20.0.120,457.0,ATM,20,4902,242748823,DEBIT,0,active,2029-01-08,2023-12-12 06:53:33,570.92,from_acc,841256.93
49977,8107399,95.181.0.105,255.0,cash_out,451,9176,242748823,DEBIT,0,active,2029-01-08,2024-01-12 11:45:09,570.55,payment,840686.38
49978,8212084,37.0.123.165,332.0,Portable term,25,3697,242748823,DEBIT,0,active,2029-01-08,2024-01-15 00:30:00,571.15,country_transfer,840115.23
49979,8292327,217.112.0.0,1471.0,ATM,20,5510,242748823,DEBIT,0,active,2029-01-08,2024-01-28 05:37:13,571.0,from_acc,839544.23
49980,8491368,188.244.0.30,1450.0,port_trm,25,4363,242748823,DEBIT,0,active,2029-01-08,2024-02-19 08:27:24,571.3,diff_cntry,838972.93
49981,8498683,85.140.0.165,1264.0,atm,-1,2244,242748823,DEBIT,1,active,2029-01-08,2024-04-22 20:57:37,571.17,err,838972.93
49982,8740294,37.0.123.165,332.0,Portable term,-1,5830,242748823,DEBIT,2,active,2029-01-08,2024-05-04 23:13:58,570.96,err_code,838972.93
49983,8760789,151.0.38.180,403.0,atm,10,4404,242748823,DEBIT,0,active,2029-01-08,2024-05-24 16:34:21,571.06,in,839543.99
49984,8783510,109.126.0.135,375.0,Portable term,451,5374,242748823,DEBIT,0,active,2029-01-08,2024-05-30 01:28:33,571.07,payment,838972.92
49985,9453129,109.126.0.135,375.0,Portable term,25,2244,242748823,DEBIT,0,active,2029-01-08,2024-06-26 13:16:21,571.12,diff_cntry,838401.8
49986,9484589,109.126.0.135,375.0,Portable term,25,6762,242748823,DEBIT,0,active,2029-01-08,2024-07-10 09:01:40,570.67,diff_cntry,837831.13
49987,9523080,188.244.0.30,1450.0,port_trm,451,8781,242748823,DEBIT,0,active,2029-01-08,2024-08-06 02:27:55,570.89,payment,837260.24
49988,9577289,217.112.0.195,1488.0,atm,451,9386,242748823,DEBIT,0,active,2029-01-08,2024-09-08 10:19:18,571.2,payment,836689.04
49989,9658187,188.0.0.240,1224.0,port_trm,451,9386,242748823,DEBIT,0,active,2029-01-08,2024-09-29 02:38:30,571.24,payment,836117.8
49990,9884199,217.112.0.195,1488.0,atm,30,3697,242748823,DEBIT,0,active,2029-01-08,2024-10-18 03:15:45,570.95,transfer,835546.85
49991,9945926,37.0.123.165,332.0,Portable term,30,5374,242748823,DEBIT,0,active,2029-01-08,2024-11-03 22:35:33,571.27,transfer,834975.58
49992,1076367,217.112.0.195,1488.0,atm,20,9638,306208038,DEBIT,0,active,2028-05-01,2022-01-12 07:58:25,247.91,from_acc,834007.09
49993,1189978,5.189.0.45,859.0,cash_out,30,3596,306208038,DEBIT,0,active,2028-05-01,2022-01-27 00:46:37,247.88,transfer,833759.21
49994,1569721,195.161.0.15,1163.0,Portable term,30,1343,306208038,DEBIT,0,active,2028-05-01,2022-02-03 22:08:47,247.91,transfer,833511.3
49995,1665172,195.161.0.30,1164.0,ATM,451,7610,306208038,DEBIT,0,active,2028-05-01,2022-02-24 01:07:11,247.89,payment,833263.41
49996,1873644,195.161.0.15,1163.0,Portable term,451,9772,306208038,DEBIT,0,active,2028-05-01,2022-02-25 08:24:55,248.15,payment,833015.26
49997,1885993,193.0.151.150,64.0,ATM,20,1343,306208038,DEBIT,0,active,2028-05-01,2022-02-26 11:28:09,247.94,from_acc,832767.32
49998,2004252,185.17.0.105,1053.0,cash_in,10,4735,306208038,DEBIT,0,active,2028-05-01,2022-03-12 02:45:16,247.96,in_acc,833015.28
49999,2010147,194.0.162.195,755.0,pos trm,25,1379,306208038,DEBIT,0,active,2028-05-01,2022-03-15 04:01:16,248.0,country_transfer,832767.28
50000,2194522,188.18.0.120,231.0,port_trm,451,9772,306208038,DEBIT,0,active,2028-05-01,2022-03-27 01:46:04,248.1,payment,832519.18
50001,2241954,194.0.162.195,755.0,pos trm,25,5501,306208038,DEBIT,0,active,2028-05-01,2022-04-05 08:44:13,248.1,country_transfer,832271.08
50002,2348169,194.0.162.195,755.0,pos trm,25,9638,306208038,DEBIT,0,active,2028-05-01,2022-04-08 22:02:01,247.91,diff_cntry,832023.17
50003,2827222,5.189.0.45,859.0,cash_out,30,1538,306208038,DEBIT,0,active,2028-05-01,2022-06-22 02:25:56,247.92,transfer,831775.25
50004,3067894,195.161.0.15,1163.0,Portable term,451,8296,306208038,DEBIT,0,active,2028-05-01,2022-06-26 21:55:04,247.79,payment,831527.46
50005,3091428,195.161.0.30,1164.0,ATM,451,4735,306208038,DEBIT,0,active,2028-05-01,2022-06-30 07:19:22,247.98,payment,831279.48
50006,3103015,77.242.0.0,268.0,cash_out,20,9772,306208038,DEBIT,0,active,2028-05-01,2022-09-07 08:56:12,248.16,from_acc,831031.32
50007,3192073,194.0.162.195,755.0,pos trm,451,5501,306208038,DEBIT,0,active,2028-05-01,2022-09-11 16:42:31,248.25,payment,830783.07
50008,3414289,194.0.162.195,755.0,pos trm,451,5501,306208038,DEBIT,0,active,2028-05-01,2022-10-13 06:02:10,247.96,payment,830535.11
50009,3561595,188.18.0.195,239.0,cash_in,10,7610,306208038,DEBIT,0,active,2028-05-01,2022-11-15 14:53:26,247.86,in,830782.97
50010,3638518,195.161.0.15,1163.0,Portable term,451,8296,306208038,DEBIT,0,active,2028-05-01,2022-12-05 02:03:34,247.94,payment,830535.03
50011,3773503,195.161.0.15,1163.0,Portable term,25,6973,306208038,DEBIT,0,active,2028-05-01,2023-02-05 23:24:16,248.13,diff_cntry,830286.9
50012,3929563,195.161.0.30,1164.0,ATM,25,5275,306208038,DEBIT,0,active,2028-05-01,2023-02-11 19:34:38,248.08,country_transfer,830038.82
50013,4064129,188.0.166.60,1303.0,atm,20,5275,306208038,DEBIT,0,active,2028-05-01,2023-02-20 19:22:30,248.04,decrease_on_acc,829790.78
50014,4085228,195.161.0.15,1163.0,Portable term,30,4735,306208038,DEBIT,0,active,2028-05-01,2023-02-28 05:03:56,248.05,transfer,829542.73
50015,4088263,195.161.0.15,1163.0,Portable term,451,7610,306208038,DEBIT,0,active,2028-05-01,2023-03-13 03:30:42,248.18,payment,829294.55
50016,4402468,195.161.0.15,1163.0,Portable term,30,7610,306208038,DEBIT,0,active,2028-05-01,2023-04-13 17:01:11,248.17,transfer,829046.38
50017,4668844,188.18.0.120,231.0,port_trm,-1,1193,306208038,DEBIT,1,active,2028-05-01,2023-05-06 14:45:21,248.05,err,829046.38
50018,4783996,5.189.0.45,859.0,cash_out,30,9638,306208038,DEBIT,0,active,2028-05-01,2023-05-12 05:30:37,247.81,transfer,828798.57
50019,4905264,195.161.0.15,1163.0,Portable term,30,5275,306208038,DEBIT,0,active,2028-05-01,2023-05-14 16:34:07,247.96,transfer,828550.61
50020,5265894,195.161.0.30,1164.0,ATM,25,1419,306208038,DEBIT,0,active,2028-05-01,2023-06-10 22:18:48,248.0,country_transfer,828302.61
50021,5528976,195.161.0.15,1163.0,Portable term,451,7610,306208038,DEBIT,0,active,2028-05-01,2023-07-01 22:57:55,248.07,payment,828054.54
50022,5636695,188.18.0.120,231.0,port_trm,-1,8296,306208038,DEBIT,1,active,2028-05-01,2023-07-17 01:04:44,248.01,err,828054.54
50023,5702600,188.18.0.120,231.0,port_trm,25,1343,306208038,DEBIT,0,active,2028-05-01,2023-07-19 09:42:36,247.82,country_transfer,827806.72
50024,5790661,80.234.0.15,411.0,cash_out,20,9638,306208038,DEBIT,0,active,2028-05-01,2023-07-23 01:46:02,248.05,from_acc,827558.67
50025,5960888,195.161.0.15,1163.0,Portable term,30,8296,306208038,DEBIT,0,active,2028-05-01,2023-08-01 07:27:24,248.25,transfer,827310.42
50026,6089050,194.156.0.105,29.0,ATM,20,9638,306208038,DEBIT,0,active,2028-05-01,2023-09-30 10:08:10,248.11,decrease_on_acc,827062.31
50027,6292987,78.24.158.69,937.0,atm,10,5275,306208038,DEBIT,0,active,2028-05-01,2023-10-06 05:05:39,247.98,in_acc,827310.29
50028,6359127,194.0.162.195,755.0,pos trm,451,1699,306208038,DEBIT,0,active,2028-05-01,2023-10-31 16:41:59,248.03,payment,827062.26
50029,6481191,195.161.0.15,1163.0,Portable term,451,1419,306208038,DEBIT,0,active,2028-05-01,2023-11-26 00:43:07,247.79,payment,826814.47
50030,6570230,31.134.0.45,1119.0,atm,10,1419,306208038,DEBIT,0,active,2028-05-01,2023-11-30 02:11:15,248.01,in_acc,827062.48
50031,6635676,46.0.128.105,708.0,cash_out,20,1193,306208038,DEBIT,0,active,2028-05-01,2023-12-31 01:28:50,247.96,decrease_on_acc,826814.52
50032,6837166,5.189.0.45,859.0,cash_out,30,1343,306208038,DEBIT,0,active,2028-05-01,2024-01-04 21:19:36,248.04,transfer,826566.48
50033,6869423,188.0.166.30,1298.0,ATM,10,5501,306208038,DEBIT,0,active,2028-05-01,2024-01-06 00:20:08,248.0,in,826814.48
50034,7147139,188.18.0.120,231.0,port_trm,30,4735,306208038,DEBIT,0,active,2028-05-01,2024-01-13 12:09:29,248.07,transfer,826566.41
50035,7175811,5.189.0.45,859.0,cash_out,451,1379,306208038,DEBIT,0,active,2028-05-01,2024-02-11 07:38:48,247.92,payment,826318.49
50036,7222891,195.161.0.15,1163.0,Portable term,451,5275,306208038,DEBIT,0,active,2028-05-01,2024-02-14 17:54:09,248.12,payment,826070.37
50037,7291199,88.210.0.45,343.0,cash_in,10,1379,306208038,DEBIT,0,active,2028-05-01,2024-02-23 20:01:03,247.89,in,826318.26
50038,8137957,188.43.0.120,1412.0,cash_out,20,6029,306208038,DEBIT,0,active,2028-05-01,2024-02-24 17:42:13,247.94,out,826070.32
50039,8197077,194.0.162.195,755.0,pos trm,-1,8296,306208038,DEBIT,1,active,2028-05-01,2024-04-27 00:59:02,248.2,bad,826070.32
50040,8234628,5.189.0.45,859.0,cash_out,451,7610,306208038,DEBIT,0,active,2028-05-01,2024-05-11 21:28:48,248.33,payment,825821.99
50041,8277978,195.161.0.30,1164.0,ATM,25,3596,306208038,DEBIT,0,active,2028-05-01,2024-06-04 10:33:10,247.66,country_transfer,825574.33
50042,8615490,194.0.162.195,755.0,pos trm,25,2500,306208038,DEBIT,0,active,2028-05-01,2024-06-28 01:22:54,248.27,diff_cntry,825326.06
50043,8813652,188.18.0.120,231.0,port_trm,25,6973,306208038,DEBIT,0,active,2028-05-01,2024-07-24 16:45:01,248.13,diff_cntry,825077.93
50044,8888022,195.161.0.15,1163.0,Portable term,451,1379,306208038,DEBIT,0,active,2028-05-01,2024-08-27 18:24:31,248.06,payment,824829.87
50045,9044847,194.0.162.195,755.0,pos trm,-1,1379,306208038,DEBIT,1,active,2028-05-01,2024-09-14 05:57:00,247.9,bad,824829.87
50046,9335825,37.0.127.210,1037.0,ATM,10,9638,306208038,DEBIT,0,active,2028-05-01,2024-09-20 04:52:44,247.95,in_acc,825077.82
50047,9559661,194.0.162.195,755.0,pos trm,25,2500,306208038,DEBIT,0,active,2028-05-01,2024-10-15 16:07:49,247.97,diff_cntry,824829.85
50048,9647689,194.0.162.195,755.0,pos trm,25,1699,306208038,DEBIT,0,active,2028-05-01,2024-11-03 18:50:42,248.17,country_transfer,824581.68
50049,9684355,195.161.0.15,1163.0,Portable term,25,1538,306208038,DEBIT,0,active,2028-05-01,2024-11-03 20:42:04,248.25,diff_cntry,824333.43
50050,9933040,91.107.0.240,995.0,cash_in,10,1343,306208038,DEBIT,0,active,2028-05-01,2024-11-21 18:08:54,248.05,in,824581.48
50051,1022982,80.234.0.210,425.0,prtbl trm,30,7020,438391984,CREDIT,0,act,2027-06-23,2022-01-08 06:41:31,458.87,transfer,565563.13
50052,1200058,85.140.0.15,1247.0,atm,20,4742,438391984,CREDIT,0,act,2027-06-23,2022-01-29 20:15:02,458.88,out,565104.25
50053,1257323,128.0.24.30,882.0,atm,20,2874,438391984,CREDIT,0,act,2027-06-23,2022-02-03 17:37:37,458.99,decrease_on_acc,564645.26
50054,1460925,95.167.0.180,215.0,ATM,20,5502,438391984,CREDIT,0,act,2027-06-23,2022-02-24 11:01:44,459.14,out,564186.12
50055,1562417,95.106.0.90,550.0,atm,20,7363,438391984,CREDIT,0,act,2027-06-23,2022-03-01 21:07:34,458.89,out,563727.23
50056,1700631,188.43.0.135,1413.0,ATM,30,4347,438391984,CREDIT,0,act,2027-06-23,2022-03-25 22:31:54,458.79,transfer,563268.44
50057,2026867,217.26.0.225,696.0,cash_out,451,5502,438391984,CREDIT,0,act,2027-06-23,2022-04-07 03:35:09,459.0,payment,562809.44
50058,2143090,94.243.0.135,108.0,cash_out,20,5989,438391984,CREDIT,0,act,2027-06-23,2022-04-13 14:47:35,458.87,decrease_on_acc,562350.57
50059,2866484,46.0.143.15,811.0,atm,20,5989,438391984,CREDIT,0,act,2027-06-23,2022-04-18 21:13:35,458.89,from_acc,561891.68
50060,2967945,79.104.60.75,433.0,port_trm,30,2834,438391984,CREDIT,0,act,2027-06-23,2022-04-24 03:31:36,458.96,transfer,561432.72
50061,3186149,212.20.0.75,454.0,cash_in,10,4347,438391984,CREDIT,0,act,2027-06-23,2022-05-12 09:24:37,458.98,add_on_acc,561891.7
50062,3251396,188.0.166.15,1297.0,ATM,30,7020,438391984,CREDIT,0,act,2027-06-23,2022-05-14 19:24:49,459.03,transfer,561432.67
50063,3289783,79.104.60.75,433.0,port_trm,30,2900,438391984,CREDIT,0,act,2027-06-23,2022-06-04 03:50:05,459.1,transfer,560973.57
50064,3363832,109.126.0.180,378.0,atm,10,4742,438391984,CREDIT,0,act,2027-06-23,2022-07-17 12:47:04,459.1,add_on_acc,561432.67
50065,3885428,188.43.0.135,1413.0,ATM,30,7020,438391984,CREDIT,0,act,2027-06-23,2022-08-17 16:27:54,458.95,transfer,560973.72
50066,3967559,188.0.166.15,1297.0,ATM,-1,7020,438391984,CREDIT,1,act,2027-06-23,2022-09-06 16:54:10,458.92,err_code,560973.72
50067,4112053,188.43.0.135,1413.0,ATM,30,2834,438391984,CREDIT,0,act,2027-06-23,2022-09-17 15:14:53,458.87,transfer,560514.85
50068,4213771,188.0.166.15,1297.0,ATM,451,2308,438391984,CREDIT,0,act,2027-06-23,2022-10-03 12:24:58,458.86,payment,560055.99
50069,4452274,188.43.0.135,1413.0,ATM,25,6143,438391984,CREDIT,0,act,2027-06-23,2022-10-30 03:46:43,459.14,diff_cntry,559596.85
50070,4845341,37.0.123.210,335.0,prtbl trm,451,2834,438391984,CREDIT,0,act,2027-06-23,2022-11-29 01:08:21,458.89,payment,559137.96
50071,4895345,77.242.0.210,287.0,atm,20,9865,438391984,CREDIT,0,act,2027-06-23,2022-12-19 04:03:10,458.87,out,558679.09
50072,4910480,80.234.0.210,425.0,prtbl trm,451,5875,438391984,CREDIT,0,act,2027-06-23,2023-01-18 02:10:31,458.99,payment,558220.1
50073,4941550,37.0.123.210,335.0,prtbl trm,25,1839,438391984,CREDIT,0,act,2027-06-23,2023-04-16 18:08:32,459.08,diff_cntry,557761.02
50074,5074555,109.126.0.105,372.0,ATM,10,1183,438391984,CREDIT,0,act,2027-06-23,2023-04-18 18:31:37,458.88,add_on_acc,558219.9
50075,5088341,79.104.60.75,433.0,port_trm,451,2343,438391984,CREDIT,0,act,2027-06-23,2023-04-18 18:54:56,458.92,payment,557760.98
50076,5229053,217.26.0.225,696.0,cash_out,451,9865,438391984,CREDIT,0,act,2027-06-23,2023-05-02 02:53:19,459.11,payment,557301.87
50077,5259500,88.210.0.210,360.0,atm,10,7020,438391984,CREDIT,0,act,2027-06-23,2023-05-08 12:48:51,458.8,add_on_acc,557760.67
50078,5424529,217.112.0.195,1488.0,atm,10,4347,438391984,CREDIT,0,act,2027-06-23,2023-06-27 07:31:11,458.88,add_on_acc,558219.55
50079,5592399,80.234.0.210,425.0,prtbl trm,451,4463,438391984,CREDIT,0,act,2027-06-23,2023-07-15 18:48:35,459.11,payment,557760.44
50080,5607944,188.43.0.135,1413.0,ATM,30,8602,438391984,CREDIT,0,act,2027-06-23,2023-08-17 19:10:56,458.82,transfer,557301.62
50081,5796428,80.234.0.210,425.0,prtbl trm,-1,5989,438391984,CREDIT,1,act,2027-06-23,2023-08-21 23:16:53,458.86,bad,557301.62
50082,5894737,188.43.0.135,1413.0,ATM,25,1183,438391984,CREDIT,0,act,2027-06-23,2023-08-22 17:56:50,458.97,country_transfer,556842.65
50083,6382785,37.0.123.210,335.0,prtbl trm,30,2834,438391984,CREDIT,0,act,2027-06-23,2023-08-23 16:55:10,458.81,transfer,556383.84
50084,6435306,188.0.166.15,1297.0,ATM,25,6484,438391984,CREDIT,0,act,2027-06-23,2023-08-24 05:37:05,459.22,diff_cntry,555924.62
50085,6457205,80.234.0.210,425.0,prtbl trm,25,2834,438391984,CREDIT,0,act,2027-06-23,2023-08-26 09:34:26,459.12,diff_cntry,555465.5
50086,6503703,46.0.188.15,1227.0,atm,20,3925,438391984,CREDIT,0,act,2027-06-23,2023-09-30 15:50:17,459.08,out,555006.42
50087,6573167,62.118.0.0,518.0,cash_out,20,1709,438391984,CREDIT,0,act,2027-06-23,2023-10-08 00:36:21,459.13,out,554547.29
50088,6962962,217.26.0.225,696.0,cash_out,25,4742,438391984,CREDIT,0,act,2027-06-23,2023-10-13 22:22:23,459.02,country_transfer,554088.27
50089,6985507,46.0.188.60,1232.0,cash_in,10,4347,438391984,CREDIT,0,act,2027-06-23,2023-11-15 23:18:37,458.72,in,554546.99
50090,6995261,37.0.127.210,1037.0,ATM,10,2900,438391984,CREDIT,0,act,2027-06-23,2023-12-06 08:57:14,459.26,in,555006.25
50091,7067250,188.0.166.15,1297.0,ATM,451,7363,438391984,CREDIT,0,act,2027-06-23,2023-12-30 23:29:40,459.16,payment,554547.09
50092,7184247,188.0.166.15,1297.0,ATM,451,6143,438391984,CREDIT,0,act,2027-06-23,2024-02-05 12:17:37,459.18,payment,554087.91
50093,7769173,188.0.166.165,1311.0,cash_out,20,2023,438391984,CREDIT,0,act,2027-06-23,2024-02-11 05:47:03,458.97,out,553628.94
50094,7807439,46.0.128.225,716.0,ATM,20,4463,438391984,CREDIT,0,act,2027-06-23,2024-02-14 16:17:11,459.16,out,553169.78
50095,7877105,188.0.166.15,1297.0,ATM,30,3505,438391984,CREDIT,0,act,2027-06-23,2024-02-26 22:55:58,458.84,transfer,552710.94
50096,8046429,188.43.0.135,1413.0,ATM,30,4463,438391984,CREDIT,0,act,2027-06-23,2024-04-24 21:49:33,458.88,transfer,552252.06
50097,8134043,88.210.0.15,341.0,atm,20,9865,438391984,CREDIT,0,act,2027-06-23,2024-05-13 17:06:28,458.91,out,551793.15
50098,8606625,188.0.166.15,1297.0,ATM,25,1183,438391984,CREDIT,0,act,2027-06-23,2024-05-29 01:43:10,458.68,diff_cntry,551334.47
50099,8735033,217.26.0.225,696.0,cash_out,25,7020,438391984,CREDIT,0,act,2027-06-23,2024-06-24 08:30:38,458.83,diff_cntry,550875.64
50100,9071179,31.134.0.120,1124.0,ATM,20,3505,438391984,CREDIT,0,act,2027-06-23,2024-07-29 10:58:35,459.28,out,550416.36
50101,9111757,188.0.166.15,1297.0,ATM,451,2834,438391984,CREDIT,0,act,2027-06-23,2024-08-05 01:29:27,459.03,payment,549957.33
50102,9327965,80.234.0.210,425.0,prtbl trm,30,4347,438391984,CREDIT,0,act,2027-06-23,2024-08-14 07:05:12,458.9,transfer,549498.43
50103,9348568,217.26.0.225,696.0,cash_out,451,3858,438391984,CREDIT,0,act,2027-06-23,2024-09-02 21:03:25,458.9,payment,549039.53
50104,9509524,217.26.0.225,696.0,cash_out,451,2900,438391984,CREDIT,0,act,2027-06-23,2024-09-29 04:39:37,459.23,payment,548580.3
50105,9524320,37.0.123.210,335.0,prtbl trm,25,4243,438391984,CREDIT,0,act,2027-06-23,2024-10-03 15:51:00,458.86,country_transfer,548121.44
50106,9780564,188.0.0.60,1210.0,ATM,20,2874,438391984,CREDIT,0,act,2027-06-23,2024-10-23 02:57:35,458.96,from_acc,547662.48
50107,1246749,88.210.0.135,353.0,cash_in,451,8330,654636970,DEBIT,0,act,2030-04-20,2022-03-05 02:09:43,502.17,payment,866548.83
50108,1293897,213.151.0.0,996.0,atm,25,2301,654636970,DEBIT,0,act,2030-04-20,2022-04-23 16:27:39,502.04,country_transfer,866046.79
50109,1342139,88.210.0.135,353.0,cash_in,451,3949,654636970,DEBIT,0,act,2030-04-20,2022-04-30 00:49:14,502.03,payment,865544.76
50110,1350623,194.156.0.180,35.0,cash_out,-1,5906,654636970,DEBIT,1,act,2030-04-20,2022-05-08 10:35:21,502.13,bad,865544.76
50111,1632171,94.243.0.135,108.0,cash_out,20,8330,654636970,DEBIT,0,act,2030-04-20,2022-07-26 01:08:35,502.06,from_acc,865042.7
50112,1663103,95.181.0.135,257.0,cash_in,10,9081,654636970,DEBIT,0,act,2030-04-20,2022-08-12 10:37:44,501.97,in,865544.67
50113,2123490,91.107.0.240,995.0,cash_in,10,7236,654636970,DEBIT,0,act,2030-04-20,2022-10-17 21:26:00,501.68,in,866046.35
50114,2152661,194.156.0.180,35.0,cash_out,30,4110,654636970,DEBIT,0,act,2030-04-20,2022-10-26 22:06:13,501.82,transfer,865544.53
50115,2166948,88.210.0.135,353.0,cash_in,30,8820,654636970,DEBIT,0,act,2030-04-20,2022-11-30 10:18:08,502.08,transfer,865042.45
50116,2206248,194.0.162.60,744.0,prtbl trm,451,2301,654636970,DEBIT,0,act,2030-04-20,2022-12-13 09:36:06,501.84,payment,864540.61
50117,2273874,188.162.0.120,962.0,ATM,20,7209,654636970,DEBIT,0,act,2030-04-20,2023-01-02 03:56:50,502.07,from_acc,864038.54
50118,2409492,46.0.2.225,198.0,ATM,10,7236,654636970,DEBIT,0,act,2030-04-20,2023-02-06 13:34:26,501.79,in_acc,864540.33
50119,2486340,194.0.162.60,744.0,prtbl trm,25,4912,654636970,DEBIT,0,act,2030-04-20,2023-02-14 12:56:02,501.93,country_transfer,864038.4
50120,2625557,46.0.128.225,716.0,ATM,10,1289,654636970,DEBIT,0,act,2030-04-20,2023-03-31 01:45:19,502.06,in,864540.46
50121,2667593,185.17.0.150,1061.0,cash_out,25,7209,654636970,DEBIT,0,act,2030-04-20,2023-05-03 05:48:10,501.98,diff_cntry,864038.48
50122,3092664,88.210.0.135,353.0,cash_in,25,4500,654636970,DEBIT,0,act,2030-04-20,2023-07-09 17:44:33,502.24,diff_cntry,863536.24
50123,3224027,194.0.162.60,744.0,prtbl trm,25,8820,654636970,DEBIT,0,act,2030-04-20,2023-08-02 07:27:16,501.85,diff_cntry,863034.39
50124,3378883,46.0.176.45,121.0,Portable term,-1,7114,654636970,DEBIT,1,act,2030-04-20,2023-10-09 14:30:40,502.13,bad,863034.39
50125,3759198,185.17.0.150,1061.0,cash_out,-1,2605,654636970,DEBIT,2,act,2030-04-20,2024-04-11 15:09:17,501.96,err,863034.39
50126,4261503,194.0.162.60,744.0,prtbl trm,-1,7236,654636970,DEBIT,3,blk,2030-04-20,2024-08-18 17:32:06,502.02,err_code,863034.39
50127,1244024,37.0.124.0,719.0,port_trm,25,5069,998717557,CREDIT,0,active,2030-09-18,2022-01-10 11:43:54,613.02,diff_cntry,865042.98
50128,1388564,188.191.0.225,1159.0,atm,20,8114,998717557,CREDIT,0,active,2030-09-18,2022-01-20 02:46:01,613.07,from_acc,864429.91
50129,1479186,79.104.0.135,645.0,ATM,20,1471,998717557,CREDIT,0,active,2030-09-18,2022-02-06 22:04:39,613.16,from_acc,863816.75
50130,1481316,195.143.0.60,1366.0,port_trm,30,1955,998717557,CREDIT,0,active,2030-09-18,2022-02-10 11:23:23,612.87,transfer,863203.88
50131,1553305,195.143.0.150,1377.0,ATM,30,1369,998717557,CREDIT,0,active,2030-09-18,2022-02-18 20:10:33,613.16,transfer,862590.72
50132,1578391,195.143.0.150,1377.0,ATM,30,1955,998717557,CREDIT,0,active,2030-09-18,2022-02-19 23:06:45,613.07,transfer,861977.65
50133,1759055,128.0.24.30,882.0,atm,451,1983,998717557,CREDIT,0,active,2030-09-18,2022-03-17 17:53:58,613.17,payment,861364.48
50134,2071376,195.143.0.60,1366.0,port_trm,451,5068,998717557,CREDIT,0,active,2030-09-18,2022-04-24 16:08:05,613.19,payment,860751.29
50135,2182659,151.0.38.75,393.0,cash_in,10,1945,998717557,CREDIT,0,active,2030-09-18,2022-04-26 08:51:35,613.01,add_on_acc,861364.3
50136,2650904,46.0.176.240,135.0,cash_out,20,5282,998717557,CREDIT,0,active,2030-09-18,2022-05-01 08:01:04,612.99,from_acc,860751.31
50137,2804299,188.162.0.225,971.0,port_trm,-1,1955,998717557,CREDIT,1,active,2030-09-18,2022-05-02 00:46:05,612.88,err_code,860751.31
50138,2899044,128.0.24.30,882.0,atm,25,6357,998717557,CREDIT,0,active,2030-09-18,2022-05-13 06:56:30,613.02,diff_cntry,860138.29
50139,3059705,195.143.0.60,1366.0,port_trm,30,8114,998717557,CREDIT,0,active,2030-09-18,2022-08-15 04:40:24,612.81,transfer,859525.48
50140,3382290,195.143.0.150,1377.0,ATM,-1,9080,998717557,CREDIT,1,active,2030-09-18,2022-08-21 16:51:19,612.77,bad,859525.48
50141,3797742,194.0.162.30,742.0,Portable term,-1,7751,998717557,CREDIT,2,active,2030-09-18,2022-09-09 22:29:25,613.11,bad,859525.48
50142,3870435,46.0.143.15,811.0,atm,10,1955,998717557,CREDIT,0,active,2030-09-18,2022-09-18 12:44:33,612.95,in_acc,860138.43
50143,4240690,193.0.151.195,71.0,cash_in,10,2080,998717557,CREDIT,0,active,2030-09-18,2022-09-21 17:57:30,613.14,in,860751.57
50144,4987393,195.143.0.150,1377.0,ATM,25,6275,998717557,CREDIT,0,active,2030-09-18,2022-10-27 02:10:16,612.72,country_transfer,860138.85
50145,5178218,46.173.0.120,503.0,ATM,20,8032,998717557,CREDIT,0,active,2030-09-18,2022-11-09 20:08:48,612.92,decrease_on_acc,859525.93
50146,5238468,195.143.0.150,1377.0,ATM,-1,4319,998717557,CREDIT,1,active,2030-09-18,2022-11-21 06:30:45,613.16,err,859525.93
50147,5498836,195.143.0.150,1377.0,ATM,30,1983,998717557,CREDIT,0,active,2030-09-18,2022-11-29 04:48:53,612.8,transfer,858913.13
50148,5646958,188.191.0.135,1150.0,atm,10,1471,998717557,CREDIT,0,active,2030-09-18,2022-12-29 13:06:00,613.05,add_on_acc,859526.18
50149,5670898,212.20.0.225,465.0,atm,30,8032,998717557,CREDIT,0,active,2030-09-18,2023-01-05 22:10:01,612.76,transfer,858913.42
50150,6108276,195.143.0.150,1377.0,ATM,30,2080,998717557,CREDIT,0,active,2030-09-18,2023-01-08 23:53:13,612.92,transfer,858300.5
50151,6171490,188.0.166.30,1298.0,ATM,20,4475,998717557,CREDIT,0,active,2030-09-18,2023-01-17 16:19:34,613.01,decrease_on_acc,857687.49
50152,6415642,188.0.166.90,1305.0,cash_out,20,5069,998717557,CREDIT,0,active,2030-09-18,2023-01-29 00:21:40,613.0,decrease_on_acc,857074.49
50153,6478966,195.143.0.60,1366.0,port_trm,25,9515,998717557,CREDIT,0,active,2030-09-18,2023-02-17 09:43:00,613.15,diff_cntry,856461.34
50154,6532093,195.143.0.150,1377.0,ATM,451,5068,998717557,CREDIT,0,active,2030-09-18,2023-02-28 12:55:57,612.94,payment,855848.4
50155,6591094,217.26.0.45,677.0,ATM,10,2080,998717557,CREDIT,0,active,2030-09-18,2023-03-12 21:34:17,612.78,in,856461.18
50156,6701503,195.143.0.150,1377.0,ATM,25,4475,998717557,CREDIT,0,active,2030-09-18,2023-04-13 21:18:09,612.97,country_transfer,855848.21
50157,6805615,79.104.0.75,641.0,atm,20,2415,998717557,CREDIT,0,active,2030-09-18,2023-05-31 15:54:10,613.01,from_acc,855235.2
50158,6892006,37.0.124.0,719.0,port_trm,-1,2415,998717557,CREDIT,1,active,2030-09-18,2023-07-28 11:44:19,613.12,err,855235.2
50159,7066850,194.0.162.30,742.0,Portable term,451,8032,998717557,CREDIT,0,active,2030-09-18,2023-08-02 01:43:45,613.2,payment,854622.0
50160,7349107,194.0.162.30,742.0,Portable term,30,6515,998717557,CREDIT,0,active,2030-09-18,2023-09-08 16:32:05,613.3,transfer,854008.7
50161,7404805,194.0.162.30,742.0,Portable term,25,4319,998717557,CREDIT,0,active,2030-09-18,2023-09-19 20:56:40,612.87,country_transfer,853395.83
50162,7428263,195.143.0.60,1366.0,port_trm,30,1955,998717557,CREDIT,0,active,2030-09-18,2023-10-23 17:24:56,612.94,transfer,852782.89
50163,7797981,128.0.24.30,882.0,atm,-1,5068,998717557,CREDIT,1,active,2030-09-18,2023-11-03 08:58:11,613.0,bad,852782.89
50164,7937527,95.106.0.90,550.0,atm,20,5282,998717557,CREDIT,0,active,2030-09-18,2023-12-05 04:30:13,613.16,out,852169.73
50165,8156755,37.0.124.0,719.0,port_trm,30,1945,998717557,CREDIT,0,active,2030-09-18,2023-12-27 22:08:22,613.01,transfer,851556.72
50166,8266694,128.0.24.30,882.0,atm,30,4475,998717557,CREDIT,0,active,2030-09-18,2024-01-03 14:34:47,613.04,transfer,850943.68
50167,8367275,62.118.0.45,523.0,cash_out,20,8114,998717557,CREDIT,0,active,2030-09-18,2024-03-26 06:10:19,613.02,out,850330.66
50168,8446829,128.0.24.30,882.0,atm,451,5068,998717557,CREDIT,0,active,2030-09-18,2024-04-02 15:00:40,613.47,payment,849717.19
50169,8515449,128.0.24.30,882.0,atm,451,1983,998717557,CREDIT,0,active,2030-09-18,2024-04-06 01:13:02,613.12,payment,849104.07
50170,8706601,212.20.0.225,465.0,atm,30,5068,998717557,CREDIT,0,active,2030-09-18,2024-04-21 16:47:05,612.87,transfer,848491.2
50171,8807171,195.143.0.150,1377.0,ATM,-1,5069,998717557,CREDIT,1,active,2030-09-18,2024-05-27 07:11:46,613.06,err,848491.2
50172,8866856,128.0.24.90,889.0,ATM,20,6515,998717557,CREDIT,0,active,2030-09-18,2024-07-11 20:19:54,612.72,decrease_on_acc,847878.48
50173,8916703,194.0.162.30,742.0,Portable term,451,1471,998717557,CREDIT,0,active,2030-09-18,2024-08-07 22:22:59,612.96,payment,847265.52
50174,8972398,62.118.0.75,525.0,ATM,10,1955,998717557,CREDIT,0,active,2030-09-18,2024-08-15 22:04:13,613.01,in,847878.53
50175,9163766,195.143.0.60,1366.0,port_trm,30,1700,998717557,CREDIT,0,active,2030-09-18,2024-08-18 02:31:33,612.88,transfer,847265.65
50176,9267331,128.0.24.30,882.0,atm,25,9515,998717557,CREDIT,0,active,2030-09-18,2024-09-26 03:08:53,612.86,country_transfer,846652.79
50177,9681099,5.189.0.180,871.0,ATM,10,6275,998717557,CREDIT,0,active,2030-09-18,2024-10-17 08:30:58,612.87,in_acc,847265.66
50178,9722624,195.143.0.150,1377.0,ATM,451,5282,998717557,CREDIT,0,active,2030-09-18,2024-11-08 17:15:27,613.31,payment,846652.35
50179,9959209,195.143.0.60,1366.0,port_trm,-1,9515,998717557,CREDIT,1,active,2030-09-18,2024-11-20 08:42:22,613.35,err_code,846652.35
50180,1049059,45.154.0.120,304.0,ATM,451,2165,410328814,DEBIT,0,active,2030-08-11,2022-03-13 18:00:18,1108.09,payment,308965.91
50181,1108605,45.154.0.120,304.0,ATM,30,1406,410328814,DEBIT,0,active,2030-08-11,2022-03-14 00:14:07,1107.8,transfer,307858.11
50182,1174255,188.18.0.30,223.0,cash_out,20,8406,410328814,DEBIT,0,active,2030-08-11,2022-03-16 15:49:41,1108.03,from_acc,306750.08
50183,1281132,46.0.2.30,183.0,cash_in,10,8494,410328814,DEBIT,0,active,2030-08-11,2022-04-10 10:13:26,1108.01,add_on_acc,307858.09
50184,1577930,217.26.0.90,681.0,cash_out,25,5769,410328814,DEBIT,0,active,2030-08-11,2022-04-18 13:38:33,1108.0,country_transfer,306750.09
50185,1714467,31.134.0.90,1122.0,cash_in,451,5183,410328814,DEBIT,0,active,2030-08-11,2022-04-28 23:48:25,1107.86,payment,305642.23
50186,1750002,31.134.0.90,1122.0,cash_in,25,1626,410328814,DEBIT,0,active,2030-08-11,2022-05-06 22:44:55,1108.03,diff_cntry,304534.2
50187,1958446,128.0.24.105,890.0,prtbl trm,-1,8406,410328814,DEBIT,1,active,2030-08-11,2022-05-31 04:59:09,1107.98,bad,304534.2
50188,2250698,151.0.38.150,400.0,port_trm,30,3099,410328814,DEBIT,0,active,2030-08-11,2022-06-03 13:55:40,1108.03,transfer,303426.17
50189,2507631,46.173.0.0,487.0,prtbl trm,25,8802,410328814,DEBIT,0,active,2030-08-11,2022-06-06 10:26:05,1108.11,country_transfer,302318.06
50190,2821784,79.104.0.0,634.0,cash_in,10,1215,410328814,DEBIT,0,active,2030-08-11,2022-06-30 16:05:18,1107.9,add_on_acc,303425.96
50191,2931776,62.118.0.135,531.0,ATM,10,1406,410328814,DEBIT,0,active,2030-08-11,2022-08-22 14:32:49,1108.1,in_acc,304534.06
50192,3336242,188.18.0.180,238.0,ATM,20,8802,410328814,DEBIT,0,active,2030-08-11,2022-09-15 12:53:49,1107.9,out,303426.16
50193,3551748,46.0.176.60,122.0,pos trm,25,7672,410328814,DEBIT,0,active,2030-08-11,2022-09-26 00:25:05,1108.11,diff_cntry,302318.05
50194,3574480,128.0.24.105,890.0,prtbl trm,451,7672,410328814,DEBIT,0,active,2030-08-11,2022-10-08 19:14:30,1108.08,payment,301209.97
50195,3811755,45.154.0.120,304.0,ATM,-1,2242,410328814,DEBIT,1,active,2030-08-11,2022-10-12 19:54:14,1107.93,bad,301209.97
50196,3846251,46.0.0.135,664.0,cash_out,20,1215,410328814,DEBIT,0,active,2030-08-11,2022-10-24 13:40:16,1107.91,decrease_on_acc,300102.06
50197,4072640,31.134.0.90,1122.0,cash_in,30,1626,410328814,DEBIT,0,active,2030-08-11,2022-12-07 13:19:43,1107.83,transfer,298994.23
50198,4217714,79.104.0.135,645.0,ATM,10,8406,410328814,DEBIT,0,active,2030-08-11,2022-12-11 03:34:34,1107.94,in,300102.17
50199,4468565,31.134.0.90,1122.0,cash_in,451,1215,410328814,DEBIT,0,active,2030-08-11,2022-12-19 05:01:39,1107.9,payment,298994.27
50200,4621265,46.0.8.90,144.0,cash_in,10,7496,410328814,DEBIT,0,active,2030-08-11,2022-12-29 17:02:39,1108.07,in,300102.34
50201,4651234,46.0.176.60,122.0,pos trm,451,1406,410328814,DEBIT,0,active,2030-08-11,2023-01-16 07:17:14,1107.88,payment,298994.46
50202,4832343,128.0.24.105,890.0,prtbl trm,30,8494,410328814,DEBIT,0,active,2030-08-11,2023-01-20 19:59:53,1107.92,transfer,297886.54
50203,5050495,80.234.0.240,428.0,ATM,20,8681,410328814,DEBIT,0,active,2030-08-11,2023-02-17 02:23:17,1108.11,decrease_on_acc,296778.43
50204,5572189,128.0.24.105,890.0,prtbl trm,-1,1215,410328814,DEBIT,1,active,2030-08-11,2023-02-26 04:28:29,1108.03,bad,296778.43
50205,5868844,46.0.123.90,917.0,atm,10,2165,410328814,DEBIT,0,active,2030-08-11,2023-03-02 10:28:25,1107.8,in_acc,297886.23
50206,6022407,31.134.0.90,1122.0,cash_in,451,7496,410328814,DEBIT,0,active,2030-08-11,2023-06-03 13:15:49,1107.99,payment,296778.24
50207,6293400,217.26.0.90,681.0,cash_out,30,2242,410328814,DEBIT,0,active,2030-08-11,2023-06-30 19:37:06,1108.02,transfer,295670.22
50208,6432156,188.0.169.150,479.0,cash_out,20,1419,410328814,DEBIT,0,active,2030-08-11,2023-08-10 12:17:59,1108.56,from_acc,294561.66
50209,6488881,45.154.0.120,304.0,ATM,25,2029,410328814,DEBIT,0,active,2030-08-11,2023-08-25 02:21:44,1108.04,diff_cntry,293453.62
50210,6674871,95.167.0.180,215.0,ATM,10,5769,410328814,DEBIT,0,active,2030-08-11,2023-10-02 16:05:21,1108.05,in_acc,294561.67
50211,6714552,217.26.0.90,681.0,cash_out,30,3678,410328814,DEBIT,0,active,2030-08-11,2023-10-05 07:33:59,1107.86,transfer,293453.81
50212,6962294,31.134.0.90,1122.0,cash_in,25,3099,410328814,DEBIT,0,active,2030-08-11,2023-10-29 14:34:48,1107.86,country_transfer,292345.95
50213,7046173,46.0.176.60,122.0,pos trm,451,3099,410328814,DEBIT,0,active,2030-08-11,2024-01-14 15:54:53,1108.06,payment,291237.89
50214,7175960,151.0.38.150,400.0,port_trm,-1,5769,410328814,DEBIT,1,active,2030-08-11,2024-01-21 05:27:50,1108.34,err_code,291237.89
50215,7332066,151.0.38.150,400.0,port_trm,30,5183,410328814,DEBIT,0,active,2030-08-11,2024-02-08 19:41:36,1108.13,transfer,290129.76
50216,7378985,46.8.0.180,781.0,cash_in,10,8681,410328814,DEBIT,0,active,2030-08-11,2024-02-27 13:45:01,1108.17,in_acc,291237.93
50217,7938708,45.154.0.120,304.0,ATM,451,5837,410328814,DEBIT,0,active,2030-08-11,2024-03-18 16:59:37,1107.93,payment,290130.0
50218,8010541,151.0.38.150,400.0,port_trm,-1,7672,410328814,DEBIT,1,active,2030-08-11,2024-03-22 18:32:58,1108.04,err,290130.0
50219,8348462,46.173.0.0,487.0,prtbl trm,-1,3099,410328814,DEBIT,2,active,2030-08-11,2024-04-19 00:54:39,1108.2,err_code,290130.0
50220,8544158,128.0.24.105,890.0,prtbl trm,451,3678,410328814,DEBIT,0,active,2030-08-11,2024-04-23 18:02:25,1108.21,payment,289021.79
50221,8553092,188.0.0.60,1210.0,ATM,10,7204,410328814,DEBIT,0,active,2030-08-11,2024-05-05 12:28:15,1108.13,add_on_acc,290129.92
50222,8968017,77.242.0.150,282.0,cash_out,20,7672,410328814,DEBIT,0,active,2030-08-11,2024-05-21 01:30:07,1108.09,decrease_on_acc,289021.83
50223,9137644,46.0.176.60,122.0,pos trm,30,1215,410328814,DEBIT,0,active,2030-08-11,2024-06-02 00:15:58,1107.98,transfer,287913.85
50224,9282217,45.154.0.120,304.0,ATM,25,1626,410328814,DEBIT,0,active,2030-08-11,2024-06-18 15:55:39,1107.84,diff_cntry,286806.01
50225,9629413,46.173.0.0,487.0,prtbl trm,-1,8802,410328814,DEBIT,1,active,2030-08-11,2024-06-22 14:41:09,1107.77,err,286806.01
50226,9762634,151.0.38.150,400.0,port_trm,30,3099,410328814,DEBIT,0,active,2030-08-11,2024-06-29 06:51:53,1108.04,transfer,285697.97
50227,9773478,45.154.0.120,304.0,ATM,451,1406,410328814,DEBIT,0,active,2030-08-11,2024-07-13 07:07:03,1107.82,payment,284590.15
50228,9968999,95.167.0.75,205.0,ATM,20,2165,410328814,DEBIT,0,active,2030-08-11,2024-07-27 01:16:46,1107.9,decrease_on_acc,283482.25
50229,9975992,46.0.176.60,122.0,pos trm,25,1419,410328814,DEBIT,0,active,2030-08-11,2024-11-27 00:07:13,1107.99,country_transfer,282374.26
50230,1240329,46.0.9.120,1325.0,ATM,20,4869,216807235,DEBIT,0,active,2030-05-25,2022-02-06 13:59:22,902.08,from_acc,680833.92
50231,1459286,78.24.158.129,942.0,ATM,451,1327,216807235,DEBIT,0,active,2030-05-25,2022-04-14 18:44:14,901.67,payment,679932.25
50232,1510668,85.140.0.225,1270.0,cash_in,10,8586,216807235,DEBIT,0,active,2030-05-25,2022-10-06 14:16:07,901.84,in,680834.09
50233,1644171,37.0.127.135,1032.0,port_trm,-1,9246,216807235,DEBIT,1,active,2030-05-25,2022-10-11 15:28:58,901.91,err_code,680834.09
50234,1739190,46.0.188.0,1226.0,cash_out,30,1689,216807235,DEBIT,0,active,2030-05-25,2023-01-26 20:27:03,902.07,transfer,679932.02
50235,1793028,86.111.0.195,1357.0,pos trm,30,3992,216807235,DEBIT,0,active,2030-05-25,2023-03-10 00:28:41,901.98,transfer,679030.04
50236,1807220,78.24.158.129,942.0,ATM,30,2206,216807235,DEBIT,0,active,2030-05-25,2023-09-07 22:07:23,902.03,transfer,678128.01
50237,2014582,45.154.0.75,300.0,ATM,20,3992,216807235,DEBIT,0,active,2030-05-25,2023-09-10 11:29:00,902.1,from_acc,677225.91
50238,2129449,78.24.158.174,945.0,cash_in,10,5653,216807235,DEBIT,0,active,2030-05-25,2023-11-30 15:47:00,901.99,in,678127.9
50239,2166850,95.106.0.75,549.0,cash_in,-1,2699,216807235,DEBIT,1,active,2030-05-25,2024-03-22 17:52:32,901.76,bad,678127.9
50240,2263918,5.189.0.240,877.0,cash_out,-1,3992,216807235,DEBIT,2,active,2030-05-25,2024-03-26 12:33:24,901.97,err,678127.9
50241,2502212,185.17.0.135,1060.0,cash_in,-1,2531,216807235,DEBIT,3,blk,2030-05-25,2024-04-07 23:19:15,901.8,bad,678127.9
50242,1112345,194.156.0.105,29.0,ATM,20,2107,852995547,DEBIT,0,active,2026-09-06,2022-02-09 00:50:01,1173.01,out,655888.99
50243,1173131,151.0.38.75,393.0,cash_in,30,5240,852995547,DEBIT,0,active,2026-09-06,2022-05-03 06:57:43,1172.75,transfer,654716.24
50244,1378706,194.0.162.0,739.0,cash_in,10,3853,852995547,DEBIT,0,active,2026-09-06,2022-05-11 09:57:55,1172.94,add_on_acc,655889.18
50245,1447075,95.167.0.0,200.0,ATM,10,5240,852995547,DEBIT,0,active,2026-09-06,2022-05-25 22:23:51,1173.23,add_on_acc,657062.41
50246,1458099,45.154.0.150,306.0,prtbl trm,30,2233,852995547,DEBIT,0,active,2026-09-06,2022-05-31 22:23:34,1172.91,transfer,655889.5
50247,1723856,151.0.38.225,406.0,cash_in,10,1658,852995547,DEBIT,0,active,2026-09-06,2022-06-03 07:58:56,1172.74,add_on_acc,657062.24
50248,1765634,195.161.0.135,1173.0,cash_in,10,4505,852995547,DEBIT,0,active,2026-09-06,2022-06-20 18:26:01,1172.94,add_on_acc,658235.18
50249,1784429,188.128.16.46,1186.0,cash_out,20,2107,852995547,DEBIT,0,active,2026-09-06,2022-08-25 01:35:24,1173.08,from_acc,657062.1
50250,2180632,188.128.16.211,1201.0,ATM,-1,4342,852995547,DEBIT,1,active,2026-09-06,2022-12-13 08:45:21,1172.84,err_code,657062.1
50251,2414349,151.0.38.75,393.0,cash_in,451,4342,852995547,DEBIT,0,active,2026-09-06,2022-12-18 14:41:13,1172.85,payment,655889.25
50252,2441420,193.0.151.195,71.0,cash_in,10,1658,852995547,DEBIT,0,active,2026-09-06,2022-12-30 04:47:51,1173.06,add_on_acc,657062.31
50253,2519287,188.128.16.211,1201.0,ATM,25,4505,852995547,DEBIT,0,active,2026-09-06,2023-01-10 09:56:10,1172.92,diff_cntry,655889.39
50254,2799494,188.128.16.211,1201.0,ATM,30,3847,852995547,DEBIT,0,active,2026-09-06,2023-01-16 00:46:00,1172.94,transfer,654716.45
50255,3080404,212.20.0.15,446.0,cash_in,10,4480,852995547,DEBIT,0,active,2026-09-06,2023-02-16 15:39:23,1172.81,in,655889.26
50256,3090264,45.154.0.150,306.0,prtbl trm,30,4342,852995547,DEBIT,0,active,2026-09-06,2023-02-19 05:33:16,1172.82,transfer,654716.44
50257,3228387,46.0.54.240,1093.0,atm,451,4820,852995547,DEBIT,0,active,2026-09-06,2023-03-14 14:31:40,1172.91,payment,653543.53
50258,3466136,46.0.54.240,1093.0,atm,30,9972,852995547,DEBIT,0,active,2026-09-06,2023-04-14 03:02:36,1172.9,transfer,652370.63
50259,3663418,188.128.16.211,1201.0,ATM,451,2233,852995547,DEBIT,0,active,2026-09-06,2023-04-22 16:20:09,1172.86,payment,651197.77
50260,3697960,31.134.0.240,1137.0,cash_in,25,4133,852995547,DEBIT,0,active,2026-09-06,2023-04-23 15:46:41,1172.98,diff_cntry,650024.79
50261,3843706,31.134.0.240,1137.0,cash_in,-1,2233,852995547,DEBIT,1,active,2026-09-06,2023-04-28 19:34:04,1172.93,bad,650024.79
50262,4165559,194.0.144.120,169.0,Portable term,451,2233,852995547,DEBIT,0,active,2026-09-06,2023-06-03 22:33:29,1173.18,payment,648851.61
50263,4189478,46.0.54.240,1093.0,atm,25,9972,852995547,DEBIT,0,active,2026-09-06,2023-06-08 17:46:28,1173.22,country_transfer,647678.39
50264,4409102,31.134.0.240,1137.0,cash_in,451,4480,852995547,DEBIT,0,active,2026-09-06,2023-06-12 19:04:56,1172.75,payment,646505.64
50265,4564147,134.0.98.30,792.0,cash_in,25,2107,852995547,DEBIT,0,active,2026-09-06,2023-07-01 23:53:00,1172.87,diff_cntry,645332.77
50266,4888222,31.134.0.240,1137.0,cash_in,30,3847,852995547,DEBIT,0,active,2026-09-06,2023-07-16 10:52:09,1173.28,transfer,644159.49
50267,5024928,188.128.16.211,1201.0,ATM,451,4133,852995547,DEBIT,0,active,2026-09-06,2023-12-16 22:55:00,1172.97,payment,642986.52
50268,5139641,46.0.128.90,705.0,cash_in,10,4133,852995547,DEBIT,0,active,2026-09-06,2023-12-28 12:44:06,1173.02,add_on_acc,644159.54
50269,5349930,46.0.54.240,1093.0,atm,451,3544,852995547,DEBIT,0,active,2026-09-06,2024-02-08 19:04:28,1172.94,payment,642986.6
50270,5366178,79.104.0.90,642.0,ATM,20,1980,852995547,DEBIT,0,active,2026-09-06,2024-03-22 13:03:12,1173.2,out,641813.4
50271,5604208,46.0.54.240,1093.0,atm,25,3544,852995547,DEBIT,0,active,2026-09-06,2024-04-11 07:16:54,1172.82,country_transfer,640640.58
50272,5731947,45.154.0.150,306.0,prtbl trm,451,3544,852995547,DEBIT,0,active,2026-09-06,2024-04-15 03:51:17,1172.77,payment,639467.81
50273,5941762,78.24.158.219,949.0,port_trm,-1,2233,852995547,DEBIT,1,active,2026-09-06,2024-05-06 02:24:05,1172.95,bad,639467.81
50274,6057053,78.24.158.219,949.0,port_trm,-1,5240,852995547,DEBIT,2,active,2026-09-06,2024-05-28 17:36:04,1172.96,bad,639467.81
50275,6158157,134.0.98.30,792.0,cash_in,30,3847,852995547,DEBIT,0,active,2026-09-06,2024-06-21 08:13:43,1173.09,transfer,638294.72
50276,6344587,217.112.0.165,1485.0,ATM,10,4133,852995547,DEBIT,0,active,2026-09-06,2024-08-16 14:32:42,1173.24,add_on_acc,639467.96
50277,6458101,78.24.158.219,949.0,port_trm,451,5240,852995547,DEBIT,0,active,2026-09-06,2024-08-20 09:24:46,1173.03,payment,638294.93
50278,6587424,188.128.16.211,1201.0,ATM,-1,4820,852995547,DEBIT,1,active,2026-09-06,2024-09-30 21:26:57,1172.95,bad,638294.93
50279,6671423,31.134.0.240,1137.0,cash_in,-1,1980,852995547,DEBIT,2,active,2026-09-06,2024-11-06 20:36:08,1173.01,err,638294.93
50280,6920687,78.24.158.219,949.0,port_trm,-1,4342,852995547,DEBIT,3,blk,2026-09-06,2024-11-13 17:35:38,1173.01,err_code,638294.93
50281,1021164,188.0.169.195,482.0,cash_in,451,3441,314372290,DEBIT,0,active,2027-02-18,2022-02-11 00:01:32,131.17,payment,231684.83
50282,1568533,195.161.0.210,1179.0,atm,-1,7358,314372290,DEBIT,1,active,2027-02-18,2022-02-26 21:04:43,130.89,bad,231684.83
50283,1573080,46.8.0.105,774.0,cash_out,20,6621,314372290,DEBIT,0,active,2027-02-18,2022-03-01 18:07:48,131.13,out,231553.7
50284,1909409,188.0.169.60,471.0,atm,10,7541,314372290,DEBIT,0,active,2027-02-18,2022-07-19 01:59:58,131.18,in_acc,231684.88
50285,1978907,188.191.0.135,1150.0,atm,-1,7541,314372290,DEBIT,1,active,2027-02-18,2022-07-27 13:16:56,131.04,err,231684.88
50286,2057041,188.0.169.195,482.0,cash_in,25,3492,314372290,DEBIT,0,active,2027-02-18,2022-08-07 22:56:09,131.09,country_transfer,231553.79
50287,2430141,188.0.169.195,482.0,cash_in,-1,7654,314372290,DEBIT,1,active,2027-02-18,2022-10-10 20:58:43,131.01,bad,231553.79
50288,2563577,188.191.0.135,1150.0,atm,25,7654,314372290,DEBIT,0,active,2027-02-18,2022-10-11 22:42:51,131.2,country_transfer,231422.59
50289,2606686,151.0.0.90,20.0,ATM,10,4783,314372290,DEBIT,0,active,2027-02-18,2022-10-18 23:48:26,131.18,in_acc,231553.77
50290,2656330,185.17.0.150,1061.0,cash_out,20,2864,314372290,DEBIT,0,active,2027-02-18,2022-10-24 03:26:00,131.06,out,231422.71
50291,2758307,188.0.189.15,832.0,pos trm,-1,2864,314372290,DEBIT,1,active,2027-02-18,2023-03-08 15:13:34,130.87,err,231422.71
50292,2777986,188.128.16.241,1205.0,atm,10,7071,314372290,DEBIT,0,active,2027-02-18,2023-04-30 04:12:11,130.95,in,231553.66
50293,2778881,109.126.0.60,369.0,cash_in,10,5750,314372290,DEBIT,0,active,2027-02-18,2023-08-05 07:33:23,130.95,add_on_acc,231684.61
50294,2934264,195.161.0.210,1179.0,atm,451,7071,314372290,DEBIT,0,active,2027-02-18,2023-12-10 10:08:26,131.08,payment,231553.53
50295,2962784,78.24.158.69,937.0,atm,20,9285,314372290,DEBIT,0,active,2027-02-18,2024-03-22 02:04:15,130.86,from_acc,231422.67
50296,3361594,46.173.0.105,502.0,atm,30,6621,314372290,DEBIT,0,active,2027-02-18,2024-05-17 13:40:47,130.89,transfer,231291.78
50297,3527791,45.154.0.90,302.0,cash_in,10,7358,314372290,DEBIT,0,active,2027-02-18,2024-07-10 13:45:36,131.12,in_acc,231422.9
50298,3991315,188.0.169.195,482.0,cash_in,-1,9307,314372290,DEBIT,1,active,2027-02-18,2024-09-27 08:59:25,131.15,bad,231422.9
50299,4009911,188.191.0.135,1150.0,atm,-1,8025,314372290,DEBIT,2,active,2027-02-18,2024-10-29 17:41:27,131.17,bad,231422.9
50300,4043142,195.161.0.210,1179.0,atm,-1,5750,314372290,DEBIT,3,blk,2027-02-18,2024-11-09 09:56:21,130.72,bad,231422.9
50301,1155920,193.31.0.135,599.0,ATM,10,1545,572375593,DEBIT,0,act,2027-02-07,2022-01-07 06:07:03,1156.84,in,163431.84
50302,1262788,45.154.0.15,294.0,pos trm,-1,5645,572375593,DEBIT,1,act,2027-02-07,2022-01-12 02:43:04,1156.86,bad,163431.84
50303,1274123,45.154.0.15,294.0,pos trm,25,1035,572375593,DEBIT,0,act,2027-02-07,2022-01-24 01:36:48,1157.1,country_transfer,162274.74
50304,1341701,91.107.0.240,995.0,cash_in,30,1035,572375593,DEBIT,0,act,2027-02-07,2022-02-07 05:39:18,1156.73,transfer,161118.01
50305,1645149,185.173.0.75,1278.0,ATM,20,7669,572375593,DEBIT,0,act,2027-02-07,2022-03-11 00:27:02,1157.08,decrease_on_acc,159960.93
50306,1704020,62.118.0.105,529.0,cash_out,20,5645,572375593,DEBIT,0,act,2027-02-07,2022-05-07 19:03:27,1157.21,decrease_on_acc,158803.72
50307,1731257,37.0.127.90,1028.0,prtbl trm,30,1035,572375593,DEBIT,0,act,2027-02-07,2022-05-10 19:16:42,1156.89,transfer,157646.83
50308,1788453,188.191.0.60,1143.0,prtbl trm,30,8742,572375593,DEBIT,0,act,2027-02-07,2022-05-31 16:20:10,1157.12,transfer,156489.71
50309,1982406,188.191.0.15,1140.0,ATM,20,3835,572375593,DEBIT,0,act,2027-02-07,2022-06-01 01:31:49,1156.66,from_acc,155333.05
50310,2401399,194.87.0.30,568.0,cash_in,10,7669,572375593,DEBIT,0,act,2027-02-07,2022-06-02 21:46:36,1156.67,in_acc,156489.72
50311,2570748,78.24.158.234,950.0,ATM,451,9759,572375593,DEBIT,0,act,2027-02-07,2022-06-14 19:41:40,1157.14,payment,155332.58
50312,2643340,91.107.0.240,995.0,cash_in,30,5645,572375593,DEBIT,0,act,2027-02-07,2022-06-30 04:30:38,1157.01,transfer,154175.57
50313,2894211,88.210.0.75,346.0,atm,20,3835,572375593,DEBIT,0,act,2027-02-07,2022-07-08 09:43:45,1157.25,decrease_on_acc,153018.32
50314,2899097,81.17.0.105,1391.0,cash_out,20,5127,572375593,DEBIT,0,act,2027-02-07,2022-07-10 18:26:52,1156.73,from_acc,151861.59
50315,3234624,45.154.0.15,294.0,pos trm,451,4320,572375593,DEBIT,0,act,2027-02-07,2022-07-15 21:07:59,1157.1,payment,150704.49
50316,3279787,95.167.0.15,201.0,cash_in,30,4894,572375593,DEBIT,0,act,2027-02-07,2022-08-20 01:21:30,1157.01,transfer,149547.48
50317,3345884,46.0.9.30,1319.0,cash_in,10,3934,572375593,DEBIT,0,act,2027-02-07,2022-09-25 16:29:32,1156.79,add_on_acc,150704.27
50318,3414052,188.191.0.60,1143.0,prtbl trm,-1,4370,572375593,DEBIT,1,act,2027-02-07,2022-10-14 15:51:40,1157.1,err,150704.27
50319,3445035,195.58.0.60,1429.0,ATM,10,9969,572375593,DEBIT,0,act,2027-02-07,2022-11-08 16:39:08,1157.16,in_acc,151861.43
50320,3841898,212.20.0.30,448.0,ATM,10,2775,572375593,DEBIT,0,act,2027-02-07,2022-12-21 19:58:45,1156.97,in_acc,153018.4
50321,4137974,45.154.0.15,294.0,pos trm,451,5645,572375593,DEBIT,0,act,2027-02-07,2023-01-24 21:26:45,1157.09,payment,151861.31
50322,4213781,78.24.158.234,950.0,ATM,451,8940,572375593,DEBIT,0,act,2027-02-07,2023-02-02 00:55:36,1156.79,payment,150704.52
50323,4224527,95.167.0.15,201.0,cash_in,451,2775,572375593,DEBIT,0,act,2027-02-07,2023-02-14 11:08:04,1156.85,payment,149547.67
50324,4463078,128.0.82.210,631.0,pos trm,451,4370,572375593,DEBIT,0,act,2027-02-07,2023-02-23 03:02:54,1157.01,payment,148390.66
50325,4570789,95.181.0.165,260.0,atm,10,3934,572375593,DEBIT,0,act,2027-02-07,2023-03-06 13:37:39,1156.81,add_on_acc,149547.47
50326,4977283,91.107.0.240,995.0,cash_in,25,5127,572375593,DEBIT,0,act,2027-02-07,2023-03-09 05:55:36,1156.87,diff_cntry,148390.6
50327,5159106,188.191.0.60,1143.0,prtbl trm,-1,8940,572375593,DEBIT,1,act,2027-02-07,2023-03-19 23:40:03,1157.04,err,148390.6
50328,5185502,45.154.0.15,294.0,pos trm,-1,3934,572375593,DEBIT,2,act,2027-02-07,2023-04-06 14:59:26,1157.17,err,148390.6
50329,5200646,37.0.127.90,1028.0,prtbl trm,30,1545,572375593,DEBIT,0,act,2027-02-07,2023-04-08 07:04:30,1156.83,transfer,147233.77
50330,5396566,213.151.0.195,1015.0,atm,10,6890,572375593,DEBIT,0,act,2027-02-07,2023-05-30 09:30:26,1156.92,in_acc,148390.69
50331,5451985,37.0.127.90,1028.0,prtbl trm,-1,3835,572375593,DEBIT,1,act,2027-02-07,2023-06-20 05:12:30,1156.85,err_code,148390.69
50332,5557393,45.154.0.15,294.0,pos trm,25,7669,572375593,DEBIT,0,act,2027-02-07,2023-07-27 22:01:09,1156.82,diff_cntry,147233.87
50333,5731090,46.0.188.135,1238.0,atm,10,7114,572375593,DEBIT,0,act,2027-02-07,2023-07-29 02:45:09,1157.01,in,148390.88
50334,5766585,128.0.82.210,631.0,pos trm,451,8742,572375593,DEBIT,0,act,2027-02-07,2023-08-01 17:53:10,1157.38,payment,147233.5
50335,5822080,188.191.0.60,1143.0,prtbl trm,25,7432,572375593,DEBIT,0,act,2027-02-07,2023-08-13 16:20:54,1157.09,country_transfer,146076.41
50336,5867401,37.0.127.90,1028.0,prtbl trm,25,5645,572375593,DEBIT,0,act,2027-02-07,2023-08-26 10:07:30,1156.88,country_transfer,144919.53
50337,6142137,37.0.127.90,1028.0,prtbl trm,451,6890,572375593,DEBIT,0,act,2027-02-07,2023-09-04 16:11:56,1156.84,payment,143762.69
50338,6179362,37.0.127.90,1028.0,prtbl trm,30,3835,572375593,DEBIT,0,act,2027-02-07,2023-09-06 14:44:10,1156.95,transfer,142605.74
50339,6461874,46.0.128.180,713.0,ATM,20,3934,572375593,DEBIT,0,act,2027-02-07,2023-09-14 16:16:56,1157.22,out,141448.52
50340,6615469,37.0.127.90,1028.0,prtbl trm,-1,1545,572375593,DEBIT,1,act,2027-02-07,2023-09-26 15:49:33,1157.26,err_code,141448.52
50341,6634643,45.154.0.15,294.0,pos trm,451,9785,572375593,DEBIT,0,act,2027-02-07,2023-10-06 17:22:13,1157.05,payment,140291.47
50342,6751064,88.210.0.135,353.0,cash_in,10,3934,572375593,DEBIT,0,act,2027-02-07,2023-11-07 13:05:21,1157.14,add_on_acc,141448.61
50343,6765570,91.107.0.240,995.0,cash_in,-1,8940,572375593,DEBIT,1,act,2027-02-07,2024-01-31 12:05:58,1157.11,bad,141448.61
50344,6971709,78.24.158.234,950.0,ATM,-1,3934,572375593,DEBIT,2,act,2027-02-07,2024-02-28 15:56:57,1156.97,bad,141448.61
50345,6994391,195.143.0.30,1364.0,atm,10,4370,572375593,DEBIT,0,act,2027-02-07,2024-03-21 08:05:58,1157.02,in,142605.63
50346,7091705,188.244.0.15,1449.0,ATM,10,9477,572375593,DEBIT,0,act,2027-02-07,2024-04-21 13:21:25,1156.6,add_on_acc,143762.23
50347,7282603,45.154.0.15,294.0,pos trm,451,1545,572375593,DEBIT,0,act,2027-02-07,2024-06-19 05:47:27,1156.91,payment,142605.32
50348,7486715,194.87.0.240,585.0,cash_out,20,4370,572375593,DEBIT,0,act,2027-02-07,2024-07-14 07:40:00,1156.97,from_acc,141448.35
50349,7777360,79.104.0.135,645.0,ATM,10,9759,572375593,DEBIT,0,act,2027-02-07,2024-08-13 15:36:24,1157.12,add_on_acc,142605.47
50350,7993281,85.140.0.30,1249.0,cash_out,20,8742,572375593,DEBIT,0,act,2027-02-07,2024-09-09 18:50:49,1157.04,out,141448.43
50351,8044637,217.26.0.45,677.0,ATM,20,2775,572375593,DEBIT,0,act,2027-02-07,2024-09-17 17:25:29,1156.97,decrease_on_acc,140291.46
50352,8072352,91.107.0.240,995.0,cash_in,-1,4894,572375593,DEBIT,1,act,2027-02-07,2024-09-19 00:31:04,1157.08,err,140291.46
50353,8303623,188.191.0.60,1143.0,prtbl trm,25,5645,572375593,DEBIT,0,act,2027-02-07,2024-09-24 05:09:34,1157.26,diff_cntry,139134.2
50354,9297422,45.154.0.15,294.0,pos trm,25,4894,572375593,DEBIT,0,act,2027-02-07,2024-10-10 11:11:08,1157.17,country_transfer,137977.03
50355,9306184,45.154.0.15,294.0,pos trm,451,4370,572375593,DEBIT,0,act,2027-02-07,2024-10-14 03:51:57,1156.92,payment,136820.11
50356,9740484,78.24.158.69,937.0,atm,10,4894,572375593,DEBIT,0,act,2027-02-07,2024-11-07 23:09:49,1157.11,in_acc,137977.22
50357,9923792,78.24.158.234,950.0,ATM,451,1327,572375593,DEBIT,0,act,2027-02-07,2024-11-28 02:22:41,1157.01,payment,136820.21
50358,1225223,45.154.0.210,314.0,atm,30,1708,954571357,DEBIT,0,act,2025-12-03,2022-02-12 17:48:12,972.87,transfer,380152.13
50359,1460912,188.43.0.75,1409.0,cash_in,30,8929,954571357,DEBIT,0,act,2025-12-03,2022-03-02 15:46:02,972.88,transfer,379179.25
50360,1986140,217.26.0.210,695.0,cash_out,20,1708,954571357,DEBIT,0,act,2025-12-03,2022-03-11 09:44:32,973.02,from_acc,378206.23
50361,2108455,195.58.0.135,1436.0,atm,20,2507,954571357,DEBIT,0,act,2025-12-03,2022-05-08 05:06:32,972.9,out,377233.33
50362,2238364,195.161.0.210,1179.0,atm,20,8929,954571357,DEBIT,0,act,2025-12-03,2022-05-12 05:15:01,972.76,decrease_on_acc,376260.57
50363,2482362,195.161.0.210,1179.0,atm,20,4259,954571357,DEBIT,0,act,2025-12-03,2022-05-27 01:44:12,972.87,out,375287.7
50364,2897396,188.43.0.75,1409.0,cash_in,451,8222,954571357,DEBIT,0,act,2025-12-03,2022-06-04 06:28:50,973.03,payment,374314.67
50365,3133044,81.17.0.240,1403.0,prtbl trm,25,2752,954571357,DEBIT,0,act,2025-12-03,2022-06-11 03:19:51,972.98,country_transfer,373341.69
50366,3153022,46.0.128.30,701.0,cash_out,20,5841,954571357,DEBIT,0,act,2025-12-03,2022-07-21 07:56:11,972.9,decrease_on_acc,372368.79
50367,3176494,45.154.0.210,314.0,atm,451,9272,954571357,DEBIT,0,act,2025-12-03,2022-09-03 09:13:08,972.91,payment,371395.88
50368,3353118,5.189.0.135,866.0,ATM,20,3679,954571357,DEBIT,0,act,2025-12-03,2022-09-05 18:21:32,972.95,from_acc,370422.93
50369,3355384,188.191.0.240,1160.0,ATM,10,9272,954571357,DEBIT,0,act,2025-12-03,2022-10-11 08:38:24,972.95,in_acc,371395.88
50370,3364453,81.17.0.240,1403.0,prtbl trm,-1,9272,954571357,DEBIT,1,act,2025-12-03,2022-10-18 21:43:29,973.02,bad,371395.88
50371,3552304,45.154.0.210,314.0,atm,25,2266,954571357,DEBIT,0,act,2025-12-03,2023-01-22 10:33:10,972.89,diff_cntry,370422.99
50372,3679991,213.151.0.135,1010.0,ATM,10,8368,954571357,DEBIT,0,act,2025-12-03,2023-02-03 15:45:17,973.32,in_acc,371396.31
50373,3756881,188.43.0.75,1409.0,cash_in,25,5841,954571357,DEBIT,0,act,2025-12-03,2023-02-11 05:42:11,972.99,country_transfer,370423.32
50374,3828126,5.189.0.165,869.0,cash_out,451,6546,954571357,DEBIT,0,act,2025-12-03,2023-02-21 20:25:59,972.95,payment,369450.37
50375,3866849,213.151.0.135,1010.0,ATM,20,5449,954571357,DEBIT,0,act,2025-12-03,2023-03-07 20:11:18,973.09,from_acc,368477.28
50376,4045969,188.43.0.165,1416.0,port_trm,451,9634,954571357,DEBIT,0,act,2025-12-03,2023-03-16 21:17:39,973.07,payment,367504.21
50377,4089974,194.87.0.165,577.0,atm,10,2507,954571357,DEBIT,0,act,2025-12-03,2023-04-15 15:48:06,972.8,in_acc,368477.01
50378,4293989,85.140.0.240,1271.0,ATM,10,2185,954571357,DEBIT,0,act,2025-12-03,2023-04-18 01:43:01,972.89,add_on_acc,369449.9
50379,4301738,45.154.0.75,300.0,ATM,451,3257,954571357,DEBIT,0,act,2025-12-03,2023-05-25 22:11:12,972.76,payment,368477.14
50380,4310389,188.43.0.165,1416.0,port_trm,-1,2507,954571357,DEBIT,1,act,2025-12-03,2023-06-07 11:10:56,973.0,err_code,368477.14
50381,4430182,91.107.0.210,993.0,atm,10,8368,954571357,DEBIT,0,act,2025-12-03,2023-06-09 21:49:39,972.96,in,369450.1
50382,4590090,45.154.0.210,314.0,atm,451,9634,954571357,DEBIT,0,act,2025-12-03,2023-06-15 06:09:39,973.06,payment,368477.04
50383,4627552,45.154.0.210,314.0,atm,451,2752,954571357,DEBIT,0,act,2025-12-03,2023-07-08 18:36:04,972.91,payment,367504.13
50384,5224128,45.154.0.210,314.0,atm,-1,2266,954571357,DEBIT,1,act,2025-12-03,2023-08-08 18:58:32,972.9,err_code,367504.13
50385,5747026,86.111.0.225,1359.0,cash_out,20,9582,954571357,DEBIT,0,act,2025-12-03,2023-09-16 04:22:41,973.17,from_acc,366530.96
50386,6080629,5.189.0.165,869.0,cash_out,30,9634,954571357,DEBIT,0,act,2025-12-03,2023-09-21 01:36:42,973.27,transfer,365557.69
50387,6138934,188.43.0.165,1416.0,port_trm,30,8589,954571357,DEBIT,0,act,2025-12-03,2023-09-26 20:34:07,972.77,transfer,364584.92
50388,6299046,185.173.0.15,1273.0,ATM,451,7445,954571357,DEBIT,0,act,2025-12-03,2023-10-11 01:39:26,972.98,payment,363611.94
50389,6384436,188.43.0.165,1416.0,port_trm,-1,7445,954571357,DEBIT,1,act,2025-12-03,2023-11-18 18:47:57,972.98,bad,363611.94
50390,6566362,128.0.24.15,880.0,cash_in,10,9634,954571357,DEBIT,0,act,2025-12-03,2023-11-25 03:57:39,973.06,in_acc,364585.0
50391,6623712,86.111.0.180,1356.0,cash_out,20,9754,954571357,DEBIT,0,act,2025-12-03,2023-12-10 14:04:16,973.1,decrease_on_acc,363611.9
50392,6647769,45.154.0.75,300.0,ATM,-1,5035,954571357,DEBIT,1,act,2025-12-03,2024-01-05 17:04:49,972.93,bad,363611.9
50393,6777156,109.126.0.240,385.0,cash_in,30,2266,954571357,DEBIT,0,act,2025-12-03,2024-01-18 09:39:21,973.04,transfer,362638.86
50394,7109220,188.191.0.15,1140.0,ATM,20,9397,954571357,DEBIT,0,act,2025-12-03,2024-01-26 02:07:16,972.99,from_acc,361665.87
50395,7202216,195.143.0.0,1361.0,cash_out,20,9272,954571357,DEBIT,0,act,2025-12-03,2024-01-26 10:29:08,972.92,out,360692.95
50396,7246874,78.24.158.24,931.0,ATM,20,9441,954571357,DEBIT,0,act,2025-12-03,2024-02-05 18:17:00,973.11,decrease_on_acc,359719.84
50397,7249514,185.173.0.15,1273.0,ATM,25,2266,954571357,DEBIT,0,act,2025-12-03,2024-02-25 00:36:01,973.09,diff_cntry,358746.75
50398,7311572,45.154.0.210,314.0,atm,-1,7445,954571357,DEBIT,1,act,2025-12-03,2024-03-27 09:38:54,972.95,bad,358746.75
50399,7325243,5.189.0.165,869.0,cash_out,30,8368,954571357,DEBIT,0,act,2025-12-03,2024-04-17 02:35:20,972.84,transfer,357773.91
50400,7331487,188.43.0.165,1416.0,port_trm,30,9754,954571357,DEBIT,0,act,2025-12-03,2024-04-26 02:20:44,973.29,transfer,356800.62
50401,7845256,5.189.0.165,869.0,cash_out,25,9754,954571357,DEBIT,0,act,2025-12-03,2024-05-06 07:20:19,972.96,country_transfer,355827.66
50402,7971583,81.17.0.240,1403.0,prtbl trm,451,3375,954571357,DEBIT,0,act,2025-12-03,2024-05-07 10:15:21,973.07,payment,354854.59
50403,7991704,188.0.166.60,1303.0,atm,10,2185,954571357,DEBIT,0,act,2025-12-03,2024-05-15 06:50:54,973.08,in_acc,355827.67
50404,8802035,5.189.0.165,869.0,cash_out,30,6546,954571357,DEBIT,0,act,2025-12-03,2024-07-22 01:11:36,972.92,transfer,354854.75
50405,8893802,81.17.0.240,1403.0,prtbl trm,30,7445,954571357,DEBIT,0,act,2025-12-03,2024-08-04 22:54:09,973.07,transfer,353881.68
50406,8941414,45.154.0.210,314.0,atm,451,9754,954571357,DEBIT,0,act,2025-12-03,2024-08-30 16:42:33,972.88,payment,352908.8
50407,8998048,109.126.0.240,385.0,cash_in,30,2216,954571357,DEBIT,0,act,2025-12-03,2024-09-30 16:08:37,972.97,transfer,351935.83
50408,9021745,213.151.0.0,996.0,atm,20,3679,954571357,DEBIT,0,act,2025-12-03,2024-10-08 14:36:25,972.9,out,350962.93
50409,9033998,85.140.0.165,1264.0,atm,10,6546,954571357,DEBIT,0,act,2025-12-03,2024-10-19 20:54:23,972.79,in_acc,351935.72
50410,9154154,45.154.0.210,314.0,atm,10,6546,954571357,DEBIT,0,act,2025-12-03,2024-10-29 00:52:34,972.91,in_acc,352908.63
50411,1299645,185.233.0.210,94.0,pos trm,25,8965,722863944,CREDIT,0,active,2028-05-21,2022-02-22 16:37:20,1037.15,country_transfer,993890.85
50412,1481534,128.0.94.150,1109.0,prtbl trm,451,5675,722863944,CREDIT,0,active,2028-05-21,2022-03-27 21:31:11,1037.05,payment,992853.8
50413,1531528,194.0.144.165,174.0,pos trm,451,6978,722863944,CREDIT,0,active,2028-05-21,2022-04-08 22:30:10,1036.95,payment,991816.85
50414,1640425,46.0.54.195,1089.0,atm,10,1409,722863944,CREDIT,0,active,2028-05-21,2022-04-08 22:59:29,1036.86,in,992853.71
50415,1822270,88.210.0.45,343.0,cash_in,10,4810,722863944,CREDIT,0,active,2028-05-21,2022-04-10 06:36:37,1037.16,add_on_acc,993890.87
50416,2037261,217.26.0.30,676.0,port_trm,451,5784,722863944,CREDIT,0,active,2028-05-21,2022-04-15 01:47:19,1036.74,payment,992854.13
50417,2241881,188.18.0.120,231.0,port_trm,451,5784,722863944,CREDIT,0,active,2028-05-21,2022-04-18 22:55:07,1036.93,payment,991817.2
50418,2247922,128.0.94.150,1109.0,prtbl trm,30,6978,722863944,CREDIT,0,active,2028-05-21,2022-04-27 02:28:25,1036.66,transfer,990780.54
50419,2664814,188.18.0.120,231.0,port_trm,451,8918,722863944,CREDIT,0,active,2028-05-21,2022-05-31 01:14:23,1037.1,payment,989743.44
50420,3084488,128.0.94.150,1109.0,prtbl trm,25,6978,722863944,CREDIT,0,active,2028-05-21,2022-06-11 04:30:25,1037.1,diff_cntry,988706.34
50421,3178704,79.104.60.240,444.0,cash_out,20,5675,722863944,CREDIT,0,active,2028-05-21,2022-07-27 00:15:20,1037.0,decrease_on_acc,987669.34
50422,3314118,188.18.0.120,231.0,port_trm,451,3484,722863944,CREDIT,0,active,2028-05-21,2022-08-14 10:28:58,1037.11,payment,986632.23
50423,3385759,188.18.0.120,231.0,port_trm,451,6423,722863944,CREDIT,0,active,2028-05-21,2022-10-07 16:25:19,1036.86,payment,985595.37
50424,3716001,193.31.0.180,603.0,ATM,10,8965,722863944,CREDIT,0,active,2028-05-21,2022-10-15 14:32:13,1037.05,add_on_acc,986632.42
50425,3761080,128.0.94.150,1109.0,prtbl trm,451,5691,722863944,CREDIT,0,active,2028-05-21,2022-10-18 04:39:00,1036.82,payment,985595.6
50426,3802578,86.111.0.75,1349.0,pos trm,-1,5331,722863944,CREDIT,1,active,2028-05-21,2023-01-31 07:27:13,1037.07,err,985595.6
50427,3847315,195.161.0.165,1175.0,cash_out,20,5675,722863944,CREDIT,0,active,2028-05-21,2023-02-01 21:19:23,1037.06,out,984558.54
50428,3968955,185.233.0.210,94.0,pos trm,30,5784,722863944,CREDIT,0,active,2028-05-21,2023-02-06 04:31:48,1036.93,transfer,983521.61
50429,4237965,128.0.94.150,1109.0,prtbl trm,25,5331,722863944,CREDIT,0,active,2028-05-21,2023-02-23 04:59:20,1037.08,country_transfer,982484.53
50430,4980659,193.0.151.105,59.0,ATM,20,6978,722863944,CREDIT,0,active,2028-05-21,2023-04-02 09:13:28,1037.11,from_acc,981447.42
50431,5245049,194.0.144.165,174.0,pos trm,25,5784,722863944,CREDIT,0,active,2028-05-21,2023-04-20 22:40:28,1037.06,diff_cntry,980410.36
50432,5262129,188.18.0.120,231.0,port_trm,451,4810,722863944,CREDIT,0,active,2028-05-21,2023-06-22 01:22:57,1036.9,payment,979373.46
50433,5294347,188.18.0.120,231.0,port_trm,25,7239,722863944,CREDIT,0,active,2028-05-21,2023-08-23 16:45:47,1036.84,country_transfer,978336.62
50434,5356720,188.18.0.120,231.0,port_trm,-1,6282,722863944,CREDIT,1,active,2028-05-21,2023-08-29 17:32:14,1037.12,bad,978336.62
50435,5505399,217.26.0.30,676.0,port_trm,25,4810,722863944,CREDIT,0,active,2028-05-21,2023-09-01 15:33:35,1036.94,country_transfer,977299.68
50436,5517171,45.154.0.60,299.0,cash_in,10,1835,722863944,CREDIT,0,active,2028-05-21,2023-09-08 16:24:20,1036.87,in_acc,978336.55
50437,5868919,188.18.0.120,231.0,port_trm,451,5331,722863944,CREDIT,0,active,2028-05-21,2023-10-06 16:10:37,1036.91,payment,977299.64
50438,5900585,188.0.166.210,1314.0,cash_out,20,2025,722863944,CREDIT,0,active,2028-05-21,2023-10-15 03:52:43,1037.03,from_acc,976262.61
50439,6410793,86.111.0.75,1349.0,pos trm,-1,6776,722863944,CREDIT,1,active,2028-05-21,2023-11-01 11:45:13,1037.01,err_code,976262.61
50440,6481342,86.111.0.75,1349.0,pos trm,-1,1549,722863944,CREDIT,2,active,2028-05-21,2023-11-29 18:54:08,1037.35,bad,976262.61
50441,7220276,95.106.0.165,558.0,ATM,20,1409,722863944,CREDIT,0,active,2028-05-21,2023-12-02 11:49:14,1036.94,from_acc,975225.67
50442,7560713,217.26.0.30,676.0,port_trm,25,6776,722863944,CREDIT,0,active,2028-05-21,2023-12-14 06:08:29,1036.84,country_transfer,974188.83
50443,7745486,86.111.0.75,1349.0,pos trm,25,6282,722863944,CREDIT,0,active,2028-05-21,2023-12-31 20:39:44,1036.98,diff_cntry,973151.85
50444,8093622,46.0.123.15,910.0,ATM,10,4810,722863944,CREDIT,0,active,2028-05-21,2024-02-11 20:17:34,1037.02,in,974188.87
50445,8320161,188.0.169.0,467.0,atm,10,7027,722863944,CREDIT,0,active,2028-05-21,2024-03-01 02:22:39,1036.96,in,975225.83
50446,8564734,37.0.127.195,1036.0,cash_in,10,6776,722863944,CREDIT,0,active,2028-05-21,2024-03-03 10:15:07,1037.05,add_on_acc,976262.88
50447,8679310,128.0.94.150,1109.0,prtbl trm,451,8417,722863944,CREDIT,0,active,2028-05-21,2024-03-15 06:53:37,1037.0,payment,975225.88
50448,8692601,185.233.0.210,94.0,pos trm,30,1835,722863944,CREDIT,0,active,2028-05-21,2024-03-31 09:14:34,1037.2,transfer,974188.68
50449,8906414,128.0.94.150,1109.0,prtbl trm,25,9086,722863944,CREDIT,0,active,2028-05-21,2024-04-09 14:53:47,1037.06,diff_cntry,973151.62
50450,9107227,128.0.94.150,1109.0,prtbl trm,451,5718,722863944,CREDIT,0,active,2028-05-21,2024-04-12 17:11:13,1037.12,payment,972114.5
50451,9110527,188.18.0.120,231.0,port_trm,25,2025,722863944,CREDIT,0,active,2028-05-21,2024-04-14 00:55:15,1037.05,country_transfer,971077.45
50452,9198639,86.111.0.75,1349.0,pos trm,25,7239,722863944,CREDIT,0,active,2028-05-21,2024-04-24 16:28:34,1037.14,country_transfer,970040.31
50453,9454733,86.111.0.75,1349.0,pos trm,30,6776,722863944,CREDIT,0,active,2028-05-21,2024-05-24 03:29:13,1036.92,transfer,969003.39
50454,9562437,185.233.0.210,94.0,pos trm,30,7027,722863944,CREDIT,0,active,2028-05-21,2024-08-16 08:25:20,1037.26,transfer,967966.13
50455,9607378,217.26.0.30,676.0,port_trm,-1,6776,722863944,CREDIT,1,active,2028-05-21,2024-09-14 05:17:32,1037.12,bad,967966.13
50456,9664722,128.0.94.150,1109.0,prtbl trm,-1,5675,722863944,CREDIT,2,active,2028-05-21,2024-09-20 07:17:03,1036.62,err_code,967966.13
50457,9708967,217.26.0.30,676.0,port_trm,451,6978,722863944,CREDIT,0,active,2028-05-21,2024-09-24 15:26:28,1036.88,payment,966929.25
50458,9815767,128.0.94.150,1109.0,prtbl trm,30,8965,722863944,CREDIT,0,active,2028-05-21,2024-10-05 01:33:30,1036.97,transfer,965892.28
50459,9830164,128.0.94.150,1109.0,prtbl trm,451,5675,722863944,CREDIT,0,active,2028-05-21,2024-10-08 09:06:18,1037.32,payment,964854.96
50460,9876511,188.0.166.165,1311.0,cash_out,20,2025,722863944,CREDIT,0,active,2028-05-21,2024-11-04 01:53:56,1036.66,decrease_on_acc,963818.3
50461,9973661,86.111.0.75,1349.0,pos trm,30,9086,722863944,CREDIT,0,active,2028-05-21,2024-11-11 10:24:47,1037.0,transfer,962781.3
50462,1060733,109.126.0.150,376.0,atm,20,6446,113138243,DEBIT,0,active,2028-05-16,2022-02-19 16:07:14,249.92,decrease_on_acc,391081.08
50463,1100779,46.0.9.225,1338.0,ATM,20,6705,113138243,DEBIT,0,active,2028-05-16,2022-02-26 23:54:55,249.95,from_acc,390831.13
50464,1433593,188.191.0.15,1140.0,ATM,10,7999,113138243,DEBIT,0,active,2028-05-16,2022-04-15 09:19:50,250.23,in_acc,391081.36
50465,1861902,37.0.127.180,1035.0,atm,10,7944,113138243,DEBIT,0,active,2028-05-16,2022-04-16 09:40:01,250.14,in,391331.5
50466,2038575,188.43.0.195,1419.0,cash_in,30,5177,113138243,DEBIT,0,active,2028-05-16,2022-05-16 10:52:47,250.12,transfer,391081.38
50467,2192886,194.0.162.45,743.0,prtbl trm,30,1411,113138243,DEBIT,0,active,2028-05-16,2022-06-05 14:56:51,249.81,transfer,390831.57
50468,2432778,81.17.0.180,1399.0,ATM,20,1587,113138243,DEBIT,0,active,2028-05-16,2022-06-25 21:07:52,249.97,out,390581.6
50469,2634973,194.0.162.45,743.0,prtbl trm,451,1823,113138243,DEBIT,0,active,2028-05-16,2022-07-01 03:28:58,250.08,payment,390331.52
50470,2800687,37.0.123.195,334.0,ATM,20,1655,113138243,DEBIT,0,active,2028-05-16,2022-07-09 17:13:15,249.99,out,390081.53
50471,2814638,31.134.0.45,1119.0,atm,10,2715,113138243,DEBIT,0,active,2028-05-16,2022-07-17 08:02:55,250.1,add_on_acc,390331.63
50472,2845058,134.0.98.45,794.0,cash_out,20,3326,113138243,DEBIT,0,active,2028-05-16,2022-08-11 06:01:54,250.03,decrease_on_acc,390081.6
50473,3020131,79.104.60.225,443.0,cash_out,30,1823,113138243,DEBIT,0,active,2028-05-16,2022-08-15 03:15:50,249.92,transfer,389831.68
50474,3211623,37.0.123.30,320.0,cash_in,25,1655,113138243,DEBIT,0,active,2028-05-16,2022-09-06 11:38:23,250.1,diff_cntry,389581.58
50475,3494147,46.0.2.45,184.0,ATM,10,3326,113138243,DEBIT,0,active,2028-05-16,2022-09-23 21:03:53,250.07,add_on_acc,389831.65
50476,3597344,95.167.0.75,205.0,ATM,20,9475,113138243,DEBIT,0,active,2028-05-16,2022-09-26 09:28:01,250.17,out,389581.48
50477,3665845,188.0.166.0,1296.0,port_trm,-1,9865,113138243,DEBIT,1,active,2028-05-16,2022-10-08 08:21:13,250.06,err_code,389581.48
50478,3823396,78.24.158.189,947.0,cash_out,20,2928,113138243,DEBIT,0,active,2028-05-16,2022-10-17 16:26:39,250.04,decrease_on_acc,389331.44
50479,3870353,37.0.123.30,320.0,cash_in,451,1411,113138243,DEBIT,0,active,2028-05-16,2022-11-05 00:05:30,250.0,payment,389081.44
50480,3873121,195.161.0.195,1177.0,prtbl trm,451,6705,113138243,DEBIT,0,active,2028-05-16,2022-11-13 06:15:27,249.83,payment,388831.61
50481,4042199,188.0.166.0,1296.0,port_trm,30,2928,113138243,DEBIT,0,active,2028-05-16,2022-11-14 17:19:44,250.12,transfer,388581.49
50482,4057547,37.0.123.30,320.0,cash_in,30,1536,113138243,DEBIT,0,active,2028-05-16,2022-12-11 06:07:23,249.84,transfer,388331.65
50483,4073513,46.0.0.210,670.0,ATM,10,2386,113138243,DEBIT,0,active,2028-05-16,2023-02-10 08:09:24,250.15,in,388581.8
50484,4096563,78.24.158.99,939.0,atm,20,7999,113138243,DEBIT,0,active,2028-05-16,2023-03-05 06:05:55,249.89,out,388331.91
50485,4346829,79.104.60.225,443.0,cash_out,25,6705,113138243,DEBIT,0,active,2028-05-16,2023-03-10 07:23:22,250.16,country_transfer,388081.75
50486,4551564,194.0.162.45,743.0,prtbl trm,451,6705,113138243,DEBIT,0,active,2028-05-16,2023-03-11 03:55:35,250.01,payment,387831.74
50487,4662855,91.107.0.90,982.0,prtbl trm,25,7999,113138243,DEBIT,0,active,2028-05-16,2023-03-22 08:27:42,249.96,diff_cntry,387581.78
50488,4691221,79.104.60.225,443.0,cash_out,451,6446,113138243,DEBIT,0,active,2028-05-16,2023-03-26 05:05:48,250.09,payment,387331.69
50489,4992458,188.0.169.0,467.0,atm,20,6705,113138243,DEBIT,0,active,2028-05-16,2023-05-31 11:41:57,249.9,decrease_on_acc,387081.79
50490,5447385,45.154.0.120,304.0,ATM,10,7705,113138243,DEBIT,0,active,2028-05-16,2023-07-05 22:56:11,249.99,add_on_acc,387331.78
50491,5461834,185.173.0.60,1277.0,cash_out,20,2715,113138243,DEBIT,0,active,2028-05-16,2023-09-01 09:29:45,249.98,out,387081.8
50492,5506626,134.0.98.180,804.0,atm,10,2715,113138243,DEBIT,0,active,2028-05-16,2023-10-21 05:30:15,249.82,add_on_acc,387331.62
50493,5645802,188.0.166.0,1296.0,port_trm,451,9782,113138243,DEBIT,0,active,2028-05-16,2023-12-10 08:07:03,249.92,payment,387081.7
50494,5705397,188.0.166.15,1297.0,ATM,10,7944,113138243,DEBIT,0,active,2028-05-16,2023-12-11 23:58:13,249.97,in,387331.67
50495,5762697,213.151.0.0,996.0,atm,-1,5177,113138243,DEBIT,1,active,2028-05-16,2023-12-24 13:05:53,250.1,err_code,387331.67
50496,5992654,5.189.0.150,867.0,ATM,20,2386,113138243,DEBIT,0,active,2028-05-16,2024-01-07 14:17:40,249.8,from_acc,387081.87
50497,7032996,195.161.0.195,1177.0,prtbl trm,-1,1411,113138243,DEBIT,1,active,2028-05-16,2024-01-17 18:05:54,250.05,bad,387081.87
50498,7137335,46.0.143.30,812.0,atm,20,2386,113138243,DEBIT,0,active,2028-05-16,2024-02-08 23:22:49,250.05,from_acc,386831.82
50499,7177769,194.0.162.45,743.0,prtbl trm,25,7705,113138243,DEBIT,0,active,2028-05-16,2024-02-25 15:38:17,249.99,country_transfer,386581.83
50500,7192254,91.107.0.90,982.0,prtbl trm,25,1411,113138243,DEBIT,0,active,2028-05-16,2024-03-06 10:48:57,250.0,diff_cntry,386331.83
50501,7310292,194.87.0.60,570.0,cash_out,20,7944,113138243,DEBIT,0,active,2028-05-16,2024-03-16 15:30:08,249.95,out,386081.88
50502,7478826,195.161.0.195,1177.0,prtbl trm,25,5177,113138243,DEBIT,0,active,2028-05-16,2024-05-11 18:31:43,250.13,diff_cntry,385831.75
50503,7740407,37.0.123.30,320.0,cash_in,451,7999,113138243,DEBIT,0,active,2028-05-16,2024-05-17 15:40:03,250.09,payment,385581.66
50504,7827200,37.0.123.30,320.0,cash_in,451,1655,113138243,DEBIT,0,active,2028-05-16,2024-06-23 21:11:53,250.0,payment,385331.66
50505,8190147,217.112.0.30,1474.0,ATM,10,7999,113138243,DEBIT,0,active,2028-05-16,2024-07-07 19:24:24,249.88,in_acc,385581.54
50506,8754521,188.0.166.0,1296.0,port_trm,25,7999,113138243,DEBIT,0,active,2028-05-16,2024-07-12 19:11:25,250.09,country_transfer,385331.45
50507,8828565,188.0.189.0,831.0,cash_in,10,4396,113138243,DEBIT,0,active,2028-05-16,2024-08-04 18:13:20,250.17,in,385581.62
50508,9117355,77.242.0.210,287.0,atm,20,2928,113138243,DEBIT,0,active,2028-05-16,2024-08-20 22:47:19,249.81,decrease_on_acc,385331.81
50509,9706758,37.0.123.30,320.0,cash_in,25,7999,113138243,DEBIT,0,active,2028-05-16,2024-08-24 16:56:26,249.99,diff_cntry,385081.82
50510,9735772,188.0.166.0,1296.0,port_trm,30,2715,113138243,DEBIT,0,active,2028-05-16,2024-10-03 11:19:00,250.11,transfer,384831.71
50511,9850547,195.161.0.195,1177.0,prtbl trm,25,2715,113138243,DEBIT,0,active,2028-05-16,2024-11-11 07:03:08,249.94,diff_cntry,384581.77
50512,9873200,79.104.0.135,645.0,ATM,20,2163,113138243,DEBIT,0,active,2028-05-16,2024-11-14 07:00:58,249.74,from_acc,384332.03
50513,1835400,195.58.0.105,1434.0,ATM,10,8769,459383836,CREDIT,0,active,2026-06-10,2022-01-02 05:59:20,547.94,add_on_acc,338795.94
50514,1847411,37.0.123.15,319.0,atm,30,9334,459383836,CREDIT,0,active,2026-06-10,2022-01-15 13:29:18,547.79,transfer,338248.15
50515,1853953,194.156.0.150,32.0,pos trm,25,5449,459383836,CREDIT,0,active,2026-06-10,2022-01-15 14:34:21,548.17,country_transfer,337699.98
50516,1908183,95.167.0.225,218.0,ATM,-1,7338,459383836,CREDIT,1,active,2026-06-10,2022-01-20 16:22:04,547.96,err_code,337699.98
50517,2132268,95.167.0.225,218.0,ATM,30,9846,459383836,CREDIT,0,active,2026-06-10,2022-02-03 00:18:37,548.26,transfer,337151.72
50518,2293142,95.181.0.15,249.0,ATM,10,8769,459383836,CREDIT,0,active,2026-06-10,2022-02-28 16:12:53,547.98,add_on_acc,337699.7
50519,2591386,46.0.9.75,1322.0,cash_out,20,8514,459383836,CREDIT,0,active,2026-06-10,2022-03-21 00:00:31,547.93,out,337151.77
50520,2776679,194.156.0.150,32.0,pos trm,451,8540,459383836,CREDIT,0,active,2026-06-10,2022-04-03 00:33:13,548.04,payment,336603.73
50521,2851995,95.167.0.225,218.0,ATM,451,5449,459383836,CREDIT,0,active,2026-06-10,2022-04-21 20:34:43,548.2,payment,336055.53
50522,2874592,37.0.123.15,319.0,atm,-1,7338,459383836,CREDIT,1,active,2026-06-10,2022-05-05 19:53:03,547.83,err,336055.53
50523,2976751,188.0.166.90,1305.0,cash_out,20,4300,459383836,CREDIT,0,active,2026-06-10,2022-05-22 17:58:16,547.86,out,335507.67
50524,3013817,37.0.123.15,319.0,atm,451,8769,459383836,CREDIT,0,active,2026-06-10,2022-06-28 21:41:06,547.9,payment,334959.77
50525,3062462,217.26.0.195,694.0,cash_out,20,9334,459383836,CREDIT,0,active,2026-06-10,2022-08-09 08:23:01,548.0,from_acc,334411.77
50526,3190700,188.191.0.180,1153.0,pos trm,25,5480,459383836,CREDIT,0,active,2026-06-10,2022-08-21 06:27:22,548.04,diff_cntry,333863.73
50527,3320996,188.191.0.180,1153.0,pos trm,25,5480,459383836,CREDIT,0,active,2026-06-10,2022-08-30 14:53:13,548.16,country_transfer,333315.57
50528,3401722,188.191.0.180,1153.0,pos trm,-1,3920,459383836,CREDIT,1,active,2026-06-10,2022-10-21 22:29:12,547.94,err_code,333315.57
50529,3511523,95.167.0.225,218.0,ATM,30,2109,459383836,CREDIT,0,active,2026-06-10,2022-11-01 12:24:41,548.15,transfer,332767.42
50530,3531339,188.191.0.180,1153.0,pos trm,25,9258,459383836,CREDIT,0,active,2026-06-10,2022-11-10 13:07:31,547.91,diff_cntry,332219.51
50531,3773038,188.191.0.180,1153.0,pos trm,30,7161,459383836,CREDIT,0,active,2026-06-10,2022-11-12 10:23:18,547.95,transfer,331671.56
50532,4161180,188.191.0.180,1153.0,pos trm,30,9334,459383836,CREDIT,0,active,2026-06-10,2022-11-22 09:02:43,547.8,transfer,331123.76
50533,4170434,194.156.0.150,32.0,pos trm,-1,2109,459383836,CREDIT,1,active,2026-06-10,2022-11-30 12:38:18,547.92,err,331123.76
50534,4353379,37.0.123.15,319.0,atm,451,9334,459383836,CREDIT,0,active,2026-06-10,2022-12-08 19:00:00,547.88,payment,330575.88
50535,4393263,188.191.0.180,1153.0,pos trm,451,9846,459383836,CREDIT,0,active,2026-06-10,2022-12-16 01:35:00,548.19,payment,330027.69
50536,4732445,37.0.123.15,319.0,atm,30,9334,459383836,CREDIT,0,active,2026-06-10,2022-12-21 15:59:52,547.9,transfer,329479.79
50537,4732642,194.87.0.165,577.0,atm,451,9258,459383836,CREDIT,0,active,2026-06-10,2023-01-05 19:01:44,548.1,payment,328931.69
50538,4885299,95.167.0.225,218.0,ATM,30,8514,459383836,CREDIT,0,active,2026-06-10,2023-02-13 17:54:44,548.02,transfer,328383.67
50539,5128901,194.156.0.150,32.0,pos trm,30,6204,459383836,CREDIT,0,active,2026-06-10,2023-03-01 07:14:38,548.12,transfer,327835.55
50540,5389433,95.167.0.75,205.0,ATM,10,9258,459383836,CREDIT,0,active,2026-06-10,2023-03-04 06:15:41,547.8,add_on_acc,328383.35
50541,5611856,109.126.0.90,371.0,pos trm,451,4058,459383836,CREDIT,0,active,2026-06-10,2023-03-16 11:14:58,548.14,payment,327835.21
50542,5914347,109.126.0.90,371.0,pos trm,451,8540,459383836,CREDIT,0,active,2026-06-10,2023-04-18 16:36:56,548.19,payment,327287.02
50543,6251623,109.126.0.90,371.0,pos trm,451,3920,459383836,CREDIT,0,active,2026-06-10,2023-04-29 10:32:00,547.86,payment,326739.16
50544,6330979,194.87.0.165,577.0,atm,451,8769,459383836,CREDIT,0,active,2026-06-10,2023-05-01 14:45:37,547.94,payment,326191.22
50545,6430662,37.0.123.15,319.0,atm,451,7338,459383836,CREDIT,0,active,2026-06-10,2023-05-18 05:11:25,548.03,payment,325643.19
50546,6643236,188.191.0.180,1153.0,pos trm,25,5480,459383836,CREDIT,0,active,2026-06-10,2023-06-24 06:09:16,548.08,diff_cntry,325095.11
50547,6877394,109.126.0.90,371.0,pos trm,25,7161,459383836,CREDIT,0,active,2026-06-10,2023-07-18 20:17:50,547.99,country_transfer,324547.12
50548,6906985,95.167.0.225,218.0,ATM,451,8769,459383836,CREDIT,0,active,2026-06-10,2023-07-20 17:10:36,548.32,payment,323998.8
50549,7073479,217.26.0.135,688.0,ATM,20,8769,459383836,CREDIT,0,active,2026-06-10,2023-08-16 16:04:50,548.11,decrease_on_acc,323450.69
50550,7237566,188.18.0.105,228.0,atm,10,8514,459383836,CREDIT,0,active,2026-06-10,2023-08-27 17:23:07,548.02,in,323998.71
50551,7329236,109.126.0.90,371.0,pos trm,30,8540,459383836,CREDIT,0,active,2026-06-10,2023-09-09 21:53:49,547.94,transfer,323450.77
50552,7415425,194.87.0.165,577.0,atm,25,5449,459383836,CREDIT,0,active,2026-06-10,2023-11-14 19:02:33,547.97,diff_cntry,322902.8
50553,7548758,188.191.0.180,1153.0,pos trm,-1,8769,459383836,CREDIT,1,active,2026-06-10,2023-12-01 11:53:20,547.83,bad,322902.8
50554,7610938,188.0.0.0,1206.0,atm,10,4300,459383836,CREDIT,0,active,2026-06-10,2023-12-25 22:18:33,548.21,add_on_acc,323451.01
50555,7857453,88.210.0.15,341.0,atm,10,4058,459383836,CREDIT,0,active,2026-06-10,2023-12-26 06:40:24,548.05,in,323999.06
50556,7974043,194.87.0.165,577.0,atm,-1,9846,459383836,CREDIT,1,active,2026-06-10,2023-12-27 00:08:06,548.03,err,323999.06
50557,8016065,109.126.0.90,371.0,pos trm,30,3920,459383836,CREDIT,0,active,2026-06-10,2024-01-03 06:53:18,547.96,transfer,323451.1
50558,8128238,188.191.0.180,1153.0,pos trm,451,4058,459383836,CREDIT,0,active,2026-06-10,2024-02-22 03:09:42,548.08,payment,322903.02
50559,8491839,45.154.0.75,300.0,ATM,20,5480,459383836,CREDIT,0,active,2026-06-10,2024-03-13 07:54:56,548.18,out,322354.84
50560,8583295,37.0.123.15,319.0,atm,30,7338,459383836,CREDIT,0,active,2026-06-10,2024-03-13 14:47:44,547.99,transfer,321806.85
50561,8983508,78.24.158.24,931.0,ATM,20,8769,459383836,CREDIT,0,active,2026-06-10,2024-03-24 22:09:09,548.04,from_acc,321258.81
50562,9136070,95.167.0.225,218.0,ATM,451,8540,459383836,CREDIT,0,active,2026-06-10,2024-05-03 16:04:49,547.89,payment,320710.92
50563,9155848,46.0.54.75,1075.0,ATM,20,7338,459383836,CREDIT,0,active,2026-06-10,2024-06-11 11:01:19,547.63,from_acc,320163.29
50564,9246162,95.167.0.105,208.0,atm,10,5449,459383836,CREDIT,0,active,2026-06-10,2024-06-26 22:21:28,547.93,in_acc,320711.22
50565,9246281,109.126.0.90,371.0,pos trm,-1,7338,459383836,CREDIT,1,active,2026-06-10,2024-07-07 11:38:17,547.95,bad,320711.22
50566,9712316,213.151.0.135,1010.0,ATM,10,8540,459383836,CREDIT,0,active,2026-06-10,2024-08-01 10:38:13,547.99,in,321259.21
50567,9741470,194.87.0.165,577.0,atm,451,3920,459383836,CREDIT,0,active,2026-06-10,2024-09-14 11:36:33,548.04,payment,320711.17
50568,9746270,128.0.24.15,880.0,cash_in,10,8769,459383836,CREDIT,0,active,2026-06-10,2024-10-03 15:00:31,548.03,add_on_acc,321259.2
50569,9783198,194.87.0.165,577.0,atm,10,4058,459383836,CREDIT,0,active,2026-06-10,2024-10-08 03:33:11,547.91,add_on_acc,321807.11
50570,1105718,188.162.0.0,952.0,atm,-1,7832,542488442,DEBIT,1,act,2028-09-24,2022-01-14 01:59:37,811.13,err_code,514763.0
50571,1215789,46.173.0.240,517.0,port_trm,30,2660,542488442,DEBIT,0,act,2028-09-24,2022-02-02 23:49:38,810.83,transfer,513952.17
50572,1221569,31.134.0.120,1124.0,ATM,10,7832,542488442,DEBIT,0,act,2028-09-24,2022-02-04 04:43:34,810.95,add_on_acc,514763.12
50573,1229483,128.0.94.180,1111.0,ATM,20,8533,542488442,DEBIT,0,act,2028-09-24,2022-02-14 21:29:25,810.72,out,513952.4
50574,1371638,109.126.0.165,377.0,port_trm,451,6946,542488442,DEBIT,0,act,2028-09-24,2022-02-28 06:58:38,810.83,payment,513141.57
50575,1741191,188.162.0.0,952.0,atm,25,7835,542488442,DEBIT,0,act,2028-09-24,2022-03-05 17:31:13,810.97,country_transfer,512330.6
50576,1746412,46.173.0.240,517.0,port_trm,451,3655,542488442,DEBIT,0,act,2028-09-24,2022-04-02 13:35:22,811.06,payment,511519.54
50577,1780334,188.162.0.0,952.0,atm,25,2522,542488442,DEBIT,0,act,2028-09-24,2022-04-03 07:38:21,810.97,country_transfer,510708.57
50578,1929080,109.126.0.165,377.0,port_trm,451,6923,542488442,DEBIT,0,act,2028-09-24,2022-05-13 19:57:03,810.93,payment,509897.64
50579,2061547,62.118.0.135,531.0,ATM,451,7167,542488442,DEBIT,0,act,2028-09-24,2022-05-31 10:37:57,810.92,payment,509086.72
50580,2161967,109.126.0.165,377.0,port_trm,30,3655,542488442,DEBIT,0,act,2028-09-24,2022-06-10 06:49:44,810.79,transfer,508275.93
50581,2198281,128.0.82.15,611.0,ATM,10,3655,542488442,DEBIT,0,act,2028-09-24,2022-08-15 20:43:11,811.11,add_on_acc,509087.04
50582,2246047,188.162.0.0,952.0,atm,-1,7339,542488442,DEBIT,1,act,2028-09-24,2022-10-03 03:49:00,810.89,bad,509087.04
50583,2304063,213.151.0.165,1012.0,atm,20,4807,542488442,DEBIT,0,act,2028-09-24,2022-12-02 12:04:01,810.94,decrease_on_acc,508276.1
50584,2701997,194.156.0.180,35.0,cash_out,-1,2522,542488442,DEBIT,1,act,2028-09-24,2022-12-16 10:15:37,811.06,err,508276.1
50585,2942704,46.0.123.150,924.0,Portable term,30,7314,542488442,DEBIT,0,act,2028-09-24,2022-12-16 20:35:52,811.11,transfer,507464.99
50586,3077125,46.0.9.15,1318.0,ATM,25,3211,542488442,DEBIT,0,act,2028-09-24,2023-01-21 19:53:26,810.94,country_transfer,506654.05
50587,3099371,188.43.0.30,1406.0,atm,10,4807,542488442,DEBIT,0,act,2028-09-24,2023-01-31 15:03:08,810.97,in,507465.02
50588,3217731,37.0.124.90,727.0,atm,20,2660,542488442,DEBIT,0,act,2028-09-24,2023-03-17 00:19:44,810.98,out,506654.04
50589,3223993,195.58.0.30,1426.0,cash_in,10,2522,542488442,DEBIT,0,act,2028-09-24,2023-04-08 06:53:10,810.91,add_on_acc,507464.95
50590,3262987,213.151.0.0,996.0,atm,20,4807,542488442,DEBIT,0,act,2028-09-24,2023-04-24 02:42:34,811.27,decrease_on_acc,506653.68
50591,3607545,46.0.9.15,1318.0,ATM,451,3211,542488442,DEBIT,0,act,2028-09-24,2023-05-25 16:59:06,810.82,payment,505842.86
50592,3664828,95.181.0.15,249.0,ATM,10,3655,542488442,DEBIT,0,act,2028-09-24,2023-07-21 12:12:41,811.25,add_on_acc,506654.11
50593,3920432,46.173.0.240,517.0,port_trm,451,7972,542488442,DEBIT,0,act,2028-09-24,2023-07-31 01:14:59,811.07,payment,505843.04
50594,4007967,193.0.151.180,68.0,atm,20,6264,542488442,DEBIT,0,act,2028-09-24,2023-08-03 20:54:33,811.33,out,505031.71
50595,4142063,62.118.0.75,525.0,ATM,10,2384,542488442,DEBIT,0,act,2028-09-24,2023-08-12 02:46:49,811.08,in_acc,505842.79
50596,4198119,37.0.127.45,1025.0,cash_in,10,3211,542488442,DEBIT,0,act,2028-09-24,2023-08-15 12:21:01,810.82,add_on_acc,506653.61
50597,4296687,188.162.0.0,952.0,atm,30,7167,542488442,DEBIT,0,act,2028-09-24,2023-08-21 06:36:00,810.93,transfer,505842.68
50598,4307923,194.156.0.180,35.0,cash_out,451,3211,542488442,DEBIT,0,act,2028-09-24,2023-08-21 07:53:55,810.93,payment,505031.75
50599,4406109,128.0.24.75,887.0,cash_out,20,6264,542488442,DEBIT,0,act,2028-09-24,2023-08-25 09:56:14,810.97,out,504220.78
50600,4719282,195.58.0.60,1429.0,ATM,10,3211,542488442,DEBIT,0,act,2028-09-24,2023-09-09 14:42:40,811.1,in,505031.88
50601,4821468,194.156.0.180,35.0,cash_out,451,7972,542488442,DEBIT,0,act,2028-09-24,2023-11-15 19:36:09,811.08,payment,504220.8
50602,4984044,188.0.169.60,471.0,atm,10,3655,542488442,DEBIT,0,act,2028-09-24,2023-12-22 06:58:02,810.98,in,505031.78
50603,5104985,46.0.9.15,1318.0,ATM,-1,4807,542488442,DEBIT,1,act,2028-09-24,2024-01-09 07:57:38,811.16,err_code,505031.78
50604,5242809,109.126.0.165,377.0,port_trm,25,7832,542488442,DEBIT,0,act,2028-09-24,2024-01-25 16:00:28,811.06,diff_cntry,504220.72
50605,5512543,62.118.0.135,531.0,ATM,10,7972,542488442,DEBIT,0,act,2028-09-24,2024-02-21 05:43:13,811.02,in,505031.74
50606,5525809,109.126.0.165,377.0,port_trm,451,7832,542488442,DEBIT,0,act,2028-09-24,2024-03-05 23:07:54,811.17,payment,504220.57
50607,5652044,188.162.0.0,952.0,atm,451,7832,542488442,DEBIT,0,act,2028-09-24,2024-03-16 13:49:15,811.04,payment,503409.53
50608,5674986,46.0.9.15,1318.0,ATM,-1,7167,542488442,DEBIT,1,act,2028-09-24,2024-03-20 11:27:57,811.17,err,503409.53
50609,5757706,46.0.9.15,1318.0,ATM,451,2384,542488442,DEBIT,0,act,2028-09-24,2024-03-22 18:47:48,811.02,payment,502598.51
50610,5821128,62.118.0.135,531.0,ATM,451,3211,542488442,DEBIT,0,act,2028-09-24,2024-04-16 14:16:06,810.76,payment,501787.75
50611,6016412,194.156.0.180,35.0,cash_out,451,7339,542488442,DEBIT,0,act,2028-09-24,2024-05-19 23:35:28,810.66,payment,500977.09
50612,6249867,95.106.0.210,562.0,cash_in,10,4346,542488442,DEBIT,0,act,2028-09-24,2024-06-06 13:24:04,810.85,in_acc,501787.94
50613,6734248,128.0.24.210,900.0,cash_in,10,6264,542488442,DEBIT,0,act,2028-09-24,2024-06-20 23:08:12,810.87,in_acc,502598.81
50614,7285718,62.118.0.135,531.0,ATM,451,4807,542488442,DEBIT,0,act,2028-09-24,2024-07-07 23:31:56,810.79,payment,501788.02
50615,7657235,46.0.123.150,924.0,Portable term,25,6264,542488442,DEBIT,0,act,2028-09-24,2024-08-03 20:39:05,811.1,country_transfer,500976.92
50616,7700983,194.156.0.180,35.0,cash_out,30,6923,542488442,DEBIT,0,act,2028-09-24,2024-08-14 09:48:22,811.19,transfer,500165.73
50617,8242898,46.173.0.240,517.0,port_trm,-1,7835,542488442,DEBIT,1,act,2028-09-24,2024-08-14 11:31:00,811.02,err,500165.73
50618,8254873,194.156.0.180,35.0,cash_out,30,8284,542488442,DEBIT,0,act,2028-09-24,2024-09-28 14:26:41,811.04,transfer,499354.69
50619,8719803,188.162.0.0,952.0,atm,-1,7339,542488442,DEBIT,1,act,2028-09-24,2024-10-13 03:56:53,811.2,err,499354.69
50620,9018617,62.118.0.135,531.0,ATM,451,2522,542488442,DEBIT,0,act,2028-09-24,2024-10-17 16:08:11,810.96,payment,498543.73
50621,9241307,109.126.0.165,377.0,port_trm,451,2660,542488442,DEBIT,0,act,2028-09-24,2024-11-04 09:56:05,810.71,payment,497733.02
50622,9339659,62.118.0.135,531.0,ATM,30,3655,542488442,DEBIT,0,act,2028-09-24,2024-11-11 00:25:23,811.05,transfer,496921.97
50623,9753741,46.0.9.15,1318.0,ATM,-1,7339,542488442,DEBIT,1,act,2028-09-24,2024-11-15 02:17:44,810.95,bad,496921.97
50624,1141832,94.243.0.210,114.0,atm,25,7351,124638020,DEBIT,0,act,2027-10-17,2022-02-16 09:49:03,743.02,diff_cntry,734078.98
50625,1934654,46.0.9.120,1325.0,ATM,-1,7810,124638020,DEBIT,1,act,2027-10-17,2022-02-18 05:49:08,743.03,err,734078.98
50626,2329900,45.154.0.30,297.0,ATM,451,8043,124638020,DEBIT,0,act,2027-10-17,2022-03-31 15:29:05,743.07,payment,733335.91
50627,2578146,95.181.0.165,260.0,atm,-1,1002,124638020,DEBIT,1,act,2027-10-17,2022-03-31 19:31:20,742.9,err,733335.91
50628,2634242,194.0.162.210,757.0,ATM,10,3639,124638020,DEBIT,0,act,2027-10-17,2022-05-02 07:37:28,742.95,in,734078.86
50629,2804397,195.143.0.195,1380.0,atm,20,7351,124638020,DEBIT,0,act,2027-10-17,2022-05-15 13:44:46,742.97,from_acc,733335.89
50630,3100895,46.0.0.150,665.0,cash_out,451,5055,124638020,DEBIT,0,act,2027-10-17,2022-05-16 03:18:59,742.83,payment,732593.06
50631,3180197,95.167.0.240,219.0,ATM,10,9854,124638020,DEBIT,0,act,2027-10-17,2022-05-21 22:41:43,743.03,add_on_acc,733336.09
50632,4066966,109.126.0.150,376.0,atm,20,7905,124638020,DEBIT,0,act,2027-10-17,2022-08-05 21:01:10,742.73,from_acc,732593.36
50633,4086532,46.0.9.60,1321.0,ATM,20,7810,124638020,DEBIT,0,act,2027-10-17,2022-08-06 02:01:34,742.98,out,731850.38
50634,4098387,77.242.0.0,268.0,cash_out,30,8839,124638020,DEBIT,0,act,2027-10-17,2022-08-08 05:16:26,743.09,transfer,731107.29
50635,4167551,188.162.0.120,962.0,ATM,20,2346,124638020,DEBIT,0,act,2027-10-17,2022-08-17 07:01:07,743.03,out,730364.26
50636,4198760,94.243.0.210,114.0,atm,-1,3639,124638020,DEBIT,1,act,2027-10-17,2022-09-18 01:10:54,742.72,err_code,730364.26
50637,4240912,188.128.16.121,1192.0,cash_out,20,1773,124638020,DEBIT,0,act,2027-10-17,2022-09-18 10:46:57,743.22,from_acc,729621.04
50638,4282275,31.134.0.165,1127.0,atm,20,2346,124638020,DEBIT,0,act,2027-10-17,2022-10-09 17:39:13,743.07,out,728877.97
50639,4299036,77.242.0.0,268.0,cash_out,30,7351,124638020,DEBIT,0,act,2027-10-17,2022-10-16 23:37:33,743.15,transfer,728134.82
50640,4383474,45.154.0.30,297.0,ATM,-1,3047,124638020,DEBIT,1,act,2027-10-17,2022-11-17 12:01:40,743.08,err,728134.82
50641,4493297,95.181.0.165,260.0,atm,-1,3601,124638020,DEBIT,2,act,2027-10-17,2022-11-22 21:15:33,743.04,bad,728134.82
50642,4781876,134.0.98.180,804.0,atm,20,7905,124638020,DEBIT,0,act,2027-10-17,2022-11-24 22:04:52,742.85,from_acc,727391.97
50643,5164140,46.0.54.150,1086.0,ATM,20,5055,124638020,DEBIT,0,act,2027-10-17,2022-12-02 03:35:51,743.07,decrease_on_acc,726648.9
50644,5195711,94.243.0.210,114.0,atm,-1,8839,124638020,DEBIT,1,act,2027-10-17,2022-12-19 13:28:20,742.88,err,726648.9
50645,5402728,46.0.0.150,665.0,cash_out,30,3639,124638020,DEBIT,0,act,2027-10-17,2023-01-27 08:55:18,742.79,transfer,725906.11
50646,5601889,46.0.128.15,699.0,port_trm,451,1488,124638020,DEBIT,0,act,2027-10-17,2023-02-19 19:01:11,743.24,payment,725162.87
50647,5672495,77.242.0.0,268.0,cash_out,30,1773,124638020,DEBIT,0,act,2027-10-17,2023-02-25 01:27:11,743.12,transfer,724419.75
50648,5677826,46.0.0.150,665.0,cash_out,25,7019,124638020,DEBIT,0,act,2027-10-17,2023-04-05 14:07:50,743.22,diff_cntry,723676.53
50649,6217671,46.0.128.15,699.0,port_trm,451,3639,124638020,DEBIT,0,act,2027-10-17,2023-04-29 04:37:08,742.87,payment,722933.66
50650,6256188,151.0.38.75,393.0,cash_in,25,4129,124638020,DEBIT,0,act,2027-10-17,2023-05-10 12:54:41,743.18,country_transfer,722190.48
50651,6352926,46.0.9.120,1325.0,ATM,30,5055,124638020,DEBIT,0,act,2027-10-17,2023-05-14 15:25:08,743.3,transfer,721447.18
50652,6434904,94.243.0.210,114.0,atm,451,1002,124638020,DEBIT,0,act,2027-10-17,2023-06-09 17:20:47,742.85,payment,720704.33
50653,6462909,77.242.0.0,268.0,cash_out,25,7351,124638020,DEBIT,0,act,2027-10-17,2023-06-12 05:36:39,743.13,country_transfer,719961.2
50654,6513370,77.242.0.0,268.0,cash_out,30,7019,124638020,DEBIT,0,act,2027-10-17,2023-06-15 02:21:58,743.21,transfer,719217.99
50655,6604078,195.161.0.210,1179.0,atm,10,3061,124638020,DEBIT,0,act,2027-10-17,2023-07-06 13:22:42,743.24,in,719961.23
50656,6705460,45.154.0.30,297.0,ATM,-1,4473,124638020,DEBIT,1,act,2027-10-17,2023-07-29 19:20:49,742.68,bad,719961.23
50657,6902287,77.242.0.0,268.0,cash_out,25,7905,124638020,DEBIT,0,act,2027-10-17,2023-08-02 01:44:06,743.02,country_transfer,719218.21
50658,7344335,95.181.0.90,254.0,atm,20,9854,124638020,DEBIT,0,act,2027-10-17,2023-09-04 08:19:16,743.05,from_acc,718475.16
50659,7441325,151.0.38.75,393.0,cash_in,30,1777,124638020,DEBIT,0,act,2027-10-17,2023-09-06 08:07:51,743.1,transfer,717732.06
50660,7452780,212.20.0.150,459.0,cash_in,10,7361,124638020,DEBIT,0,act,2027-10-17,2023-09-25 03:10:19,743.02,add_on_acc,718475.08
50661,7509788,45.154.0.30,297.0,ATM,25,1488,124638020,DEBIT,0,act,2027-10-17,2023-11-16 23:18:21,742.92,diff_cntry,717732.16
50662,7591418,45.154.0.30,297.0,ATM,30,5055,124638020,DEBIT,0,act,2027-10-17,2023-11-17 15:56:36,743.17,transfer,716988.99
50663,7654298,193.31.0.135,599.0,ATM,20,4129,124638020,DEBIT,0,act,2027-10-17,2023-12-09 00:28:19,742.95,decrease_on_acc,716246.04
50664,7861751,95.181.0.165,260.0,atm,30,3601,124638020,DEBIT,0,act,2027-10-17,2023-12-09 23:20:35,742.95,transfer,715503.09
50665,7889902,77.242.0.0,268.0,cash_out,-1,6688,124638020,DEBIT,1,act,2027-10-17,2023-12-10 17:52:45,743.03,bad,715503.09
50666,7990799,37.0.124.105,728.0,cash_in,10,6004,124638020,DEBIT,0,act,2027-10-17,2024-01-03 00:53:44,743.18,in_acc,716246.27
50667,8033528,128.0.94.195,1112.0,cash_in,10,3601,124638020,DEBIT,0,act,2027-10-17,2024-02-20 13:19:10,743.11,in,716989.38
50668,8047970,37.0.123.60,325.0,ATM,20,1773,124638020,DEBIT,0,act,2027-10-17,2024-02-22 00:54:49,742.99,from_acc,716246.39
50669,8279377,217.112.0.75,1477.0,cash_out,20,1002,124638020,DEBIT,0,act,2027-10-17,2024-03-19 02:00:30,742.78,decrease_on_acc,715503.61
50670,8778312,46.0.9.120,1325.0,ATM,30,1777,124638020,DEBIT,0,act,2027-10-17,2024-04-12 20:03:42,743.04,transfer,714760.57
50671,8932923,46.0.0.150,665.0,cash_out,25,6004,124638020,DEBIT,0,act,2027-10-17,2024-05-02 04:47:38,742.82,country_transfer,714017.75
50672,9177649,46.0.176.120,126.0,cash_in,10,9854,124638020,DEBIT,0,act,2027-10-17,2024-05-23 09:49:27,742.81,add_on_acc,714760.56
50673,9256993,88.210.0.120,350.0,atm,10,1777,124638020,DEBIT,0,act,2027-10-17,2024-05-25 22:44:20,743.02,in_acc,715503.58
50674,9356457,95.181.0.165,260.0,atm,30,3061,124638020,DEBIT,0,act,2027-10-17,2024-09-10 11:46:28,743.16,transfer,714760.42
50675,9440943,45.154.0.30,297.0,ATM,25,5055,124638020,DEBIT,0,act,2027-10-17,2024-09-14 06:43:00,743.03,diff_cntry,714017.39
50676,9445339,94.243.0.210,114.0,atm,25,7361,124638020,DEBIT,0,act,2027-10-17,2024-09-16 02:19:47,742.96,country_transfer,713274.43
50677,9474753,46.0.128.15,699.0,port_trm,25,7905,124638020,DEBIT,0,act,2027-10-17,2024-10-24 09:32:50,743.04,diff_cntry,712531.39
50678,9801314,45.154.0.30,297.0,ATM,451,7905,124638020,DEBIT,0,act,2027-10-17,2024-10-29 19:15:47,742.85,payment,711788.54
50679,9976060,151.0.38.75,393.0,cash_in,30,7019,124638020,DEBIT,0,act,2027-10-17,2024-11-20 19:56:35,743.12,transfer,711045.42
50680,1086708,88.210.0.15,341.0,atm,30,2760,493677673,DEBIT,0,act,2028-05-18,2022-01-09 20:48:01,712.05,transfer,636292.95
50681,1087795,195.161.0.45,1166.0,cash_out,20,6143,493677673,DEBIT,0,act,2028-05-18,2022-01-17 05:44:27,712.3,from_acc,635580.65
50682,1125429,5.189.0.60,860.0,cash_in,25,9545,493677673,DEBIT,0,act,2028-05-18,2022-01-31 05:57:31,712.0,country_transfer,634868.65
50683,1147497,109.126.0.60,369.0,cash_in,30,4867,493677673,DEBIT,0,act,2028-05-18,2022-02-15 20:13:43,711.83,transfer,634156.82
50684,1178705,88.210.0.15,341.0,atm,25,5690,493677673,DEBIT,0,act,2028-05-18,2022-03-19 11:39:40,712.04,diff_cntry,633444.78
50685,1216494,5.189.0.15,857.0,cash_in,10,4284,493677673,DEBIT,0,act,2028-05-18,2022-04-13 12:08:42,711.98,in,634156.76
50686,1347860,109.126.0.60,369.0,cash_in,451,6143,493677673,DEBIT,0,act,2028-05-18,2022-04-15 06:14:31,711.72,payment,633445.04
50687,1367909,109.126.0.60,369.0,cash_in,30,9545,493677673,DEBIT,0,act,2028-05-18,2022-09-23 05:19:22,711.89,transfer,632733.15
50688,1376388,217.112.0.240,1495.0,pos trm,451,5449,493677673,DEBIT,0,act,2028-05-18,2022-11-19 04:19:19,712.05,payment,632021.1
50689,1386245,88.210.0.75,346.0,atm,10,7233,493677673,DEBIT,0,act,2028-05-18,2022-12-13 03:50:30,711.81,in_acc,632732.91
50690,1569071,194.0.162.135,749.0,port_trm,451,5690,493677673,DEBIT,0,act,2028-05-18,2022-12-22 11:42:16,711.98,payment,632020.93
50691,1714008,46.0.8.210,154.0,prtbl trm,25,1941,493677673,DEBIT,0,act,2028-05-18,2023-01-14 10:41:58,711.95,diff_cntry,631308.98
50692,1799228,46.0.0.150,665.0,cash_out,20,8367,493677673,DEBIT,0,act,2028-05-18,2023-02-20 04:57:57,711.9,decrease_on_acc,630597.08
50693,2081256,194.0.162.135,749.0,port_trm,25,4284,493677673,DEBIT,0,act,2028-05-18,2023-03-06 07:27:11,711.76,country_transfer,629885.32
50694,2163984,213.151.0.135,1010.0,ATM,10,5690,493677673,DEBIT,0,act,2028-05-18,2023-04-18 19:12:35,712.21,in,630597.53
50695,2257396,88.210.0.15,341.0,atm,-1,8367,493677673,DEBIT,1,act,2028-05-18,2023-04-25 00:14:34,712.06,bad,630597.53
50696,2598479,217.112.0.240,1495.0,pos trm,451,3233,493677673,DEBIT,0,act,2028-05-18,2023-05-05 13:02:17,712.43,payment,629885.1
50697,2679586,88.210.0.15,341.0,atm,10,8954,493677673,DEBIT,0,act,2028-05-18,2023-05-06 14:52:41,711.93,add_on_acc,630597.03
50698,2794065,46.0.8.210,154.0,prtbl trm,-1,9545,493677673,DEBIT,1,act,2028-05-18,2023-06-05 18:35:15,711.95,err_code,630597.03
50699,2890803,194.0.162.135,749.0,port_trm,451,7233,493677673,DEBIT,0,act,2028-05-18,2023-07-18 16:25:35,711.92,payment,629885.11
50700,2914666,46.0.0.60,659.0,port_trm,30,3233,493677673,DEBIT,0,act,2028-05-18,2023-10-07 21:59:38,711.96,transfer,629173.15
50701,3060056,5.189.0.30,858.0,cash_in,10,3233,493677673,DEBIT,0,act,2028-05-18,2023-10-15 12:31:23,712.0,in,629885.15
50702,3070718,37.0.127.180,1035.0,atm,20,4867,493677673,DEBIT,0,act,2028-05-18,2023-12-11 02:35:12,711.98,from_acc,629173.17
50703,3081400,95.106.0.90,550.0,atm,20,3233,493677673,DEBIT,0,act,2028-05-18,2024-01-13 02:18:29,711.82,decrease_on_acc,628461.35
50704,3089655,46.0.8.210,154.0,prtbl trm,451,4867,493677673,DEBIT,0,act,2028-05-18,2024-01-19 09:31:37,712.05,payment,627749.3
50705,3315161,194.0.162.135,749.0,port_trm,451,4867,493677673,DEBIT,0,act,2028-05-18,2024-04-08 12:25:47,712.1,payment,627037.2
50706,3342659,188.0.166.60,1303.0,atm,20,1173,493677673,DEBIT,0,act,2028-05-18,2024-04-15 05:16:33,711.84,from_acc,626325.36
50707,3666845,46.8.0.240,787.0,ATM,20,7487,493677673,DEBIT,0,act,2028-05-18,2024-04-23 17:36:23,712.06,out,625613.3
50708,3713215,194.0.162.135,749.0,port_trm,451,6143,493677673,DEBIT,0,act,2028-05-18,2024-06-02 02:06:23,711.69,payment,624901.61
50709,3725658,194.0.162.120,748.0,cash_in,10,3252,493677673,DEBIT,0,act,2028-05-18,2024-08-06 12:44:17,712.12,in_acc,625613.73
50710,3855117,88.210.0.15,341.0,atm,-1,1622,493677673,DEBIT,1,act,2028-05-18,2024-09-23 13:20:35,711.93,err,625613.73
50711,4191410,88.210.0.15,341.0,atm,-1,1941,493677673,DEBIT,2,act,2028-05-18,2024-10-23 07:56:27,711.93,err_code,625613.73
50712,4557581,194.0.144.0,158.0,cash_out,-1,6143,493677673,DEBIT,3,blk,2028-05-18,2024-10-29 20:12:34,712.01,err,625613.73
50713,1079150,62.118.0.105,529.0,cash_out,30,3994,666044189,CREDIT,0,act,2030-06-17,2022-01-07 21:25:44,845.19,transfer,254339.81
50714,1171072,217.112.0.150,1483.0,ATM,10,6328,666044189,CREDIT,0,act,2030-06-17,2022-01-09 22:47:42,844.91,in_acc,255184.72
50715,1188010,217.112.0.105,1480.0,Portable term,25,9382,666044189,CREDIT,0,act,2030-06-17,2022-01-31 02:02:03,845.2,country_transfer,254339.52
50716,1432128,31.134.0.45,1119.0,atm,20,5987,666044189,CREDIT,0,act,2030-06-17,2022-03-09 19:23:12,844.99,decrease_on_acc,253494.53
50717,1986736,194.0.162.210,757.0,ATM,20,5987,666044189,CREDIT,0,act,2030-06-17,2022-03-10 12:22:53,844.84,out,252649.69
50718,2058306,194.0.144.210,177.0,port_trm,451,9382,666044189,CREDIT,0,act,2030-06-17,2022-04-07 04:57:57,844.91,payment,251804.78
50719,2068210,185.17.0.30,1044.0,ATM,10,6106,666044189,CREDIT,0,act,2030-06-17,2022-04-13 08:43:23,845.05,in,252649.83
50720,2207813,46.0.188.210,1243.0,cash_out,20,5572,666044189,CREDIT,0,act,2030-06-17,2022-04-19 18:30:18,845.08,from_acc,251804.75
50721,2622714,194.0.144.210,177.0,port_trm,25,9458,666044189,CREDIT,0,act,2030-06-17,2022-04-25 04:52:47,844.82,diff_cntry,250959.93
50722,2968006,134.0.98.0,790.0,atm,10,5572,666044189,CREDIT,0,act,2030-06-17,2022-05-26 18:20:19,845.13,in_acc,251805.06
50723,3031941,188.0.189.120,841.0,cash_in,-1,9066,666044189,CREDIT,1,act,2030-06-17,2022-07-07 17:38:02,845.27,err_code,251805.06
50724,3035494,217.112.0.105,1480.0,Portable term,30,9756,666044189,CREDIT,0,act,2030-06-17,2022-08-13 20:41:31,844.89,transfer,250960.17
50725,3041875,185.233.0.105,84.0,Portable term,451,5572,666044189,CREDIT,0,act,2030-06-17,2022-08-24 13:26:59,845.14,payment,250115.03
50726,3135412,46.0.123.90,917.0,atm,10,3478,666044189,CREDIT,0,act,2030-06-17,2022-09-08 15:29:30,845.39,add_on_acc,250960.42
50727,3157056,185.233.0.105,84.0,Portable term,25,9458,666044189,CREDIT,0,act,2030-06-17,2022-11-26 18:34:46,844.71,country_transfer,250115.71
50728,3178591,188.128.16.136,1195.0,cash_in,451,5572,666044189,CREDIT,0,act,2030-06-17,2022-11-29 21:46:02,844.69,payment,249271.02
50729,3303885,188.128.16.136,1195.0,cash_in,25,4715,666044189,CREDIT,0,act,2030-06-17,2022-12-11 17:42:47,845.11,diff_cntry,248425.91
50730,3656590,188.0.169.60,471.0,atm,10,3008,666044189,CREDIT,0,act,2030-06-17,2023-01-02 11:34:01,845.01,in_acc,249270.92
50731,3708332,194.0.144.210,177.0,port_trm,-1,4715,666044189,CREDIT,1,act,2030-06-17,2023-02-02 18:24:42,844.84,bad,249270.92
50732,3895363,217.112.0.105,1480.0,Portable term,451,2535,666044189,CREDIT,0,act,2030-06-17,2023-03-23 11:14:49,845.0,payment,248425.92
50733,3956007,188.0.0.165,1217.0,ATM,10,5987,666044189,CREDIT,0,act,2030-06-17,2023-05-11 23:54:04,845.09,add_on_acc,249271.01
50734,4373627,185.233.0.105,84.0,Portable term,451,8006,666044189,CREDIT,0,act,2030-06-17,2023-05-24 07:17:14,844.94,payment,248426.07
50735,4401253,46.0.54.210,1090.0,atm,10,9382,666044189,CREDIT,0,act,2030-06-17,2023-07-15 07:45:44,845.05,in,249271.12
50736,4474484,62.118.0.105,529.0,cash_out,-1,3008,666044189,CREDIT,1,act,2030-06-17,2023-07-18 18:12:40,845.01,err_code,249271.12
50737,4479718,62.118.0.105,529.0,cash_out,451,9756,666044189,CREDIT,0,act,2030-06-17,2023-07-20 06:45:58,845.01,payment,248426.11
50738,4719638,194.0.144.210,177.0,port_trm,451,9066,666044189,CREDIT,0,act,2030-06-17,2023-08-11 15:32:17,844.8,payment,247581.31
50739,4766297,188.0.189.120,841.0,cash_in,30,1213,666044189,CREDIT,0,act,2030-06-17,2023-09-01 21:14:18,845.07,transfer,246736.24
50740,4839935,188.0.189.120,841.0,cash_in,25,3478,666044189,CREDIT,0,act,2030-06-17,2023-09-06 15:06:21,845.01,diff_cntry,245891.23
50741,4857975,188.128.16.136,1195.0,cash_in,25,2590,666044189,CREDIT,0,act,2030-06-17,2023-09-18 12:59:20,844.92,country_transfer,245046.31
50742,4882696,134.0.98.195,806.0,cash_in,10,6328,666044189,CREDIT,0,act,2030-06-17,2023-09-19 13:58:45,844.85,in,245891.16
50743,4979431,188.0.189.120,841.0,cash_in,30,3008,666044189,CREDIT,0,act,2030-06-17,2023-09-29 07:46:24,844.96,transfer,245046.2
50744,5349122,185.233.0.105,84.0,Portable term,25,6328,666044189,CREDIT,0,act,2030-06-17,2023-10-28 05:15:17,845.04,diff_cntry,244201.16
50745,5419763,185.233.0.105,84.0,Portable term,451,8006,666044189,CREDIT,0,act,2030-06-17,2023-11-28 16:15:00,844.83,payment,243356.33
50746,5484592,217.112.0.105,1480.0,Portable term,451,5987,666044189,CREDIT,0,act,2030-06-17,2023-12-08 19:43:17,845.11,payment,242511.22
50747,5493769,188.0.189.120,841.0,cash_in,10,8006,666044189,CREDIT,0,act,2030-06-17,2023-12-30 12:01:29,844.99,in_acc,243356.21
50748,6119816,95.181.0.240,267.0,ATM,20,6106,666044189,CREDIT,0,act,2030-06-17,2024-01-05 18:58:23,845.22,out,242510.99
50749,6354254,188.0.189.120,841.0,cash_in,25,3994,666044189,CREDIT,0,act,2030-06-17,2024-01-16 15:21:12,844.83,country_transfer,241666.16
50750,6754270,185.233.0.105,84.0,Portable term,451,9756,666044189,CREDIT,0,act,2030-06-17,2024-01-31 03:08:49,845.22,payment,240820.94
50751,6877590,188.0.189.120,841.0,cash_in,451,9756,666044189,CREDIT,0,act,2030-06-17,2024-02-12 19:57:59,845.08,payment,239975.86
50752,6933068,188.128.16.136,1195.0,cash_in,25,5572,666044189,CREDIT,0,act,2030-06-17,2024-02-15 03:37:09,845.2,diff_cntry,239130.66
50753,7435872,188.0.189.120,841.0,cash_in,30,6106,666044189,CREDIT,0,act,2030-06-17,2024-02-17 07:50:40,845.05,transfer,238285.61
50754,7476524,217.112.0.105,1480.0,Portable term,30,1716,666044189,CREDIT,0,act,2030-06-17,2024-03-03 10:40:52,844.93,transfer,237440.68
50755,7614903,193.31.0.135,599.0,ATM,10,3008,666044189,CREDIT,0,act,2030-06-17,2024-03-11 19:33:43,845.14,in,238285.82
50756,8474220,188.128.16.136,1195.0,cash_in,25,9458,666044189,CREDIT,0,act,2030-06-17,2024-03-31 10:32:33,844.84,diff_cntry,237440.98
50757,8535660,185.233.0.105,84.0,Portable term,451,2535,666044189,CREDIT,0,act,2030-06-17,2024-05-14 10:40:48,845.23,payment,236595.75
50758,8760573,46.0.0.210,670.0,ATM,10,8006,666044189,CREDIT,0,act,2030-06-17,2024-05-19 02:52:49,845.06,add_on_acc,237440.81
50759,9101599,185.233.0.105,84.0,Portable term,25,3008,666044189,CREDIT,0,act,2030-06-17,2024-05-22 19:24:54,844.85,diff_cntry,236595.96
50760,9109792,185.233.0.105,84.0,Portable term,30,3478,666044189,CREDIT,0,act,2030-06-17,2024-06-14 03:56:25,845.23,transfer,235750.73
50761,9318702,217.112.0.105,1480.0,Portable term,30,1293,666044189,CREDIT,0,act,2030-06-17,2024-06-21 03:50:45,844.8,transfer,234905.93
50762,9378043,185.173.0.15,1273.0,ATM,20,2535,666044189,CREDIT,0,act,2030-06-17,2024-07-26 12:16:01,844.76,decrease_on_acc,234061.17
50763,9533417,62.118.0.45,523.0,cash_out,20,4715,666044189,CREDIT,0,act,2030-06-17,2024-08-23 00:16:17,845.21,decrease_on_acc,233215.96
50764,9573932,128.0.24.240,907.0,atm,10,9756,666044189,CREDIT,0,act,2030-06-17,2024-09-27 18:32:59,844.89,in,234060.85
50765,9695643,188.0.166.165,1311.0,cash_out,20,5922,666044189,CREDIT,0,act,2030-06-17,2024-10-15 17:34:43,845.01,out,233215.84
50766,9731266,188.128.16.136,1195.0,cash_in,30,1293,666044189,CREDIT,0,act,2030-06-17,2024-10-17 03:14:14,845.1,transfer,232370.74
50767,9809438,62.118.0.105,529.0,cash_out,25,4715,666044189,CREDIT,0,act,2030-06-17,2024-11-21 07:54:02,845.06,diff_cntry,231525.68
50768,1055552,88.210.0.105,349.0,cash_out,-1,8854,493853809,CREDIT,1,act,2029-01-27,2022-01-14 02:17:27,449.87,err,119938.0
50769,1138378,46.0.0.120,663.0,prtbl trm,451,6257,493853809,CREDIT,0,act,2029-01-27,2022-01-30 14:43:38,450.26,payment,119487.74
50770,1146316,46.0.123.75,916.0,ATM,20,9737,493853809,CREDIT,0,act,2029-01-27,2022-02-20 15:23:50,450.12,decrease_on_acc,119037.62
50771,1181613,46.0.0.120,663.0,prtbl trm,-1,9303,493853809,CREDIT,1,act,2029-01-27,2022-02-21 12:56:19,449.83,err_code,119037.62
50772,1458311,193.0.151.60,56.0,port_trm,451,6519,493853809,CREDIT,0,act,2029-01-27,2022-04-07 07:24:41,450.03,payment,118587.59
50773,1542936,194.87.0.15,567.0,cash_in,25,1583,493853809,CREDIT,0,act,2029-01-27,2022-04-13 06:37:49,449.83,diff_cntry,118137.76
50774,1619234,188.0.189.165,846.0,pos trm,25,9737,493853809,CREDIT,0,act,2029-01-27,2022-05-15 03:19:19,450.01,diff_cntry,117687.75
50775,1659808,193.0.151.15,51.0,ATM,25,5395,493853809,CREDIT,0,act,2029-01-27,2022-06-04 03:35:40,449.92,diff_cntry,117237.83
50776,1809968,188.0.189.165,846.0,pos trm,30,9930,493853809,CREDIT,0,act,2029-01-27,2022-06-09 09:32:23,449.88,transfer,116787.95
50777,2155481,194.87.0.15,567.0,cash_in,30,2568,493853809,CREDIT,0,act,2029-01-27,2022-06-25 01:30:46,449.98,transfer,116337.97
50778,2359384,193.0.151.60,56.0,port_trm,451,7771,493853809,CREDIT,0,act,2029-01-27,2022-08-02 02:46:39,450.04,payment,115887.93
50779,2722913,193.0.151.15,51.0,ATM,25,7823,493853809,CREDIT,0,act,2029-01-27,2022-10-25 06:19:17,450.28,country_transfer,115437.65
50780,2756511,46.0.0.120,663.0,prtbl trm,30,3410,493853809,CREDIT,0,act,2029-01-27,2022-12-06 04:45:17,449.91,transfer,114987.74
50781,2797026,194.87.0.15,567.0,cash_in,30,6228,493853809,CREDIT,0,act,2029-01-27,2022-12-09 04:44:24,449.81,transfer,114537.93
50782,2798693,46.0.188.15,1227.0,atm,10,5395,493853809,CREDIT,0,act,2029-01-27,2023-01-22 15:22:42,449.75,in_acc,114987.68
50783,2901258,193.0.151.15,51.0,ATM,25,3911,493853809,CREDIT,0,act,2029-01-27,2023-01-23 15:17:23,450.16,country_transfer,114537.52
50784,2901600,194.87.0.15,567.0,cash_in,25,7823,493853809,CREDIT,0,act,2029-01-27,2023-02-03 04:36:46,450.12,country_transfer,114087.4
50785,3268314,188.0.189.165,846.0,pos trm,451,5555,493853809,CREDIT,0,act,2029-01-27,2023-02-10 05:36:25,450.22,payment,113637.18
50786,3307661,77.242.0.195,286.0,cash_in,10,6257,493853809,CREDIT,0,act,2029-01-27,2023-03-01 05:42:29,449.75,in,114086.93
50787,3484041,193.0.151.15,51.0,ATM,25,3399,493853809,CREDIT,0,act,2029-01-27,2023-03-05 07:39:17,450.16,country_transfer,113636.77
50788,3506425,88.210.0.105,349.0,cash_out,30,5395,493853809,CREDIT,0,act,2029-01-27,2023-03-22 15:11:19,450.26,transfer,113186.51
50789,3536870,88.210.0.105,349.0,cash_out,30,7823,493853809,CREDIT,0,act,2029-01-27,2023-03-24 00:26:56,450.08,transfer,112736.43
50790,3542372,193.0.151.15,51.0,ATM,451,9930,493853809,CREDIT,0,act,2029-01-27,2023-03-24 21:54:45,449.77,payment,112286.66
50791,3593398,46.0.0.120,663.0,prtbl trm,451,9453,493853809,CREDIT,0,act,2029-01-27,2023-04-21 07:29:24,449.83,payment,111836.83
50792,4248888,46.0.0.120,663.0,prtbl trm,25,7773,493853809,CREDIT,0,act,2029-01-27,2023-05-14 23:36:39,450.19,diff_cntry,111386.64
50793,4281161,194.87.0.15,567.0,cash_in,451,9930,493853809,CREDIT,0,act,2029-01-27,2023-05-15 03:54:15,450.07,payment,110936.57
50794,4288277,88.210.0.105,349.0,cash_out,25,3410,493853809,CREDIT,0,act,2029-01-27,2023-05-17 16:41:17,450.03,country_transfer,110486.54
50795,4330143,194.87.0.15,567.0,cash_in,25,7823,493853809,CREDIT,0,act,2029-01-27,2023-06-13 07:10:18,450.05,diff_cntry,110036.49
50796,4434174,193.0.151.60,56.0,port_trm,451,9453,493853809,CREDIT,0,act,2029-01-27,2023-06-14 06:27:35,450.19,payment,109586.3
50797,4644340,193.0.151.15,51.0,ATM,30,5508,493853809,CREDIT,0,act,2029-01-27,2023-08-05 13:29:03,449.85,transfer,109136.45
50798,4716664,193.0.151.15,51.0,ATM,451,6228,493853809,CREDIT,0,act,2029-01-27,2023-08-23 13:58:03,449.94,payment,108686.51
50799,4767904,46.8.0.210,783.0,atm,10,9930,493853809,CREDIT,0,act,2029-01-27,2023-08-30 06:16:00,450.2,in,109136.71
50800,5288538,95.167.0.75,205.0,ATM,20,3399,493853809,CREDIT,0,act,2029-01-27,2023-09-11 08:18:05,450.06,from_acc,108686.65
50801,6272032,194.87.0.15,567.0,cash_in,30,6228,493853809,CREDIT,0,act,2029-01-27,2023-11-01 22:02:44,450.05,transfer,108236.6
50802,6393426,193.0.151.15,51.0,ATM,-1,7773,493853809,CREDIT,1,act,2029-01-27,2023-11-03 16:45:25,449.92,bad,108236.6
50803,6407879,194.87.0.15,567.0,cash_in,451,5133,493853809,CREDIT,0,act,2029-01-27,2023-12-23 10:34:26,449.85,payment,107786.75
50804,6438823,79.104.0.180,649.0,ATM,10,9369,493853809,CREDIT,0,act,2029-01-27,2024-01-08 00:41:53,450.09,add_on_acc,108236.84
50805,6441798,86.111.0.180,1356.0,cash_out,20,6228,493853809,CREDIT,0,act,2029-01-27,2024-01-14 22:23:25,450.2,decrease_on_acc,107786.64
50806,6626257,193.31.0.90,594.0,ATM,10,8036,493853809,CREDIT,0,act,2029-01-27,2024-02-03 11:20:30,450.0,add_on_acc,108236.64
50807,6902500,193.0.151.60,56.0,port_trm,451,5437,493853809,CREDIT,0,act,2029-01-27,2024-02-15 22:49:54,449.81,payment,107786.83
50808,7201413,194.87.0.15,567.0,cash_in,451,6257,493853809,CREDIT,0,act,2029-01-27,2024-02-20 21:59:49,450.39,payment,107336.44
50809,7311045,46.0.0.120,663.0,prtbl trm,451,5508,493853809,CREDIT,0,act,2029-01-27,2024-03-13 09:43:05,450.04,payment,106886.4
50810,7456490,46.0.0.120,663.0,prtbl trm,451,5395,493853809,CREDIT,0,act,2029-01-27,2024-06-02 01:13:03,450.01,payment,106436.39
50811,7778251,46.0.0.120,663.0,prtbl trm,-1,9369,493853809,CREDIT,1,act,2029-01-27,2024-06-16 01:40:10,449.88,err_code,106436.39
50812,7961553,37.0.123.30,320.0,cash_in,10,9737,493853809,CREDIT,0,act,2029-01-27,2024-06-26 23:39:44,450.14,in,106886.53
50813,8348820,88.210.0.105,349.0,cash_out,25,5437,493853809,CREDIT,0,act,2029-01-27,2024-08-08 01:36:44,450.05,diff_cntry,106436.48
50814,8477381,217.112.0.60,1476.0,atm,10,5395,493853809,CREDIT,0,act,2029-01-27,2024-08-13 16:07:47,449.8,in,106886.28
50815,8726716,193.0.151.60,56.0,port_trm,-1,3410,493853809,CREDIT,1,act,2029-01-27,2024-08-25 22:52:25,449.77,bad,106886.28
50816,8769397,188.0.189.165,846.0,pos trm,451,3410,493853809,CREDIT,0,act,2029-01-27,2024-08-31 07:14:58,449.84,payment,106436.44
50817,8778251,193.0.151.180,68.0,atm,20,9737,493853809,CREDIT,0,act,2029-01-27,2024-09-06 00:23:10,449.94,out,105986.5
50818,8823215,46.0.0.120,663.0,prtbl trm,451,7823,493853809,CREDIT,0,act,2029-01-27,2024-09-20 15:15:18,450.07,payment,105536.43
50819,8920974,193.0.151.60,56.0,port_trm,451,6228,493853809,CREDIT,0,act,2029-01-27,2024-10-07 10:14:19,449.91,payment,105086.52
50820,9075261,193.0.151.60,56.0,port_trm,451,5571,493853809,CREDIT,0,act,2029-01-27,2024-10-12 06:12:31,450.17,payment,104636.35
50821,9154327,88.210.0.105,349.0,cash_out,30,9737,493853809,CREDIT,0,act,2029-01-27,2024-10-12 11:24:52,450.06,transfer,104186.29
50822,9547652,88.210.0.105,349.0,cash_out,451,8773,493853809,CREDIT,0,act,2029-01-27,2024-11-16 09:39:01,449.83,payment,103736.46
50823,1238567,109.126.0.135,375.0,Portable term,30,2420,582752937,CREDIT,0,active,2030-11-05,2022-02-15 01:35:21,1096.12,transfer,893661.88
50824,1512633,46.0.176.75,123.0,atm,451,8702,582752937,CREDIT,0,active,2030-11-05,2022-02-26 00:53:06,1096.13,payment,892565.75
50825,1573823,95.167.0.45,203.0,atm,10,5968,582752937,CREDIT,0,active,2030-11-05,2022-03-08 05:27:36,1095.81,in,893661.56
50826,1598329,109.126.0.135,375.0,Portable term,-1,3854,582752937,CREDIT,1,active,2030-11-05,2022-03-10 13:05:52,1095.82,err,893661.56
50827,1732013,109.126.0.135,375.0,Portable term,30,5462,582752937,CREDIT,0,active,2030-11-05,2022-04-05 21:44:49,1096.06,transfer,892565.5
50828,1844756,95.106.0.180,560.0,cash_out,451,1084,582752937,CREDIT,0,active,2030-11-05,2022-04-28 18:12:17,1095.95,payment,891469.55
50829,2003767,134.0.98.120,799.0,cash_out,20,7617,582752937,CREDIT,0,active,2030-11-05,2022-05-15 12:52:34,1096.04,out,890373.51
50830,2058246,95.106.0.180,560.0,cash_out,30,4803,582752937,CREDIT,0,active,2030-11-05,2022-05-17 13:22:04,1095.99,transfer,889277.52
50831,2375979,195.143.0.15,1363.0,atm,10,9439,582752937,CREDIT,0,active,2030-11-05,2022-06-24 03:21:38,1096.02,in,890373.54
50832,2776763,194.0.144.30,160.0,atm,20,8702,582752937,CREDIT,0,active,2030-11-05,2022-06-29 19:58:30,1095.73,decrease_on_acc,889277.81
50833,2958290,185.17.0.0,1041.0,atm,20,4091,582752937,CREDIT,0,active,2030-11-05,2022-07-09 15:44:42,1095.72,from_acc,888182.09
50834,2981360,95.167.0.45,203.0,atm,20,2686,582752937,CREDIT,0,active,2030-11-05,2022-07-10 14:39:50,1095.75,decrease_on_acc,887086.34
50835,3006982,31.134.0.120,1124.0,ATM,20,1935,582752937,CREDIT,0,active,2030-11-05,2022-07-27 20:11:11,1096.07,decrease_on_acc,885990.27
50836,3176377,46.0.9.105,1324.0,prtbl trm,30,1090,582752937,CREDIT,0,active,2030-11-05,2022-09-09 14:08:23,1095.96,transfer,884894.31
50837,3207976,79.104.0.150,647.0,Portable term,451,7617,582752937,CREDIT,0,active,2030-11-05,2022-09-11 04:52:13,1095.85,payment,883798.46
50838,3258518,46.0.9.105,1324.0,prtbl trm,-1,5462,582752937,CREDIT,1,active,2030-11-05,2022-09-13 12:36:10,1095.97,err,883798.46
50839,3516553,95.106.0.180,560.0,cash_out,451,4091,582752937,CREDIT,0,active,2030-11-05,2022-10-28 21:42:34,1095.97,payment,882702.49
50840,3598951,95.106.0.180,560.0,cash_out,-1,5968,582752937,CREDIT,1,active,2030-11-05,2022-11-12 03:02:58,1095.97,err,882702.49
50841,3713965,95.167.0.195,216.0,Portable term,451,5812,582752937,CREDIT,0,active,2030-11-05,2022-12-12 19:06:50,1096.42,payment,881606.07
50842,4684554,95.167.0.195,216.0,Portable term,25,1047,582752937,CREDIT,0,active,2030-11-05,2022-12-13 06:16:49,1096.17,country_transfer,880509.9
50843,5176159,95.106.0.180,560.0,cash_out,451,4585,582752937,CREDIT,0,active,2030-11-05,2023-01-12 22:09:47,1095.79,payment,879414.11
50844,5222195,46.0.176.75,123.0,atm,451,5968,582752937,CREDIT,0,active,2030-11-05,2023-01-25 04:24:02,1096.17,payment,878317.94
50845,5252610,46.0.176.75,123.0,atm,451,9439,582752937,CREDIT,0,active,2030-11-05,2023-01-27 18:32:33,1096.04,payment,877221.9
50846,5512891,46.0.176.75,123.0,atm,451,2120,582752937,CREDIT,0,active,2030-11-05,2023-03-06 19:10:51,1096.06,payment,876125.84
50847,5789291,95.106.0.180,560.0,cash_out,-1,2120,582752937,CREDIT,1,active,2030-11-05,2023-03-21 14:30:39,1096.05,bad,876125.84
50848,5887856,80.234.0.195,424.0,cash_in,10,9439,582752937,CREDIT,0,active,2030-11-05,2023-04-07 07:53:03,1095.83,add_on_acc,877221.67
50849,6041692,46.173.0.165,509.0,ATM,10,1744,582752937,CREDIT,0,active,2030-11-05,2023-05-09 07:28:23,1095.84,in_acc,878317.51
50850,6090485,46.0.143.15,811.0,atm,10,5812,582752937,CREDIT,0,active,2030-11-05,2023-06-07 13:31:02,1096.04,in,879413.55
50851,6090911,109.126.0.135,375.0,Portable term,451,1744,582752937,CREDIT,0,active,2030-11-05,2023-06-12 19:50:24,1096.02,payment,878317.53
50852,6304151,46.0.2.240,199.0,ATM,20,8744,582752937,CREDIT,0,active,2030-11-05,2023-06-24 12:46:06,1096.05,from_acc,877221.48
50853,6306831,46.0.9.105,1324.0,prtbl trm,30,3281,582752937,CREDIT,0,active,2030-11-05,2023-07-17 06:33:50,1096.21,transfer,876125.27
50854,6353812,46.0.9.105,1324.0,prtbl trm,25,2684,582752937,CREDIT,0,active,2030-11-05,2023-08-11 06:00:43,1095.7,diff_cntry,875029.57
50855,6694962,46.0.188.135,1238.0,atm,10,8702,582752937,CREDIT,0,active,2030-11-05,2023-08-14 04:04:55,1096.01,add_on_acc,876125.58
50856,6732282,109.126.0.135,375.0,Portable term,451,6595,582752937,CREDIT,0,active,2030-11-05,2023-09-17 07:40:45,1095.84,payment,875029.74
50857,6769472,109.126.0.135,375.0,Portable term,-1,2686,582752937,CREDIT,1,active,2030-11-05,2023-09-26 06:38:30,1095.94,bad,875029.74
50858,6878043,128.0.94.180,1111.0,ATM,10,4803,582752937,CREDIT,0,active,2030-11-05,2023-09-29 06:59:27,1095.96,in_acc,876125.7
50859,7095256,95.167.0.195,216.0,Portable term,451,1744,582752937,CREDIT,0,active,2030-11-05,2023-10-10 00:49:03,1096.01,payment,875029.69
50860,7116529,109.126.0.135,375.0,Portable term,-1,8702,582752937,CREDIT,1,active,2030-11-05,2023-10-25 21:56:59,1096.23,err,875029.69
50861,7135278,95.106.0.180,560.0,cash_out,-1,7617,582752937,CREDIT,2,active,2030-11-05,2023-11-23 02:05:20,1095.97,bad,875029.69
50862,7220420,95.167.0.195,216.0,Portable term,25,4091,582752937,CREDIT,0,active,2030-11-05,2023-11-26 12:59:30,1095.55,country_transfer,873934.14
50863,7291427,217.26.0.120,687.0,atm,10,6595,582752937,CREDIT,0,active,2030-11-05,2023-12-19 02:08:57,1096.2,add_on_acc,875030.34
50864,7356062,109.126.0.135,375.0,Portable term,451,2420,582752937,CREDIT,0,active,2030-11-05,2024-01-15 08:18:30,1096.03,payment,873934.31
50865,7385942,46.0.9.105,1324.0,prtbl trm,-1,2339,582752937,CREDIT,1,active,2030-11-05,2024-01-31 19:50:42,1096.1,bad,873934.31
50866,7805868,194.0.162.225,759.0,atm,20,4091,582752937,CREDIT,0,active,2030-11-05,2024-02-25 12:27:33,1095.98,out,872838.33
50867,8072698,85.140.0.105,1256.0,cash_out,20,8702,582752937,CREDIT,0,active,2030-11-05,2024-03-27 01:57:26,1095.85,decrease_on_acc,871742.48
50868,8337949,79.104.0.150,647.0,Portable term,-1,3854,582752937,CREDIT,1,active,2030-11-05,2024-04-07 19:57:04,1096.11,err_code,871742.48
50869,8338299,79.104.0.150,647.0,Portable term,30,3810,582752937,CREDIT,0,active,2030-11-05,2024-06-04 10:33:27,1095.91,transfer,870646.57
50870,8498392,46.0.176.75,123.0,atm,30,5462,582752937,CREDIT,0,active,2030-11-05,2024-06-17 11:13:48,1095.95,transfer,869550.62
50871,8528485,46.0.9.105,1324.0,prtbl trm,-1,7617,582752937,CREDIT,1,active,2030-11-05,2024-08-24 00:24:04,1096.33,err,869550.62
50872,8867396,46.0.176.75,123.0,atm,25,3810,582752937,CREDIT,0,active,2030-11-05,2024-08-25 15:27:10,1096.05,diff_cntry,868454.57
50873,8902050,95.106.0.180,560.0,cash_out,451,6595,582752937,CREDIT,0,active,2030-11-05,2024-08-29 05:40:49,1096.05,payment,867358.52
50874,9040993,109.126.0.135,375.0,Portable term,30,2684,582752937,CREDIT,0,active,2030-11-05,2024-09-01 22:16:08,1096.13,transfer,866262.39
50875,9121192,109.126.0.135,375.0,Portable term,-1,1047,582752937,CREDIT,1,active,2030-11-05,2024-09-08 16:28:56,1096.11,bad,866262.39
50876,9165862,45.154.0.105,303.0,ATM,20,3854,582752937,CREDIT,0,active,2030-11-05,2024-09-22 09:12:29,1096.11,decrease_on_acc,865166.28
50877,9386862,88.210.0.15,341.0,atm,10,3854,582752937,CREDIT,0,active,2030-11-05,2024-09-28 18:06:19,1096.01,in,866262.29
50878,9418304,46.0.176.75,123.0,atm,-1,4091,582752937,CREDIT,1,active,2030-11-05,2024-10-17 22:11:54,1095.93,bad,866262.29
50879,9485714,46.0.176.75,123.0,atm,-1,7617,582752937,CREDIT,2,active,2030-11-05,2024-10-30 13:52:02,1096.12,bad,866262.29
50880,9505854,79.104.0.150,647.0,Portable term,30,3810,582752937,CREDIT,0,active,2030-11-05,2024-10-31 21:17:03,1096.13,transfer,865166.16
50881,1395771,46.8.0.240,787.0,ATM,451,6148,945037981,CREDIT,0,active,2030-09-07,2022-02-25 23:26:10,818.77,payment,499084.23
50882,1537108,151.0.38.165,402.0,pos trm,25,2245,945037981,CREDIT,0,active,2030-09-07,2022-03-25 07:37:52,818.98,country_transfer,498265.25
50883,1571503,77.242.0.195,286.0,cash_in,30,1937,945037981,CREDIT,0,active,2030-09-07,2022-04-28 14:12:07,819.22,transfer,497446.03
50884,1614389,188.191.0.225,1159.0,atm,451,4028,945037981,CREDIT,0,active,2030-09-07,2022-06-02 07:52:21,819.27,payment,496626.76
50885,1688795,46.8.0.225,785.0,ATM,10,7917,945037981,CREDIT,0,active,2030-09-07,2022-06-15 06:52:31,818.87,in_acc,497445.63
50886,1715901,213.151.0.60,1000.0,ATM,20,5958,945037981,CREDIT,0,active,2030-09-07,2022-07-03 17:31:31,818.89,from_acc,496626.74
50887,1832678,195.161.0.45,1166.0,cash_out,20,2775,945037981,CREDIT,0,active,2030-09-07,2022-07-06 04:12:46,819.15,out,495807.59
50888,2301344,88.210.0.105,349.0,cash_out,451,9786,945037981,CREDIT,0,active,2030-09-07,2022-07-28 09:23:19,819.32,payment,494988.27
50889,2317452,213.151.0.150,1011.0,port_trm,451,6148,945037981,CREDIT,0,active,2030-09-07,2022-08-04 08:09:22,818.79,payment,494169.48
50890,2346228,213.151.0.150,1011.0,port_trm,451,4520,945037981,CREDIT,0,active,2030-09-07,2022-08-15 04:20:12,818.91,payment,493350.57
50891,2360411,134.0.98.165,802.0,cash_out,451,2041,945037981,CREDIT,0,active,2030-09-07,2022-09-10 05:41:53,819.05,payment,492531.52
50892,3054227,213.151.0.150,1011.0,port_trm,451,1937,945037981,CREDIT,0,active,2030-09-07,2022-09-24 15:38:31,819.05,payment,491712.47
50893,3055248,46.0.128.45,702.0,port_trm,30,2323,945037981,CREDIT,0,active,2030-09-07,2022-09-30 12:45:42,819.02,transfer,490893.45
50894,3659243,37.0.127.210,1037.0,ATM,20,2323,945037981,CREDIT,0,active,2030-09-07,2022-10-02 16:47:03,818.87,out,490074.58
50895,3709455,46.0.128.45,702.0,port_trm,30,8852,945037981,CREDIT,0,active,2030-09-07,2022-10-22 11:58:46,818.95,transfer,489255.63
50896,3824581,77.242.0.195,286.0,cash_in,30,6103,945037981,CREDIT,0,active,2030-09-07,2022-11-07 06:22:07,819.01,transfer,488436.62
50897,3855600,134.0.98.165,802.0,cash_out,25,2041,945037981,CREDIT,0,active,2030-09-07,2022-11-14 22:15:05,818.69,country_transfer,487617.93
50898,4034096,81.17.0.180,1399.0,ATM,20,4520,945037981,CREDIT,0,active,2030-09-07,2022-12-06 10:35:40,819.0,out,486798.93
50899,4380680,188.191.0.225,1159.0,atm,25,4520,945037981,CREDIT,0,active,2030-09-07,2022-12-13 23:54:13,818.98,diff_cntry,485979.95
50900,4823252,151.0.38.165,402.0,pos trm,-1,7917,945037981,CREDIT,1,active,2030-09-07,2023-01-11 22:27:49,819.29,bad,485979.95
50901,4858531,188.191.0.225,1159.0,atm,25,5283,945037981,CREDIT,0,active,2030-09-07,2023-01-15 07:29:32,819.07,country_transfer,485160.88
50902,5322375,37.0.127.75,1027.0,ATM,20,6148,945037981,CREDIT,0,active,2030-09-07,2023-02-24 11:05:21,819.14,decrease_on_acc,484341.74
50903,5408169,79.104.0.180,649.0,ATM,20,2323,945037981,CREDIT,0,active,2030-09-07,2023-04-30 22:35:38,818.92,out,483522.82
50904,5581933,188.0.189.120,841.0,cash_in,10,4520,945037981,CREDIT,0,active,2030-09-07,2023-05-23 09:25:46,819.04,in_acc,484341.86
50905,5683775,88.210.0.105,349.0,cash_out,30,5283,945037981,CREDIT,0,active,2030-09-07,2023-06-05 01:59:20,818.73,transfer,483523.13
50906,5836407,134.0.98.165,802.0,cash_out,451,5283,945037981,CREDIT,0,active,2030-09-07,2023-07-27 05:43:20,819.02,payment,482704.11
50907,6120173,46.173.0.105,502.0,atm,10,2041,945037981,CREDIT,0,active,2030-09-07,2023-08-17 11:17:35,819.01,in,483523.12
50908,6168056,213.151.0.150,1011.0,port_trm,30,8732,945037981,CREDIT,0,active,2030-09-07,2023-08-31 11:38:33,819.22,transfer,482703.9
50909,6838104,88.210.0.105,349.0,cash_out,-1,8732,945037981,CREDIT,1,active,2030-09-07,2023-09-17 18:03:55,819.01,bad,482703.9
50910,7106100,213.151.0.60,1000.0,ATM,20,1937,945037981,CREDIT,0,active,2030-09-07,2023-09-25 21:34:16,818.93,from_acc,481884.97
50911,7217124,134.0.98.165,802.0,cash_out,451,4028,945037981,CREDIT,0,active,2030-09-07,2023-11-07 19:30:49,819.29,payment,481065.68
50912,7707909,213.151.0.150,1011.0,port_trm,451,7917,945037981,CREDIT,0,active,2030-09-07,2023-11-11 08:45:55,819.07,payment,480246.61
50913,8125091,194.0.162.120,748.0,cash_in,-1,2323,945037981,CREDIT,1,active,2030-09-07,2023-11-12 06:12:19,819.21,err,480246.61
50914,8280816,62.118.0.75,525.0,ATM,10,4520,945037981,CREDIT,0,active,2030-09-07,2023-12-03 17:49:49,819.27,in_acc,481065.88
50915,8464293,188.191.0.225,1159.0,atm,451,4520,945037981,CREDIT,0,active,2030-09-07,2023-12-12 07:10:32,818.84,payment,480247.04
50916,8567493,134.0.98.165,802.0,cash_out,-1,6148,945037981,CREDIT,1,active,2030-09-07,2023-12-23 13:56:40,819.0,err,480247.04
50917,8722966,77.242.0.195,286.0,cash_in,25,5283,945037981,CREDIT,0,active,2030-09-07,2024-02-02 04:31:46,819.08,diff_cntry,479427.96
50918,8723180,88.210.0.105,349.0,cash_out,30,2323,945037981,CREDIT,0,active,2030-09-07,2024-02-02 17:57:28,818.82,transfer,478609.14
50919,9071921,194.0.162.120,748.0,cash_in,451,2041,945037981,CREDIT,0,active,2030-09-07,2024-03-09 12:58:03,818.97,payment,477790.17
50920,9096784,46.173.0.60,497.0,atm,20,9786,945037981,CREDIT,0,active,2030-09-07,2024-04-20 15:43:28,819.08,from_acc,476971.09
50921,9121762,46.0.128.45,702.0,port_trm,30,4028,945037981,CREDIT,0,active,2030-09-07,2024-05-02 14:40:13,818.67,transfer,476152.42
50922,9186094,151.0.38.165,402.0,pos trm,25,5958,945037981,CREDIT,0,active,2030-09-07,2024-05-10 03:42:05,819.27,country_transfer,475333.15
50923,9213892,195.58.0.135,1436.0,atm,20,2775,945037981,CREDIT,0,active,2030-09-07,2024-06-02 17:37:40,819.09,from_acc,474514.06
50924,9271555,213.151.0.150,1011.0,port_trm,-1,4520,945037981,CREDIT,1,active,2030-09-07,2024-06-22 01:34:30,818.91,err,474514.06
50925,9406246,134.0.98.165,802.0,cash_out,30,6148,945037981,CREDIT,0,active,2030-09-07,2024-07-17 15:50:13,819.0,transfer,473695.06
50926,9462564,151.0.38.165,402.0,pos trm,25,4520,945037981,CREDIT,0,active,2030-09-07,2024-09-11 00:22:13,818.95,diff_cntry,472876.11
50927,9511474,46.0.128.45,702.0,port_trm,451,4520,945037981,CREDIT,0,active,2030-09-07,2024-09-21 06:30:23,818.97,payment,472057.14
50928,9684884,213.151.0.150,1011.0,port_trm,451,4028,945037981,CREDIT,0,active,2030-09-07,2024-09-29 13:48:21,819.14,payment,471238.0
50929,9728427,46.0.9.240,1339.0,cash_out,20,7917,945037981,CREDIT,0,active,2030-09-07,2024-10-12 19:32:41,819.11,out,470418.89
50930,9991925,37.0.123.105,328.0,ATM,10,6148,945037981,CREDIT,0,active,2030-09-07,2024-10-23 10:35:29,819.0,add_on_acc,471237.89
50931,1108318,62.118.0.75,525.0,ATM,-1,9161,880902812,DEBIT,1,active,2028-05-10,2022-02-02 00:14:20,237.0,bad,871196.0
50932,1243197,5.189.0.210,874.0,Portable term,30,5977,880902812,DEBIT,0,active,2028-05-10,2022-03-09 16:40:59,237.05,transfer,870958.95
50933,1313820,46.0.0.30,656.0,cash_out,20,9132,880902812,DEBIT,0,active,2028-05-10,2022-03-19 02:26:30,237.11,out,870721.84
50934,1370462,62.118.0.75,525.0,ATM,451,2042,880902812,DEBIT,0,active,2028-05-10,2022-04-15 07:37:09,236.92,payment,870484.92
50935,1405557,194.0.144.225,178.0,prtbl trm,30,4696,880902812,DEBIT,0,active,2028-05-10,2022-04-16 23:07:21,236.69,transfer,870248.23
50936,1540903,185.173.0.0,1272.0,atm,10,4877,880902812,DEBIT,0,active,2028-05-10,2022-04-30 07:06:20,236.91,in_acc,870485.14
50937,1959027,62.118.0.75,525.0,ATM,25,3421,880902812,DEBIT,0,active,2028-05-10,2022-05-25 13:13:49,237.19,country_transfer,870247.95
50938,2084505,212.20.0.120,457.0,ATM,25,7908,880902812,DEBIT,0,active,2028-05-10,2022-06-01 18:46:43,237.06,diff_cntry,870010.89
50939,2508786,212.20.0.120,457.0,ATM,25,1670,880902812,DEBIT,0,active,2028-05-10,2022-06-16 14:48:01,237.08,country_transfer,869773.81
50940,2663512,212.20.0.120,457.0,ATM,25,4877,880902812,DEBIT,0,active,2028-05-10,2022-07-05 17:04:45,236.95,diff_cntry,869536.86
50941,2747992,194.87.0.225,584.0,atm,451,5208,880902812,DEBIT,0,active,2028-05-10,2022-07-26 12:20:13,237.04,payment,869299.82
50942,2863648,194.0.144.225,178.0,prtbl trm,451,7908,880902812,DEBIT,0,active,2028-05-10,2022-08-11 23:56:46,236.85,payment,869062.97
50943,3405381,194.87.0.225,584.0,atm,25,4696,880902812,DEBIT,0,active,2028-05-10,2022-08-12 19:52:50,236.79,country_transfer,868826.18
50944,3458686,194.87.0.225,584.0,atm,451,5977,880902812,DEBIT,0,active,2028-05-10,2022-08-30 15:18:30,236.89,payment,868589.29
50945,3499625,37.0.127.240,1039.0,cash_in,10,8191,880902812,DEBIT,0,active,2028-05-10,2022-09-11 14:40:01,237.07,add_on_acc,868826.36
50946,3562087,5.189.0.210,874.0,Portable term,30,7022,880902812,DEBIT,0,active,2028-05-10,2022-09-23 05:04:23,237.08,transfer,868589.28
50947,3589352,37.0.123.120,329.0,cash_in,10,9126,880902812,DEBIT,0,active,2028-05-10,2022-09-30 02:58:21,237.27,add_on_acc,868826.55
50948,3899158,212.20.0.0,445.0,ATM,10,7257,880902812,DEBIT,0,active,2028-05-10,2022-10-02 08:38:39,237.11,in_acc,869063.66
50949,4057024,194.87.0.225,584.0,atm,-1,9419,880902812,DEBIT,1,active,2028-05-10,2022-11-15 21:33:29,236.82,bad,869063.66
50950,4394704,194.0.144.225,178.0,prtbl trm,25,2810,880902812,DEBIT,0,active,2028-05-10,2022-11-18 12:48:40,236.92,diff_cntry,868826.74
50951,4563993,79.104.0.150,647.0,Portable term,451,8679,880902812,DEBIT,0,active,2028-05-10,2022-12-08 16:02:34,237.26,payment,868589.48
50952,4952487,88.210.0.75,346.0,atm,20,8679,880902812,DEBIT,0,active,2028-05-10,2023-02-03 16:08:44,237.06,decrease_on_acc,868352.42
50953,5025551,188.0.0.0,1206.0,atm,10,7908,880902812,DEBIT,0,active,2028-05-10,2023-02-06 19:17:32,237.19,in_acc,868589.61
50954,5265328,212.20.0.120,457.0,ATM,25,7257,880902812,DEBIT,0,active,2028-05-10,2023-03-31 04:40:03,237.16,country_transfer,868352.45
50955,5496793,194.87.0.30,568.0,cash_in,10,2810,880902812,DEBIT,0,active,2028-05-10,2023-04-30 03:28:07,236.78,add_on_acc,868589.23
50956,5693580,88.210.0.45,343.0,cash_in,10,8381,880902812,DEBIT,0,active,2028-05-10,2023-08-04 07:12:49,236.89,add_on_acc,868826.12
50957,5745499,37.0.124.90,727.0,atm,20,9126,880902812,DEBIT,0,active,2028-05-10,2023-08-15 07:22:43,237.17,decrease_on_acc,868588.95
50958,5793563,212.20.0.120,457.0,ATM,-1,5860,880902812,DEBIT,1,active,2028-05-10,2023-08-16 15:34:37,236.93,err,868588.95
50959,6053498,194.0.144.225,178.0,prtbl trm,451,5977,880902812,DEBIT,0,active,2028-05-10,2023-08-28 14:22:53,236.92,payment,868352.03
50960,6255689,62.118.0.75,525.0,ATM,451,4681,880902812,DEBIT,0,active,2028-05-10,2023-08-31 00:00:32,237.03,payment,868115.0
50961,6466294,79.104.0.150,647.0,Portable term,451,8266,880902812,DEBIT,0,active,2028-05-10,2023-09-02 09:21:19,237.06,payment,867877.94
50962,6835011,194.87.0.225,584.0,atm,451,2042,880902812,DEBIT,0,active,2028-05-10,2023-09-10 02:11:48,236.86,payment,867641.08
50963,6893633,79.104.0.150,647.0,Portable term,25,9161,880902812,DEBIT,0,active,2028-05-10,2023-09-25 04:21:12,236.9,country_transfer,867404.18
50964,7418633,212.20.0.120,457.0,ATM,30,2042,880902812,DEBIT,0,active,2028-05-10,2023-10-12 00:01:18,237.01,transfer,867167.17
50965,7529736,212.20.0.120,457.0,ATM,451,2901,880902812,DEBIT,0,active,2028-05-10,2023-10-22 18:05:36,237.16,payment,866930.01
50966,7584307,212.20.0.120,457.0,ATM,451,5208,880902812,DEBIT,0,active,2028-05-10,2023-10-24 17:17:24,236.97,payment,866693.04
50967,7616806,213.151.0.0,996.0,atm,10,9132,880902812,DEBIT,0,active,2028-05-10,2023-12-08 16:10:09,237.07,in_acc,866930.11
50968,7713602,213.151.0.195,1015.0,atm,20,8266,880902812,DEBIT,0,active,2028-05-10,2023-12-14 09:04:31,236.94,from_acc,866693.17
50969,7758148,194.87.0.225,584.0,atm,30,9132,880902812,DEBIT,0,active,2028-05-10,2024-03-09 03:35:59,237.27,transfer,866455.9
50970,7766395,212.20.0.120,457.0,ATM,-1,2810,880902812,DEBIT,1,active,2028-05-10,2024-03-13 20:10:05,237.06,bad,866455.9
50971,7794311,62.118.0.75,525.0,ATM,451,8679,880902812,DEBIT,0,active,2028-05-10,2024-04-10 10:58:33,237.2,payment,866218.7
50972,7903743,79.104.0.150,647.0,Portable term,30,7896,880902812,DEBIT,0,active,2028-05-10,2024-04-18 14:22:16,236.79,transfer,865981.91
50973,8060877,5.189.0.210,874.0,Portable term,30,3421,880902812,DEBIT,0,active,2028-05-10,2024-04-19 22:35:56,237.28,transfer,865744.63
50974,8128581,46.173.0.75,498.0,ATM,20,9161,880902812,DEBIT,0,active,2028-05-10,2024-04-26 20:37:06,236.76,decrease_on_acc,865507.87
50975,8519668,212.20.0.120,457.0,ATM,451,5208,880902812,DEBIT,0,active,2028-05-10,2024-04-28 20:55:07,237.1,payment,865270.77
50976,8526422,5.189.0.210,874.0,Portable term,451,9126,880902812,DEBIT,0,active,2028-05-10,2024-05-13 22:15:22,236.57,payment,865034.2
50977,8592013,212.20.0.120,457.0,ATM,451,8679,880902812,DEBIT,0,active,2028-05-10,2024-05-31 09:09:38,236.98,payment,864797.22
50978,8792727,212.20.0.120,457.0,ATM,-1,2901,880902812,DEBIT,1,active,2028-05-10,2024-06-05 02:59:13,237.16,err_code,864797.22
50979,8971275,5.189.0.210,874.0,Portable term,25,7257,880902812,DEBIT,0,active,2028-05-10,2024-06-20 10:32:11,236.86,diff_cntry,864560.36
50980,9055741,62.118.0.75,525.0,ATM,25,2810,880902812,DEBIT,0,active,2028-05-10,2024-06-23 04:07:27,236.71,diff_cntry,864323.65
50981,9126644,5.189.0.210,874.0,Portable term,25,9126,880902812,DEBIT,0,active,2028-05-10,2024-07-17 19:25:04,236.93,country_transfer,864086.72
50982,9195541,80.234.0.15,411.0,cash_out,20,1783,880902812,DEBIT,0,active,2028-05-10,2024-08-02 01:12:04,237.0,out,863849.72
50983,9643119,195.161.0.210,1179.0,atm,10,5624,880902812,DEBIT,0,active,2028-05-10,2024-08-15 00:24:42,236.91,in_acc,864086.63
50984,9660411,194.0.144.225,178.0,prtbl trm,-1,2263,880902812,DEBIT,1,active,2028-05-10,2024-08-21 05:26:59,237.35,err_code,864086.63
50985,9940758,212.20.0.120,457.0,ATM,30,5208,880902812,DEBIT,0,active,2028-05-10,2024-09-10 05:04:33,237.02,transfer,863849.61
50986,1013374,80.234.0.240,428.0,ATM,30,2112,847854782,CREDIT,0,act,2027-02-03,2022-01-26 09:57:06,1121.84,transfer,354333.16
50987,1129215,217.26.0.150,689.0,ATM,451,9908,847854782,CREDIT,0,act,2027-02-03,2022-01-27 02:06:21,1122.06,payment,353211.1
50988,1652892,46.0.176.75,123.0,atm,10,9908,847854782,CREDIT,0,act,2027-02-03,2022-01-27 13:27:59,1121.97,add_on_acc,354333.07
50989,1708148,80.234.0.135,420.0,prtbl trm,451,2873,847854782,CREDIT,0,act,2027-02-03,2022-01-29 16:37:57,1122.1,payment,353210.97
50990,1832207,79.104.0.75,641.0,atm,10,9868,847854782,CREDIT,0,act,2027-02-03,2022-02-08 23:52:08,1122.03,in_acc,354333.0
50991,2137665,188.0.169.225,485.0,cash_in,10,9147,847854782,CREDIT,0,act,2027-02-03,2022-03-25 16:35:19,1121.93,add_on_acc,355454.93
50992,2322858,195.161.0.135,1173.0,cash_in,451,6106,847854782,CREDIT,0,act,2027-02-03,2022-03-27 12:04:44,1121.87,payment,354333.06
50993,2512288,86.111.0.135,1353.0,prtbl trm,451,2112,847854782,CREDIT,0,act,2027-02-03,2022-05-21 17:14:49,1122.25,payment,353210.81
50994,2599925,217.26.0.150,689.0,ATM,30,7775,847854782,CREDIT,0,act,2027-02-03,2022-07-05 12:06:08,1122.17,transfer,352088.64
50995,2836801,80.234.0.135,420.0,prtbl trm,30,1419,847854782,CREDIT,0,act,2027-02-03,2022-07-08 03:32:17,1122.2,transfer,350966.44
50996,2879578,88.210.0.195,359.0,cash_out,451,8653,847854782,CREDIT,0,act,2027-02-03,2022-07-08 09:28:45,1121.89,payment,349844.55
50997,3087032,88.210.0.195,359.0,cash_out,451,2112,847854782,CREDIT,0,act,2027-02-03,2022-08-11 12:53:12,1122.01,payment,348722.54
50998,3094312,86.111.0.135,1353.0,prtbl trm,25,7775,847854782,CREDIT,0,act,2027-02-03,2022-09-06 05:54:52,1122.03,diff_cntry,347600.51
50999,3510793,217.26.0.150,689.0,ATM,-1,9908,847854782,CREDIT,1,act,2027-02-03,2022-10-05 19:07:26,1122.03,err_code,347600.51
51000,3519036,217.26.0.150,689.0,ATM,451,9868,847854782,CREDIT,0,act,2027-02-03,2022-10-08 04:49:42,1122.23,payment,346478.28
51001,3531789,88.210.0.195,359.0,cash_out,-1,2873,847854782,CREDIT,1,act,2027-02-03,2022-11-30 07:47:07,1121.79,err,346478.28
51002,3565325,188.128.16.61,1187.0,prtbl trm,451,1419,847854782,CREDIT,0,act,2027-02-03,2022-12-07 19:38:48,1121.94,payment,345356.34
51003,3580146,194.0.162.165,752.0,atm,30,3536,847854782,CREDIT,0,act,2027-02-03,2022-12-23 15:21:06,1122.17,transfer,344234.17
51004,3895554,80.234.0.135,420.0,prtbl trm,-1,3619,847854782,CREDIT,1,act,2027-02-03,2022-12-30 06:51:02,1121.98,err_code,344234.17
51005,4257492,88.210.0.195,359.0,cash_out,451,9908,847854782,CREDIT,0,act,2027-02-03,2023-01-08 05:15:40,1121.8,payment,343112.37
51006,4351270,195.161.0.135,1173.0,cash_in,-1,9147,847854782,CREDIT,1,act,2027-02-03,2023-02-01 00:30:42,1121.79,err,343112.37
51007,4351908,80.234.0.135,420.0,prtbl trm,25,9926,847854782,CREDIT,0,act,2027-02-03,2023-03-17 19:33:30,1121.9,country_transfer,341990.47
51008,4470717,46.173.0.60,497.0,atm,10,2873,847854782,CREDIT,0,act,2027-02-03,2023-03-25 07:40:46,1121.76,in,343112.23
51009,4788068,80.234.0.135,420.0,prtbl trm,451,9926,847854782,CREDIT,0,act,2027-02-03,2023-03-27 03:35:11,1121.93,payment,341990.3
51010,4819314,217.26.0.150,689.0,ATM,451,2112,847854782,CREDIT,0,act,2027-02-03,2023-04-02 11:44:10,1121.65,payment,340868.65
51011,5090556,88.210.0.195,359.0,cash_out,25,1419,847854782,CREDIT,0,act,2027-02-03,2023-04-10 16:30:14,1122.0,diff_cntry,339746.65
51012,5125335,95.167.0.120,210.0,prtbl trm,30,5043,847854782,CREDIT,0,act,2027-02-03,2023-05-09 17:45:31,1122.03,transfer,338624.62
51013,5186463,46.0.2.45,184.0,ATM,20,9908,847854782,CREDIT,0,act,2027-02-03,2023-05-23 04:29:51,1122.08,out,337502.54
51014,5214596,95.181.0.165,260.0,atm,20,8527,847854782,CREDIT,0,act,2027-02-03,2023-06-09 16:05:17,1122.07,from_acc,336380.47
51015,5229492,88.210.0.195,359.0,cash_out,25,8653,847854782,CREDIT,0,act,2027-02-03,2023-06-16 00:50:18,1121.98,diff_cntry,335258.49
51016,5904476,80.234.0.240,428.0,ATM,451,6106,847854782,CREDIT,0,act,2027-02-03,2023-06-20 08:58:50,1122.01,payment,334136.48
51017,6168001,88.210.0.195,359.0,cash_out,451,1047,847854782,CREDIT,0,act,2027-02-03,2023-07-04 00:03:14,1121.96,payment,333014.52
51018,6199848,86.111.0.135,1353.0,prtbl trm,25,8653,847854782,CREDIT,0,act,2027-02-03,2023-08-10 04:56:54,1122.08,country_transfer,331892.44
51019,6282769,194.0.162.165,752.0,atm,451,2873,847854782,CREDIT,0,act,2027-02-03,2023-08-20 09:06:17,1122.01,payment,330770.43
51020,6421762,217.26.0.150,689.0,ATM,25,3536,847854782,CREDIT,0,act,2027-02-03,2023-10-17 16:54:37,1122.02,diff_cntry,329648.41
51021,6629213,194.0.162.165,752.0,atm,451,9926,847854782,CREDIT,0,act,2027-02-03,2023-11-19 20:52:02,1122.13,payment,328526.28
51022,6842869,46.0.188.75,1233.0,ATM,10,1047,847854782,CREDIT,0,act,2027-02-03,2024-01-19 04:45:40,1121.99,in_acc,329648.27
51023,6929400,194.156.0.180,35.0,cash_out,20,1419,847854782,CREDIT,0,act,2027-02-03,2024-01-29 06:33:44,1122.05,out,328526.22
51024,7070323,80.234.0.135,420.0,prtbl trm,25,1419,847854782,CREDIT,0,act,2027-02-03,2024-02-01 03:40:50,1121.83,diff_cntry,327404.39
51025,7109308,188.128.16.61,1187.0,prtbl trm,30,3619,847854782,CREDIT,0,act,2027-02-03,2024-02-14 04:39:09,1121.9,transfer,326282.49
51026,7114011,80.234.0.135,420.0,prtbl trm,25,7775,847854782,CREDIT,0,act,2027-02-03,2024-02-27 06:47:14,1122.16,country_transfer,325160.33
51027,7335621,80.234.0.240,428.0,ATM,451,1419,847854782,CREDIT,0,act,2027-02-03,2024-03-15 15:49:05,1121.81,payment,324038.52
51028,7613255,217.26.0.150,689.0,ATM,30,8653,847854782,CREDIT,0,act,2027-02-03,2024-04-06 23:43:57,1121.81,transfer,322916.71
51029,7918154,194.156.0.75,27.0,atm,10,9871,847854782,CREDIT,0,act,2027-02-03,2024-04-07 14:58:24,1122.08,in_acc,324038.79
51030,8005651,46.0.2.0,180.0,atm,10,2873,847854782,CREDIT,0,act,2027-02-03,2024-04-11 19:58:01,1121.68,in_acc,325160.47
51031,8322758,86.111.0.135,1353.0,prtbl trm,-1,3536,847854782,CREDIT,1,act,2027-02-03,2024-05-12 21:36:36,1121.7,bad,325160.47
51032,8605150,86.111.0.135,1353.0,prtbl trm,25,5043,847854782,CREDIT,0,act,2027-02-03,2024-05-17 14:21:22,1122.03,country_transfer,324038.44
51033,8642477,88.210.0.195,359.0,cash_out,30,7775,847854782,CREDIT,0,act,2027-02-03,2024-06-09 06:04:42,1122.09,transfer,322916.35
51034,8786082,194.156.0.165,34.0,cash_in,10,1047,847854782,CREDIT,0,act,2027-02-03,2024-06-15 23:22:36,1121.79,add_on_acc,324038.14
51035,9197798,46.0.176.165,129.0,ATM,10,5043,847854782,CREDIT,0,act,2027-02-03,2024-06-22 11:39:36,1121.94,in_acc,325160.08
51036,9247156,188.128.16.61,1187.0,prtbl trm,451,9926,847854782,CREDIT,0,act,2027-02-03,2024-06-23 00:05:29,1121.91,payment,324038.17
51037,9420937,194.0.162.165,752.0,atm,30,2112,847854782,CREDIT,0,act,2027-02-03,2024-06-28 22:50:17,1122.0,transfer,322916.17
51038,9530436,46.0.2.240,199.0,ATM,10,7775,847854782,CREDIT,0,act,2027-02-03,2024-06-30 13:47:54,1121.94,add_on_acc,324038.11
51039,9619224,195.161.0.135,1173.0,cash_in,451,2873,847854782,CREDIT,0,act,2027-02-03,2024-07-24 03:55:07,1121.86,payment,322916.25
51040,9624550,86.111.0.135,1353.0,prtbl trm,451,6204,847854782,CREDIT,0,act,2027-02-03,2024-08-23 10:22:57,1122.0,payment,321794.25
51041,9925323,217.26.0.150,689.0,ATM,451,6204,847854782,CREDIT,0,act,2027-02-03,2024-10-01 00:09:21,1121.98,payment,320672.27
51042,9989781,193.0.151.240,76.0,atm,10,6204,847854782,CREDIT,0,act,2027-02-03,2024-10-13 21:05:59,1121.91,add_on_acc,321794.18
51043,9996236,188.128.16.61,1187.0,prtbl trm,25,3536,847854782,CREDIT,0,act,2027-02-03,2024-10-22 21:37:16,1121.93,country_transfer,320672.25
51044,1162967,45.154.0.240,317.0,port_trm,25,1001,657293615,DEBIT,0,active,2029-01-27,2022-01-05 20:31:55,187.15,diff_cntry,870306.85
51045,1217014,46.0.0.120,663.0,prtbl trm,25,1001,657293615,DEBIT,0,active,2029-01-27,2022-01-10 08:46:14,186.66,country_transfer,870120.19
51046,1297685,194.87.0.90,572.0,atm,451,1001,657293615,DEBIT,0,active,2029-01-27,2022-02-16 00:43:39,186.99,payment,869933.2
51047,1315127,128.0.24.240,907.0,atm,30,8298,657293615,DEBIT,0,active,2029-01-27,2022-03-04 12:51:34,187.04,transfer,869746.16
51048,1492394,193.31.0.135,599.0,ATM,451,9633,657293615,DEBIT,0,active,2029-01-27,2022-03-26 11:44:06,187.03,payment,869559.13
51049,1956449,95.181.0.225,266.0,cash_out,20,1001,657293615,DEBIT,0,active,2029-01-27,2022-04-05 09:45:16,186.95,from_acc,869372.18
51050,1994715,128.0.24.240,907.0,atm,30,6861,657293615,DEBIT,0,active,2029-01-27,2022-04-06 16:06:09,186.98,transfer,869185.2
51051,2194737,193.31.0.135,599.0,ATM,-1,7668,657293615,DEBIT,1,active,2029-01-27,2022-05-29 05:21:14,186.77,bad,869185.2
51052,2234809,128.0.24.240,907.0,atm,451,6296,657293615,DEBIT,0,active,2029-01-27,2022-06-15 04:08:09,186.94,payment,868998.26
51053,2473218,194.87.0.90,572.0,atm,30,7986,657293615,DEBIT,0,active,2029-01-27,2022-06-16 20:15:17,186.83,transfer,868811.43
51054,2594317,134.0.98.75,796.0,cash_out,20,7423,657293615,DEBIT,0,active,2029-01-27,2022-06-25 10:28:59,187.04,decrease_on_acc,868624.39
51055,2767489,45.154.0.240,317.0,port_trm,25,7668,657293615,DEBIT,0,active,2029-01-27,2022-07-31 06:30:25,187.09,country_transfer,868437.3
51056,3195431,46.0.8.135,147.0,atm,25,8284,657293615,DEBIT,0,active,2029-01-27,2022-09-16 18:12:16,186.83,country_transfer,868250.47
51057,3409772,45.154.0.240,317.0,port_trm,-1,1002,657293615,DEBIT,1,active,2029-01-27,2022-11-27 12:31:19,186.88,err,868250.47
51058,3414464,194.87.0.90,572.0,atm,451,1927,657293615,DEBIT,0,active,2029-01-27,2022-12-05 22:44:39,186.91,payment,868063.56
51059,3550806,128.0.24.240,907.0,atm,25,7986,657293615,DEBIT,0,active,2029-01-27,2023-01-31 03:12:21,187.3,diff_cntry,867876.26
51060,4006706,46.0.0.120,663.0,prtbl trm,451,2747,657293615,DEBIT,0,active,2029-01-27,2023-02-06 22:01:07,187.04,payment,867689.22
51061,4015402,128.0.24.240,907.0,atm,30,7668,657293615,DEBIT,0,active,2029-01-27,2023-02-23 16:59:22,187.14,transfer,867502.08
51062,4027357,193.31.0.135,599.0,ATM,451,1002,657293615,DEBIT,0,active,2029-01-27,2023-03-18 10:23:48,187.04,payment,867315.04
51063,4216172,128.0.24.240,907.0,atm,-1,4950,657293615,DEBIT,1,active,2029-01-27,2023-04-02 14:48:10,187.05,err_code,867315.04
51064,4286855,46.0.0.120,663.0,prtbl trm,30,2747,657293615,DEBIT,0,active,2029-01-27,2023-06-28 17:02:57,186.87,transfer,867128.17
51065,4656922,46.0.8.135,147.0,atm,451,8234,657293615,DEBIT,0,active,2029-01-27,2023-09-03 12:31:23,186.96,payment,866941.21
51066,4812685,194.87.0.90,572.0,atm,25,4950,657293615,DEBIT,0,active,2029-01-27,2023-11-01 11:21:19,186.94,country_transfer,866754.27
51067,4815061,46.0.176.165,129.0,ATM,20,7668,657293615,DEBIT,0,active,2029-01-27,2023-11-04 06:44:14,186.63,from_acc,866567.64
51068,5116771,45.154.0.240,317.0,port_trm,-1,9633,657293615,DEBIT,1,active,2029-01-27,2023-12-09 11:57:02,187.08,bad,866567.64
51069,5139114,45.154.0.240,317.0,port_trm,451,8234,657293615,DEBIT,0,active,2029-01-27,2023-12-14 19:22:47,186.82,payment,866380.82
51070,5669045,194.87.0.90,572.0,atm,451,8234,657293615,DEBIT,0,active,2029-01-27,2024-01-19 22:57:53,187.03,payment,866193.79
51071,5678578,194.87.0.90,572.0,atm,30,3606,657293615,DEBIT,0,active,2029-01-27,2024-02-04 05:01:31,187.13,transfer,866006.66
51072,5783444,128.0.82.165,627.0,atm,10,7423,657293615,DEBIT,0,active,2029-01-27,2024-03-02 23:46:09,187.01,in_acc,866193.67
51073,5833006,128.0.24.240,907.0,atm,25,3606,657293615,DEBIT,0,active,2029-01-27,2024-03-30 07:35:40,187.02,diff_cntry,866006.65
51074,6002075,85.140.0.90,1255.0,ATM,20,2747,657293615,DEBIT,0,active,2029-01-27,2024-04-05 15:05:42,187.02,decrease_on_acc,865819.63
51075,6319815,5.189.0.30,858.0,cash_in,10,3606,657293615,DEBIT,0,active,2029-01-27,2024-04-22 19:29:14,186.79,add_on_acc,866006.42
51076,6424333,45.154.0.240,317.0,port_trm,30,3606,657293615,DEBIT,0,active,2029-01-27,2024-05-14 01:29:23,187.01,transfer,865819.41
51077,6439092,45.154.0.240,317.0,port_trm,-1,1002,657293615,DEBIT,1,active,2029-01-27,2024-05-23 16:36:39,186.86,bad,865819.41
51078,6494716,193.31.0.135,599.0,ATM,451,8234,657293615,DEBIT,0,active,2029-01-27,2024-06-10 01:18:56,187.05,payment,865632.36
51079,6647761,46.0.0.120,663.0,prtbl trm,451,1927,657293615,DEBIT,0,active,2029-01-27,2024-07-07 05:53:31,187.1,payment,865445.26
51080,6664819,80.234.0.240,428.0,ATM,20,9732,657293615,DEBIT,0,active,2029-01-27,2024-08-07 01:28:48,186.8,decrease_on_acc,865258.46
51081,6709835,46.0.188.210,1243.0,cash_out,20,1927,657293615,DEBIT,0,active,2029-01-27,2024-09-26 08:07:09,187.15,out,865071.31
51082,6720133,128.0.24.240,907.0,atm,451,1002,657293615,DEBIT,0,active,2029-01-27,2024-10-05 06:12:21,186.94,payment,864884.37
51083,7254030,46.0.0.120,663.0,prtbl trm,30,7668,657293615,DEBIT,0,active,2029-01-27,2024-10-07 04:36:19,187.12,transfer,864697.25
51084,7261453,46.0.0.120,663.0,prtbl trm,-1,2342,657293615,DEBIT,1,active,2029-01-27,2024-10-07 22:43:43,187.19,err,864697.25
51085,7367042,46.0.0.120,663.0,prtbl trm,-1,1001,657293615,DEBIT,2,active,2029-01-27,2024-10-14 14:02:22,187.07,err,864697.25
51086,7386289,46.0.0.120,663.0,prtbl trm,-1,7986,657293615,DEBIT,3,blocked,2029-01-27,2024-10-19 23:06:08,187.0,bad,864697.25
51087,1155810,94.243.0.150,110.0,Portable term,-1,2967,143660501,CREDIT,1,active,2029-09-20,2022-01-16 03:55:28,687.26,bad,310188.0
51088,1734433,128.0.24.15,880.0,cash_in,10,6087,143660501,CREDIT,0,active,2029-09-20,2022-01-16 11:41:00,687.14,in,310875.14
51089,1767694,217.112.0.30,1474.0,ATM,10,1539,143660501,CREDIT,0,active,2029-09-20,2022-02-17 08:58:43,686.77,add_on_acc,311561.91
51090,1836042,188.128.16.136,1195.0,cash_in,10,1111,143660501,CREDIT,0,active,2029-09-20,2022-03-14 17:40:38,686.95,in,312248.86
51091,1938569,37.0.124.165,732.0,ATM,20,9871,143660501,CREDIT,0,active,2029-09-20,2022-03-20 20:05:15,686.98,out,311561.88
51092,2148788,188.0.169.0,467.0,atm,20,2720,143660501,CREDIT,0,active,2029-09-20,2022-04-21 12:18:05,686.96,out,310874.92
51093,2320963,95.106.0.150,557.0,cash_in,-1,3318,143660501,CREDIT,1,active,2029-09-20,2022-05-17 14:56:20,686.93,err,310874.92
51094,2355620,95.106.0.150,557.0,cash_in,30,9704,143660501,CREDIT,0,active,2029-09-20,2022-06-13 17:11:23,686.73,transfer,310188.19
51095,2465597,5.189.0.15,857.0,cash_in,10,6598,143660501,CREDIT,0,active,2029-09-20,2022-06-15 21:32:37,687.02,in,310875.21
51096,2466859,95.181.0.195,262.0,cash_out,20,9704,143660501,CREDIT,0,active,2029-09-20,2022-06-26 16:51:47,686.92,from_acc,310188.29
51097,2496348,80.234.0.195,424.0,cash_in,10,9366,143660501,CREDIT,0,active,2029-09-20,2022-06-29 17:32:26,687.1,in_acc,310875.39
51098,2639485,94.243.0.150,110.0,Portable term,25,4622,143660501,CREDIT,0,active,2029-09-20,2022-07-27 17:13:29,686.94,country_transfer,310188.45
51099,2685184,37.0.123.15,319.0,atm,10,2084,143660501,CREDIT,0,active,2029-09-20,2022-08-02 00:20:32,687.05,in,310875.5
51100,2810183,194.87.0.120,574.0,cash_out,20,1539,143660501,CREDIT,0,active,2029-09-20,2022-08-03 20:59:26,686.74,out,310188.76
51101,2914437,185.17.0.180,1063.0,atm,30,2420,143660501,CREDIT,0,active,2029-09-20,2022-09-17 07:59:51,687.03,transfer,309501.73
51102,3359766,185.17.0.180,1063.0,atm,30,6087,143660501,CREDIT,0,active,2029-09-20,2022-09-20 20:51:19,687.05,transfer,308814.68
51103,3602948,128.0.82.60,614.0,Portable term,30,1111,143660501,CREDIT,0,active,2029-09-20,2022-11-09 11:27:02,687.4,transfer,308127.28
51104,3953118,185.173.0.225,1289.0,cash_in,10,3439,143660501,CREDIT,0,active,2029-09-20,2022-11-13 10:24:06,686.72,add_on_acc,308814.0
51105,4005885,46.0.9.30,1319.0,cash_in,10,6628,143660501,CREDIT,0,active,2029-09-20,2022-11-15 08:36:15,686.97,in_acc,309500.97
51106,4171262,128.0.94.225,1114.0,cash_in,25,4232,143660501,CREDIT,0,active,2029-09-20,2022-12-09 16:55:14,686.8,diff_cntry,308814.17
51107,4423750,185.17.0.0,1041.0,atm,10,9871,143660501,CREDIT,0,active,2029-09-20,2023-01-02 01:18:14,687.01,add_on_acc,309501.18
51108,4481699,95.106.0.150,557.0,cash_in,25,6598,143660501,CREDIT,0,active,2029-09-20,2023-01-10 03:34:27,686.94,diff_cntry,308814.24
51109,4576044,217.26.0.210,695.0,cash_out,-1,9704,143660501,CREDIT,1,active,2029-09-20,2023-03-12 19:36:25,687.13,err_code,308814.24
51110,4635305,46.0.188.0,1226.0,cash_out,25,9366,143660501,CREDIT,0,active,2029-09-20,2023-04-07 02:39:07,686.92,diff_cntry,308127.32
51111,4693725,46.0.8.225,155.0,cash_in,-1,1111,143660501,CREDIT,1,active,2029-09-20,2023-04-16 03:13:54,686.78,err,308127.32
51112,4878778,128.0.94.225,1114.0,cash_in,-1,2967,143660501,CREDIT,2,active,2029-09-20,2023-05-08 04:01:10,687.01,err_code,308127.32
51113,4993251,46.0.188.0,1226.0,cash_out,451,2875,143660501,CREDIT,0,active,2029-09-20,2023-05-12 21:08:11,686.9,payment,307440.42
51114,5051101,46.0.8.225,155.0,cash_in,30,2720,143660501,CREDIT,0,active,2029-09-20,2023-05-25 19:58:38,686.84,transfer,306753.58
51115,5227353,185.17.0.180,1063.0,atm,25,2875,143660501,CREDIT,0,active,2029-09-20,2023-06-09 09:30:22,686.99,diff_cntry,306066.59
51116,5340683,128.0.82.60,614.0,Portable term,451,6628,143660501,CREDIT,0,active,2029-09-20,2023-06-23 03:28:17,686.96,payment,305379.63
51117,5385686,37.0.123.225,337.0,cash_in,30,2867,143660501,CREDIT,0,active,2029-09-20,2023-07-04 09:33:18,687.19,transfer,304692.44
51118,5486845,85.140.0.240,1271.0,ATM,20,5371,143660501,CREDIT,0,active,2029-09-20,2023-07-20 19:05:52,686.99,decrease_on_acc,304005.45
51119,5570766,217.26.0.210,695.0,cash_out,451,9704,143660501,CREDIT,0,active,2029-09-20,2023-08-09 16:53:38,686.82,payment,303318.63
51120,5575720,37.0.123.225,337.0,cash_in,30,5068,143660501,CREDIT,0,active,2029-09-20,2023-08-28 00:26:59,686.77,transfer,302631.86
51121,6688877,5.189.0.30,858.0,cash_in,10,3318,143660501,CREDIT,0,active,2029-09-20,2023-10-01 11:05:51,686.87,add_on_acc,303318.73
51122,6724914,213.151.0.120,1009.0,ATM,10,4232,143660501,CREDIT,0,active,2029-09-20,2023-10-05 07:21:22,687.08,in_acc,304005.81
51123,7176755,37.0.123.225,337.0,cash_in,451,6628,143660501,CREDIT,0,active,2029-09-20,2023-10-10 10:10:03,687.16,payment,303318.65
51124,7441607,46.0.143.15,811.0,atm,20,1539,143660501,CREDIT,0,active,2029-09-20,2023-11-19 13:21:47,687.06,from_acc,302631.59
51125,7508573,188.0.189.225,850.0,cash_in,10,6598,143660501,CREDIT,0,active,2029-09-20,2024-01-05 05:23:05,686.72,in_acc,303318.31
51126,7910544,217.26.0.210,695.0,cash_out,-1,8977,143660501,CREDIT,1,active,2029-09-20,2024-01-15 08:26:15,686.84,bad,303318.31
51127,7953776,37.0.123.225,337.0,cash_in,25,9871,143660501,CREDIT,0,active,2029-09-20,2024-01-22 18:42:16,687.04,diff_cntry,302631.27
51128,8034006,94.243.0.150,110.0,Portable term,30,1539,143660501,CREDIT,0,active,2029-09-20,2024-04-01 17:35:50,686.95,transfer,301944.32
51129,8180771,46.0.188.0,1226.0,cash_out,-1,2967,143660501,CREDIT,1,active,2029-09-20,2024-04-23 21:18:55,687.1,bad,301944.32
51130,8187188,128.0.82.60,614.0,Portable term,-1,1111,143660501,CREDIT,2,active,2029-09-20,2024-05-01 05:12:40,687.04,err_code,301944.32
51131,8273137,86.111.0.30,1345.0,cash_out,20,6628,143660501,CREDIT,0,active,2029-09-20,2024-05-02 19:55:42,686.93,out,301257.39
51132,8365944,94.243.0.150,110.0,Portable term,451,6929,143660501,CREDIT,0,active,2029-09-20,2024-05-04 00:04:38,687.1,payment,300570.29
51133,8937468,46.0.8.225,155.0,cash_in,-1,5867,143660501,CREDIT,1,active,2029-09-20,2024-06-15 06:29:33,687.29,err_code,300570.29
51134,9094168,185.17.0.180,1063.0,atm,-1,3488,143660501,CREDIT,2,active,2029-09-20,2024-06-23 19:53:47,687.11,err,300570.29
51135,9110399,194.84.192.237,47.0,cash_in,10,1111,143660501,CREDIT,0,active,2029-09-20,2024-06-29 07:51:01,687.18,add_on_acc,301257.47
51136,9110840,94.243.0.150,110.0,Portable term,451,9704,143660501,CREDIT,0,active,2029-09-20,2024-07-29 20:24:21,686.79,payment,300570.68
51137,9114817,217.26.0.210,695.0,cash_out,30,2967,143660501,CREDIT,0,active,2029-09-20,2024-08-02 19:35:51,687.05,transfer,299883.63
51138,9214363,185.17.0.180,1063.0,atm,30,2084,143660501,CREDIT,0,active,2029-09-20,2024-08-02 21:28:43,687.13,transfer,299196.5
51139,9498510,94.243.0.150,110.0,Portable term,25,9287,143660501,CREDIT,0,active,2029-09-20,2024-08-08 15:38:08,686.88,diff_cntry,298509.62
51140,9537231,128.0.24.45,883.0,atm,20,6598,143660501,CREDIT,0,active,2029-09-20,2024-08-31 12:17:22,686.71,decrease_on_acc,297822.91
51141,9552132,95.106.0.150,557.0,cash_in,451,2720,143660501,CREDIT,0,active,2029-09-20,2024-09-10 03:19:31,686.81,payment,297136.1
51142,9755007,217.26.0.210,695.0,cash_out,30,6598,143660501,CREDIT,0,active,2029-09-20,2024-10-06 04:23:18,686.67,transfer,296449.43
51143,9830703,188.244.0.15,1449.0,ATM,10,7305,143660501,CREDIT,0,active,2029-09-20,2024-10-15 07:22:44,686.97,in_acc,297136.4
51144,1409385,194.156.0.150,32.0,pos trm,451,2255,863733647,CREDIT,0,active,2028-05-31,2022-01-20 11:12:34,696.84,payment,797148.16
51145,1465711,188.162.0.180,967.0,cash_in,25,7015,863733647,CREDIT,0,active,2028-05-31,2022-01-20 20:58:10,697.06,country_transfer,796451.1
51146,1573432,46.0.54.195,1089.0,atm,20,3207,863733647,CREDIT,0,active,2028-05-31,2022-03-11 23:09:00,697.11,out,795753.99
51147,2041595,195.58.0.15,1425.0,atm,10,3207,863733647,CREDIT,0,active,2028-05-31,2022-03-19 10:22:41,696.84,in_acc,796450.83
51148,2163411,194.156.0.150,32.0,pos trm,-1,3118,863733647,CREDIT,1,active,2028-05-31,2022-04-05 05:12:31,696.97,bad,796450.83
51149,2412055,194.0.162.60,744.0,prtbl trm,30,7015,863733647,CREDIT,0,active,2028-05-31,2022-05-04 23:44:02,697.12,transfer,795753.71
51150,2563935,5.189.0.60,860.0,cash_in,10,3118,863733647,CREDIT,0,active,2028-05-31,2022-05-23 22:00:30,696.91,in,796450.62
51151,2840470,46.0.8.0,137.0,cash_out,-1,8074,863733647,CREDIT,1,active,2028-05-31,2022-05-29 19:30:11,696.91,bad,796450.62
51152,3207100,134.0.98.195,806.0,cash_in,451,3207,863733647,CREDIT,0,active,2028-05-31,2022-05-30 22:01:52,697.05,payment,795753.57
51153,3265417,46.173.0.180,511.0,cash_in,10,5206,863733647,CREDIT,0,active,2028-05-31,2022-06-22 17:58:05,696.94,add_on_acc,796450.51
51154,3300525,188.0.189.195,848.0,cash_out,30,7793,863733647,CREDIT,0,active,2028-05-31,2022-06-23 22:14:50,696.89,transfer,795753.62
51155,3436838,134.0.98.195,806.0,cash_in,30,2255,863733647,CREDIT,0,active,2028-05-31,2022-09-11 15:06:14,697.08,transfer,795056.54
51156,3473897,134.0.98.195,806.0,cash_in,451,1509,863733647,CREDIT,0,active,2028-05-31,2022-10-07 18:40:41,697.31,payment,794359.23
51157,3496368,46.0.8.0,137.0,cash_out,-1,7793,863733647,CREDIT,1,active,2028-05-31,2022-10-14 20:01:18,697.16,err_code,794359.23
51158,3554967,88.210.0.15,341.0,atm,10,4533,863733647,CREDIT,0,active,2028-05-31,2022-11-12 21:05:00,696.84,add_on_acc,795056.07
51159,3734297,188.0.189.195,848.0,cash_out,451,3207,863733647,CREDIT,0,active,2028-05-31,2023-02-05 03:49:12,697.09,payment,794358.98
51160,3760054,46.0.8.0,137.0,cash_out,25,3413,863733647,CREDIT,0,active,2028-05-31,2023-02-05 14:40:02,696.98,diff_cntry,793662.0
51161,3963738,188.43.0.135,1413.0,ATM,10,3207,863733647,CREDIT,0,active,2028-05-31,2023-02-14 09:47:56,696.9,in_acc,794358.9
51162,4016807,95.181.0.240,267.0,ATM,10,1509,863733647,CREDIT,0,active,2028-05-31,2023-02-24 05:42:04,696.82,add_on_acc,795055.72
51163,4161295,188.0.169.210,484.0,atm,20,9471,863733647,CREDIT,0,active,2028-05-31,2023-04-02 08:30:52,697.03,decrease_on_acc,794358.69
51164,4229541,46.0.8.0,137.0,cash_out,30,2255,863733647,CREDIT,0,active,2028-05-31,2023-04-16 00:12:03,697.08,transfer,793661.61
51165,4255874,194.0.162.60,744.0,prtbl trm,-1,8074,863733647,CREDIT,1,active,2028-05-31,2023-05-30 09:25:51,697.2,bad,793661.61
51166,4470122,194.156.0.150,32.0,pos trm,25,5206,863733647,CREDIT,0,active,2028-05-31,2023-07-27 21:30:47,696.97,country_transfer,792964.64
51167,4540855,194.156.0.150,32.0,pos trm,451,6157,863733647,CREDIT,0,active,2028-05-31,2023-08-26 23:50:50,697.18,payment,792267.46
51168,4813071,62.118.0.105,529.0,cash_out,20,6879,863733647,CREDIT,0,active,2028-05-31,2023-08-27 22:28:48,697.07,decrease_on_acc,791570.39
51169,5402456,37.0.123.105,328.0,ATM,10,3413,863733647,CREDIT,0,active,2028-05-31,2023-09-24 12:39:52,697.31,in_acc,792267.7
51170,5464670,95.181.0.225,266.0,cash_out,20,2255,863733647,CREDIT,0,active,2028-05-31,2023-12-10 05:40:33,696.99,decrease_on_acc,791570.71
51171,5504235,188.0.189.195,848.0,cash_out,25,9471,863733647,CREDIT,0,active,2028-05-31,2023-12-17 12:13:22,696.9,country_transfer,790873.81
51172,5715488,188.0.189.195,848.0,cash_out,451,6157,863733647,CREDIT,0,active,2028-05-31,2023-12-26 22:09:29,697.02,payment,790176.79
51173,6199759,188.0.189.195,848.0,cash_out,25,4533,863733647,CREDIT,0,active,2028-05-31,2024-02-08 07:31:36,696.68,country_transfer,789480.11
51174,6214138,188.162.0.180,967.0,cash_in,451,4533,863733647,CREDIT,0,active,2028-05-31,2024-02-12 07:35:07,697.11,payment,788783.0
51175,6311985,194.0.162.120,748.0,cash_in,10,7793,863733647,CREDIT,0,active,2028-05-31,2024-02-14 06:01:31,697.27,in,789480.27
51176,6386654,185.173.0.0,1272.0,atm,20,7788,863733647,CREDIT,0,active,2028-05-31,2024-02-15 06:33:11,697.21,decrease_on_acc,788783.06
51177,6415836,45.154.0.210,314.0,atm,20,1164,863733647,CREDIT,0,active,2028-05-31,2024-02-25 00:24:20,696.98,out,788086.08
51178,6436077,194.0.162.60,744.0,prtbl trm,451,6157,863733647,CREDIT,0,active,2028-05-31,2024-02-26 19:28:08,697.24,payment,787388.84
51179,6569489,194.0.162.60,744.0,prtbl trm,451,8074,863733647,CREDIT,0,active,2028-05-31,2024-03-05 21:26:13,696.96,payment,786691.88
51180,6667955,194.0.162.60,744.0,prtbl trm,25,6157,863733647,CREDIT,0,active,2028-05-31,2024-03-18 01:37:41,696.94,country_transfer,785994.94
51181,6971165,46.0.8.0,137.0,cash_out,-1,8074,863733647,CREDIT,1,active,2028-05-31,2024-04-19 15:40:46,697.04,err,785994.94
51182,7346981,46.0.8.0,137.0,cash_out,25,1965,863733647,CREDIT,0,active,2028-05-31,2024-05-08 13:03:49,696.79,diff_cntry,785298.15
51183,7725542,46.0.8.0,137.0,cash_out,451,6157,863733647,CREDIT,0,active,2028-05-31,2024-05-26 05:14:47,696.85,payment,784601.3
51184,7975560,217.26.0.90,681.0,cash_out,20,3207,863733647,CREDIT,0,active,2028-05-31,2024-06-05 02:15:22,697.07,out,783904.23
51185,8121562,217.26.0.150,689.0,ATM,10,6157,863733647,CREDIT,0,active,2028-05-31,2024-07-19 23:16:37,696.99,in_acc,784601.22
51186,8170019,185.173.0.75,1278.0,ATM,10,7793,863733647,CREDIT,0,active,2028-05-31,2024-08-13 20:05:06,696.7,in_acc,785297.92
51187,8277172,194.156.0.150,32.0,pos trm,25,7015,863733647,CREDIT,0,active,2028-05-31,2024-08-14 07:24:22,697.1,country_transfer,784600.82
51188,8468937,194.156.0.150,32.0,pos trm,451,5206,863733647,CREDIT,0,active,2028-05-31,2024-08-17 12:07:18,697.07,payment,783903.75
51189,9369572,188.162.0.180,967.0,cash_in,25,3118,863733647,CREDIT,0,active,2028-05-31,2024-08-24 12:59:39,696.93,diff_cntry,783206.82
51190,9439229,188.0.189.195,848.0,cash_out,25,7015,863733647,CREDIT,0,active,2028-05-31,2024-08-29 09:02:51,696.96,country_transfer,782509.86
51191,9553958,151.0.0.90,20.0,ATM,20,1164,863733647,CREDIT,0,active,2028-05-31,2024-09-24 00:53:47,697.05,decrease_on_acc,781812.81
51192,9624149,188.0.0.0,1206.0,atm,20,7788,863733647,CREDIT,0,active,2028-05-31,2024-10-10 09:31:50,696.94,decrease_on_acc,781115.87
51193,9757290,188.0.189.195,848.0,cash_out,451,3207,863733647,CREDIT,0,active,2028-05-31,2024-10-14 00:22:38,697.02,payment,780418.85
51194,9873966,46.0.8.0,137.0,cash_out,25,9471,863733647,CREDIT,0,active,2028-05-31,2024-11-17 21:20:13,697.12,diff_cntry,779721.73
51195,9916409,134.0.98.195,806.0,cash_in,-1,2255,863733647,CREDIT,1,active,2028-05-31,2024-11-28 09:55:58,696.99,bad,779721.73
51196,1117474,46.0.2.15,182.0,cash_in,451,6520,671446374,DEBIT,0,active,2028-04-20,2022-01-08 15:01:28,1020.06,payment,321656.94
51197,1212784,95.181.0.30,250.0,Portable term,-1,1582,671446374,DEBIT,1,active,2028-04-20,2022-09-16 06:29:23,1020.08,err_code,321656.94
51198,1214909,185.17.0.0,1041.0,atm,10,5597,671446374,DEBIT,0,active,2028-04-20,2022-11-17 00:36:39,1019.68,in,322676.62
51199,1350663,5.189.0.45,859.0,cash_out,20,7424,671446374,DEBIT,0,active,2028-04-20,2023-01-15 20:43:05,1019.88,decrease_on_acc,321656.74
51200,1405554,188.43.0.60,1408.0,cash_in,10,1883,671446374,DEBIT,0,active,2028-04-20,2023-02-18 05:02:45,1020.05,in,322676.79
51201,2125013,78.24.158.69,937.0,atm,-1,5527,671446374,DEBIT,1,active,2028-04-20,2023-06-15 06:34:06,1019.96,err_code,322676.79
51202,2359487,151.0.0.60,16.0,prtbl trm,-1,2378,671446374,DEBIT,2,active,2028-04-20,2024-05-25 05:21:57,1020.13,err,322676.79
51203,2468204,46.0.176.0,117.0,cash_in,-1,7543,671446374,DEBIT,3,blocked,2028-04-20,2024-06-02 03:11:01,1019.82,err,322676.79
51204,1012429,194.84.192.207,44.0,Portable term,30,8279,105878057,DEBIT,0,act,2026-03-24,2022-01-17 21:26:44,1048.99,transfer,464787.01
51205,1180825,78.24.158.54,935.0,cash_in,10,7011,105878057,DEBIT,0,act,2026-03-24,2022-03-06 02:05:07,1049.1,in_acc,465836.11
51206,1591027,194.84.192.207,44.0,Portable term,451,6458,105878057,DEBIT,0,act,2026-03-24,2022-04-04 22:41:59,1049.05,payment,464787.06
51207,1742632,78.24.158.129,942.0,ATM,30,5955,105878057,DEBIT,0,act,2026-03-24,2022-06-03 11:38:14,1048.96,transfer,463738.1
51208,2136430,91.107.0.0,974.0,pos trm,-1,5955,105878057,DEBIT,1,act,2026-03-24,2022-07-18 17:27:57,1048.96,err,463738.1
51209,2172945,88.210.0.120,350.0,atm,10,8704,105878057,DEBIT,0,act,2026-03-24,2022-08-10 13:34:44,1049.1,in,464787.2
51210,2544871,128.0.94.60,1101.0,cash_out,25,6532,105878057,DEBIT,0,act,2026-03-24,2022-08-17 11:28:20,1049.22,country_transfer,463737.98
51211,2550806,62.118.0.60,524.0,cash_in,-1,4518,105878057,DEBIT,1,act,2026-03-24,2022-08-26 12:42:53,1048.85,bad,463737.98
51212,2758183,213.151.0.90,1004.0,Portable term,-1,8482,105878057,DEBIT,2,act,2026-03-24,2022-10-14 13:05:23,1048.92,err,463737.98
51213,2892332,79.104.60.135,437.0,port_trm,30,5821,105878057,DEBIT,0,act,2026-03-24,2022-12-06 19:33:54,1049.05,transfer,462688.93
51214,3060584,185.17.0.150,1061.0,cash_out,20,3976,105878057,DEBIT,0,act,2026-03-24,2022-12-16 01:48:42,1049.15,from_acc,461639.78
51215,3145928,185.173.0.150,1283.0,cash_out,20,7011,105878057,DEBIT,0,act,2026-03-24,2023-01-05 10:04:03,1048.91,decrease_on_acc,460590.87
51216,3322645,128.0.94.60,1101.0,cash_out,25,4518,105878057,DEBIT,0,act,2026-03-24,2023-01-25 14:19:07,1048.83,diff_cntry,459542.04
51217,3384279,78.24.158.129,942.0,ATM,30,7167,105878057,DEBIT,0,act,2026-03-24,2023-02-01 12:06:42,1049.15,transfer,458492.89
51218,3481356,213.151.0.90,1004.0,Portable term,451,2360,105878057,DEBIT,0,act,2026-03-24,2023-02-07 00:17:50,1049.05,payment,457443.84
51219,3563439,46.0.0.195,669.0,cash_out,20,9265,105878057,DEBIT,0,act,2026-03-24,2023-02-13 08:09:26,1048.7,out,456395.14
51220,3673547,91.107.0.0,974.0,pos trm,451,6555,105878057,DEBIT,0,act,2026-03-24,2023-02-28 15:34:00,1048.87,payment,455346.27
51221,3808080,188.0.0.0,1206.0,atm,20,3976,105878057,DEBIT,0,act,2026-03-24,2023-03-31 07:16:46,1049.03,decrease_on_acc,454297.24
51222,4116943,128.0.94.60,1101.0,cash_out,451,8279,105878057,DEBIT,0,act,2026-03-24,2023-04-15 09:27:47,1048.73,payment,453248.51
51223,4281005,194.0.162.120,748.0,cash_in,10,7167,105878057,DEBIT,0,act,2026-03-24,2023-05-11 13:35:48,1049.23,in_acc,454297.74
51224,4677628,213.151.0.90,1004.0,Portable term,30,5112,105878057,DEBIT,0,act,2026-03-24,2023-05-28 16:13:23,1049.13,transfer,453248.61
51225,4987201,46.0.0.90,661.0,prtbl trm,30,4518,105878057,DEBIT,0,act,2026-03-24,2023-05-30 23:33:42,1049.22,transfer,452199.39
51226,5127964,79.104.60.135,437.0,port_trm,451,8704,105878057,DEBIT,0,act,2026-03-24,2023-06-12 10:30:42,1048.97,payment,451150.42
51227,5228899,77.242.0.90,278.0,cash_in,10,9366,105878057,DEBIT,0,act,2026-03-24,2023-06-30 19:15:09,1049.06,in,452199.48
51228,5360219,194.84.192.207,44.0,Portable term,-1,8292,105878057,DEBIT,1,act,2026-03-24,2023-07-03 23:24:44,1049.38,err_code,452199.48
51229,5388167,46.0.143.120,820.0,cash_in,10,9294,105878057,DEBIT,0,act,2026-03-24,2023-07-27 08:22:39,1049.08,in,453248.56
51230,5632655,46.0.0.90,661.0,prtbl trm,451,8482,105878057,DEBIT,0,act,2026-03-24,2023-08-13 22:14:02,1049.24,payment,452199.32
51231,5706476,79.104.60.135,437.0,port_trm,25,4518,105878057,DEBIT,0,act,2026-03-24,2023-08-15 01:21:38,1049.26,country_transfer,451150.06
51232,5711422,46.0.2.0,180.0,atm,20,9366,105878057,DEBIT,0,act,2026-03-24,2023-08-17 08:18:32,1048.98,out,450101.08
51233,5860893,46.0.0.90,661.0,prtbl trm,451,6532,105878057,DEBIT,0,act,2026-03-24,2023-08-23 04:37:33,1049.19,payment,449051.89
51234,5911947,217.112.0.30,1474.0,ATM,10,6555,105878057,DEBIT,0,act,2026-03-24,2023-09-02 10:54:12,1049.01,in,450100.9
51235,5960683,128.0.24.30,882.0,atm,10,6458,105878057,DEBIT,0,act,2026-03-24,2023-09-03 06:20:01,1049.4,add_on_acc,451150.3
51236,5973011,188.43.0.105,1411.0,ATM,10,9884,105878057,DEBIT,0,act,2026-03-24,2023-09-05 21:20:00,1048.96,add_on_acc,452199.26
51237,6196956,195.58.0.135,1436.0,atm,20,9366,105878057,DEBIT,0,act,2026-03-24,2023-09-15 09:24:51,1049.04,out,451150.22
51238,6275421,91.107.0.0,974.0,pos trm,451,9884,105878057,DEBIT,0,act,2026-03-24,2023-10-05 00:00:27,1049.01,payment,450101.21
51239,6804349,194.84.192.207,44.0,Portable term,30,2361,105878057,DEBIT,0,act,2026-03-24,2023-10-10 09:43:01,1048.83,transfer,449052.38
51240,7077893,194.84.192.207,44.0,Portable term,30,6458,105878057,DEBIT,0,act,2026-03-24,2023-10-24 21:04:39,1049.05,transfer,448003.33
51241,7097604,128.0.24.165,895.0,ATM,20,5112,105878057,DEBIT,0,act,2026-03-24,2023-12-09 21:43:35,1049.0,from_acc,446954.33
51242,7536926,128.0.94.60,1101.0,cash_out,451,5955,105878057,DEBIT,0,act,2026-03-24,2023-12-25 10:54:54,1048.85,payment,445905.48
51243,7757325,128.0.24.240,907.0,atm,20,5821,105878057,DEBIT,0,act,2026-03-24,2023-12-26 13:00:51,1049.0,from_acc,444856.48
51244,7902210,213.151.0.90,1004.0,Portable term,-1,4518,105878057,DEBIT,1,act,2026-03-24,2024-02-26 05:17:52,1048.7,err,444856.48
51245,7941947,46.0.176.180,130.0,ATM,20,5955,105878057,DEBIT,0,act,2026-03-24,2024-04-13 23:08:28,1048.89,out,443807.59
51246,7946390,128.0.94.60,1101.0,cash_out,-1,9884,105878057,DEBIT,1,act,2026-03-24,2024-05-08 15:26:53,1049.07,bad,443807.59
51247,8240322,194.84.192.222,46.0,cash_in,10,8772,105878057,DEBIT,0,act,2026-03-24,2024-05-19 18:05:31,1049.09,add_on_acc,444856.68
51248,8612188,128.0.94.60,1101.0,cash_out,-1,5112,105878057,DEBIT,1,act,2026-03-24,2024-06-15 09:20:05,1048.63,err_code,444856.68
51249,8958468,91.107.0.0,974.0,pos trm,451,5821,105878057,DEBIT,0,act,2026-03-24,2024-06-18 12:02:57,1049.04,payment,443807.64
51250,8962586,128.0.94.60,1101.0,cash_out,451,2360,105878057,DEBIT,0,act,2026-03-24,2024-07-09 14:43:55,1048.86,payment,442758.78
51251,8997337,95.106.0.165,558.0,ATM,20,4518,105878057,DEBIT,0,act,2026-03-24,2024-08-06 04:53:01,1048.91,from_acc,441709.87
51252,9275192,194.84.192.207,44.0,Portable term,451,6458,105878057,DEBIT,0,act,2026-03-24,2024-09-09 22:46:26,1049.03,payment,440660.84
51253,9316009,195.161.0.105,1170.0,atm,10,6828,105878057,DEBIT,0,act,2026-03-24,2024-09-19 05:36:08,1048.99,in_acc,441709.83
51254,9685752,46.0.0.90,661.0,prtbl trm,451,6828,105878057,DEBIT,0,act,2026-03-24,2024-10-27 19:35:13,1048.88,payment,440660.95
51255,1061985,45.154.0.105,303.0,ATM,20,1942,147078192,CREDIT,0,active,2030-12-14,2022-01-04 11:11:44,490.05,from_acc,201558.95
51256,1159158,46.0.54.45,1072.0,atm,451,7562,147078192,CREDIT,0,active,2030-12-14,2022-01-11 10:58:24,489.95,payment,201069.0
51257,1613360,217.112.0.0,1471.0,ATM,10,7109,147078192,CREDIT,0,active,2030-12-14,2022-01-23 05:13:34,489.99,in,201558.99
51258,1739900,213.151.0.15,997.0,pos trm,451,9959,147078192,CREDIT,0,active,2030-12-14,2022-04-21 19:56:55,490.11,payment,201068.88
51259,2055528,46.0.54.45,1072.0,atm,30,7916,147078192,CREDIT,0,active,2030-12-14,2022-06-16 23:38:32,490.03,transfer,200578.85
51260,2066662,188.0.189.240,851.0,cash_in,30,7462,147078192,CREDIT,0,active,2030-12-14,2022-07-08 17:57:29,489.89,transfer,200088.96
51261,2166852,195.143.0.15,1363.0,atm,10,7598,147078192,CREDIT,0,active,2030-12-14,2022-07-12 20:44:04,489.91,in,200578.87
51262,2174443,185.17.0.240,1067.0,port_trm,451,1796,147078192,CREDIT,0,active,2030-12-14,2022-07-24 00:29:04,490.04,payment,200088.83
51263,2537816,193.31.0.90,594.0,ATM,10,7902,147078192,CREDIT,0,active,2030-12-14,2022-07-29 00:31:44,489.96,in_acc,200578.79
51264,2630330,77.242.0.15,269.0,atm,20,8134,147078192,CREDIT,0,active,2030-12-14,2022-08-21 03:10:52,489.91,from_acc,200088.88
51265,2766828,46.173.0.60,497.0,atm,20,9006,147078192,CREDIT,0,active,2030-12-14,2022-09-04 11:03:11,490.17,decrease_on_acc,199598.71
51266,2862831,86.111.0.135,1353.0,prtbl trm,451,7109,147078192,CREDIT,0,active,2030-12-14,2022-09-06 00:18:09,490.31,payment,199108.4
51267,2897462,37.0.127.45,1025.0,cash_in,-1,2999,147078192,CREDIT,1,active,2030-12-14,2022-10-23 02:53:04,490.19,err_code,199108.4
51268,3026573,79.104.0.75,641.0,atm,30,7109,147078192,CREDIT,0,active,2030-12-14,2022-12-07 09:33:38,489.83,transfer,198618.57
51269,3278263,86.111.0.135,1353.0,prtbl trm,-1,9377,147078192,CREDIT,1,active,2030-12-14,2022-12-17 23:46:04,489.72,bad,198618.57
51270,3541828,79.104.0.0,634.0,cash_in,451,4039,147078192,CREDIT,0,active,2030-12-14,2022-12-30 18:29:16,490.2,payment,198128.37
51271,3601023,79.104.0.0,634.0,cash_in,-1,9959,147078192,CREDIT,1,active,2030-12-14,2023-03-02 23:58:42,490.16,err_code,198128.37
51272,3901454,46.8.0.240,787.0,ATM,20,7462,147078192,CREDIT,0,active,2030-12-14,2023-03-15 23:12:19,489.89,decrease_on_acc,197638.48
51273,3931843,188.0.189.240,851.0,cash_in,-1,1942,147078192,CREDIT,1,active,2030-12-14,2023-03-28 20:58:01,489.88,err_code,197638.48
51274,4217001,188.0.189.240,851.0,cash_in,-1,7916,147078192,CREDIT,2,active,2030-12-14,2023-05-14 05:58:04,490.01,err_code,197638.48
51275,4263052,46.0.54.45,1072.0,atm,25,1796,147078192,CREDIT,0,active,2030-12-14,2023-05-21 21:09:57,490.04,diff_cntry,197148.44
51276,4302281,86.111.0.135,1353.0,prtbl trm,-1,9093,147078192,CREDIT,1,active,2030-12-14,2023-06-28 09:03:55,490.17,err_code,197148.44
51277,4361082,213.151.0.15,997.0,pos trm,30,1942,147078192,CREDIT,0,active,2030-12-14,2023-06-30 02:42:28,490.08,transfer,196658.36
51278,4470437,37.0.127.45,1025.0,cash_in,-1,1796,147078192,CREDIT,1,active,2030-12-14,2023-07-06 01:01:57,489.97,bad,196658.36
51279,4505959,79.104.0.0,634.0,cash_in,-1,9291,147078192,CREDIT,2,active,2030-12-14,2023-07-30 05:32:12,490.23,bad,196658.36
51280,4534741,79.104.0.75,641.0,atm,30,8134,147078192,CREDIT,0,active,2030-12-14,2023-08-05 05:15:36,490.29,transfer,196168.07
51281,4700119,213.151.0.15,997.0,pos trm,25,1092,147078192,CREDIT,0,active,2030-12-14,2023-09-19 00:14:57,489.88,diff_cntry,195678.19
51282,4799194,185.17.0.240,1067.0,port_trm,451,7562,147078192,CREDIT,0,active,2030-12-14,2023-09-20 01:26:21,490.2,payment,195187.99
51283,4861063,79.104.60.60,429.0,atm,10,9377,147078192,CREDIT,0,active,2030-12-14,2023-09-28 13:29:37,489.68,in_acc,195677.67
51284,4912746,46.0.54.45,1072.0,atm,25,8033,147078192,CREDIT,0,active,2030-12-14,2023-11-18 18:15:55,490.09,diff_cntry,195187.58
51285,5042388,79.104.60.195,441.0,port_trm,30,4039,147078192,CREDIT,0,active,2030-12-14,2023-11-26 13:13:43,489.87,transfer,194697.71
51286,5744256,79.104.60.195,441.0,port_trm,-1,7916,147078192,CREDIT,1,active,2030-12-14,2023-12-26 22:08:45,490.06,bad,194697.71
51287,6129621,88.210.0.120,350.0,atm,20,7562,147078192,CREDIT,0,active,2030-12-14,2024-01-13 17:03:24,489.93,decrease_on_acc,194207.78
51288,6223284,185.17.0.240,1067.0,port_trm,25,7902,147078192,CREDIT,0,active,2030-12-14,2024-01-16 20:16:00,489.95,country_transfer,193717.83
51289,6312329,79.104.0.0,634.0,cash_in,30,9482,147078192,CREDIT,0,active,2030-12-14,2024-02-19 21:37:05,489.87,transfer,193227.96
51290,6354293,213.151.0.15,997.0,pos trm,451,9959,147078192,CREDIT,0,active,2030-12-14,2024-02-24 17:07:26,490.33,payment,192737.63
51291,6563756,79.104.60.195,441.0,port_trm,451,7562,147078192,CREDIT,0,active,2030-12-14,2024-03-11 00:24:11,489.86,payment,192247.77
51292,6577292,46.0.54.45,1072.0,atm,30,1942,147078192,CREDIT,0,active,2030-12-14,2024-03-26 13:58:41,490.28,transfer,191757.49
51293,7185282,185.17.0.240,1067.0,port_trm,25,7462,147078192,CREDIT,0,active,2030-12-14,2024-03-27 22:55:48,489.57,country_transfer,191267.92
51294,7359336,185.17.0.240,1067.0,port_trm,25,8134,147078192,CREDIT,0,active,2030-12-14,2024-04-03 20:47:49,489.87,country_transfer,190778.05
51295,7652093,79.104.0.75,641.0,atm,25,9959,147078192,CREDIT,0,active,2030-12-14,2024-05-08 09:25:48,489.99,country_transfer,190288.06
51296,8185296,79.104.0.75,641.0,atm,-1,8033,147078192,CREDIT,1,active,2030-12-14,2024-05-11 07:20:43,489.93,bad,190288.06
51297,8371660,79.104.0.75,641.0,atm,451,9482,147078192,CREDIT,0,active,2030-12-14,2024-05-18 01:07:21,490.04,payment,189798.02
51298,8447655,188.0.189.240,851.0,cash_in,30,9482,147078192,CREDIT,0,active,2030-12-14,2024-06-01 05:51:43,490.14,transfer,189307.88
51299,8549474,79.104.0.0,634.0,cash_in,451,1796,147078192,CREDIT,0,active,2030-12-14,2024-06-28 06:46:23,489.81,payment,188818.07
51300,8808904,37.0.127.105,1029.0,atm,10,8134,147078192,CREDIT,0,active,2030-12-14,2024-07-08 20:38:14,490.03,add_on_acc,189308.1
51301,8891368,86.111.0.135,1353.0,prtbl trm,30,7902,147078192,CREDIT,0,active,2030-12-14,2024-07-10 11:35:32,489.89,transfer,188818.21
51302,8959862,188.0.189.240,851.0,cash_in,30,7902,147078192,CREDIT,0,active,2030-12-14,2024-08-06 07:56:26,490.12,transfer,188328.09
51303,9035211,86.111.0.135,1353.0,prtbl trm,30,4473,147078192,CREDIT,0,active,2030-12-14,2024-10-06 13:09:15,490.07,transfer,187838.02
51304,9338092,185.17.0.240,1067.0,port_trm,25,5007,147078192,CREDIT,0,active,2030-12-14,2024-11-22 15:08:51,490.04,diff_cntry,187347.98
51305,1458364,95.106.0.240,564.0,ATM,10,6809,171586193,CREDIT,0,active,2030-11-16,2022-01-01 05:03:33,379.12,add_on_acc,851992.12
51306,1522444,194.87.0.165,577.0,atm,-1,5638,171586193,CREDIT,1,active,2030-11-16,2022-01-14 09:04:15,379.06,err,851992.12
51307,1724764,46.8.0.105,774.0,cash_out,20,7469,171586193,CREDIT,0,active,2030-11-16,2022-01-15 19:54:15,378.9,out,851613.22
51308,1807927,46.0.176.195,131.0,prtbl trm,30,8219,171586193,CREDIT,0,active,2030-11-16,2022-01-18 16:35:46,378.98,transfer,851234.24
51309,1860861,193.0.151.0,49.0,pos trm,451,3448,171586193,CREDIT,0,active,2030-11-16,2022-01-30 22:20:48,379.04,payment,850855.2
51310,1910812,37.0.127.195,1036.0,cash_in,25,9306,171586193,CREDIT,0,active,2030-11-16,2022-02-16 12:01:13,378.9,diff_cntry,850476.3
51311,2086269,109.126.0.45,367.0,cash_in,10,3448,171586193,CREDIT,0,active,2030-11-16,2022-03-06 17:30:45,378.92,in_acc,850855.22
51312,2331391,194.87.0.165,577.0,atm,451,8253,171586193,CREDIT,0,active,2030-11-16,2022-03-14 21:02:35,378.72,payment,850476.5
51313,2538733,213.151.0.30,998.0,ATM,10,4851,171586193,CREDIT,0,active,2030-11-16,2022-04-20 11:57:22,378.81,add_on_acc,850855.31
51314,2593903,81.17.0.60,1388.0,cash_in,10,9306,171586193,CREDIT,0,active,2030-11-16,2022-05-14 06:18:10,378.86,add_on_acc,851234.17
51315,2741322,194.87.0.165,577.0,atm,-1,9306,171586193,CREDIT,1,active,2030-11-16,2022-07-02 17:10:41,378.98,err_code,851234.17
51316,2917355,213.151.0.90,1004.0,Portable term,-1,8219,171586193,CREDIT,2,active,2030-11-16,2022-07-26 17:28:34,378.89,bad,851234.17
51317,3172656,185.17.0.105,1053.0,cash_in,10,8219,171586193,CREDIT,0,active,2030-11-16,2022-07-29 17:20:59,379.03,in,851613.2
51318,3428080,37.0.127.195,1036.0,cash_in,451,8213,171586193,CREDIT,0,active,2030-11-16,2022-08-06 01:46:52,379.14,payment,851234.06
51319,3536021,188.244.0.45,1451.0,cash_in,10,7469,171586193,CREDIT,0,active,2030-11-16,2022-08-21 12:24:51,378.79,in,851612.85
51320,3686822,217.112.0.105,1480.0,Portable term,451,3762,171586193,CREDIT,0,active,2030-11-16,2022-09-09 08:13:34,379.13,payment,851233.72
51321,3741080,188.191.0.75,1144.0,cash_out,20,7433,171586193,CREDIT,0,active,2030-11-16,2022-09-22 15:08:45,379.1,from_acc,850854.62
51322,3950269,193.0.151.0,49.0,pos trm,451,8165,171586193,CREDIT,0,active,2030-11-16,2022-09-28 11:51:03,378.86,payment,850475.76
51323,3999162,185.17.0.210,1065.0,atm,20,1715,171586193,CREDIT,0,active,2030-11-16,2022-10-07 02:01:32,378.84,out,850096.92
51324,4109703,194.87.0.165,577.0,atm,451,7038,171586193,CREDIT,0,active,2030-11-16,2022-10-09 04:36:05,378.66,payment,849718.26
51325,4366523,46.0.128.30,701.0,cash_out,25,3481,171586193,CREDIT,0,active,2030-11-16,2022-11-12 04:49:01,378.78,diff_cntry,849339.48
51326,4752496,46.0.176.195,131.0,prtbl trm,30,2432,171586193,CREDIT,0,active,2030-11-16,2022-11-13 10:07:01,378.88,transfer,848960.6
51327,4988437,193.0.151.0,49.0,pos trm,451,5874,171586193,CREDIT,0,active,2030-11-16,2022-12-15 10:55:50,379.02,payment,848581.58
51328,5055268,128.0.94.195,1112.0,cash_in,10,6809,171586193,CREDIT,0,active,2030-11-16,2023-01-22 14:47:33,378.99,add_on_acc,848960.57
51329,6130938,217.112.0.105,1480.0,Portable term,451,4501,171586193,CREDIT,0,active,2030-11-16,2023-02-10 21:17:40,379.14,payment,848581.43
51330,6368227,46.0.128.30,701.0,cash_out,25,4851,171586193,CREDIT,0,active,2030-11-16,2023-02-22 12:18:19,378.81,diff_cntry,848202.62
51331,6550354,37.0.127.195,1036.0,cash_in,-1,8213,171586193,CREDIT,1,active,2030-11-16,2023-04-05 01:37:43,378.95,err,848202.62
51332,6621553,46.0.128.30,701.0,cash_out,451,6809,171586193,CREDIT,0,active,2030-11-16,2023-04-25 12:58:56,378.97,payment,847823.65
51333,6735560,80.234.0.225,427.0,cash_out,20,3481,171586193,CREDIT,0,active,2030-11-16,2023-05-18 20:50:35,378.99,decrease_on_acc,847444.66
51334,6771624,217.112.0.105,1480.0,Portable term,451,7813,171586193,CREDIT,0,active,2030-11-16,2023-06-11 15:49:04,379.19,payment,847065.47
51335,6780825,46.0.128.30,701.0,cash_out,30,2837,171586193,CREDIT,0,active,2030-11-16,2023-06-14 16:05:44,379.02,transfer,846686.45
51336,6885853,37.0.127.195,1036.0,cash_in,451,3990,171586193,CREDIT,0,active,2030-11-16,2023-06-17 01:59:18,379.3,payment,846307.15
51337,6908657,37.0.127.195,1036.0,cash_in,451,8253,171586193,CREDIT,0,active,2030-11-16,2023-06-28 10:25:35,379.18,payment,845927.97
51338,6969791,46.8.0.225,785.0,ATM,10,1715,171586193,CREDIT,0,active,2030-11-16,2023-07-13 02:08:38,379.04,add_on_acc,846307.01
51339,7081644,217.112.0.105,1480.0,Portable term,30,3560,171586193,CREDIT,0,active,2030-11-16,2023-10-09 07:20:34,378.91,transfer,845928.1
51340,7117972,194.87.0.240,585.0,cash_out,20,3481,171586193,CREDIT,0,active,2030-11-16,2023-11-01 08:10:37,379.0,from_acc,845549.1
51341,7515006,188.43.0.0,1404.0,cash_out,20,7221,171586193,CREDIT,0,active,2030-11-16,2023-12-07 02:46:13,378.9,out,845170.2
51342,7576591,194.87.0.165,577.0,atm,25,4501,171586193,CREDIT,0,active,2030-11-16,2023-12-11 19:43:50,378.99,diff_cntry,844791.21
51343,7668069,188.0.0.60,1210.0,ATM,20,5638,171586193,CREDIT,0,active,2030-11-16,2024-01-27 01:09:23,379.06,from_acc,844412.15
51344,7793171,77.242.0.210,287.0,atm,10,4501,171586193,CREDIT,0,active,2030-11-16,2024-03-04 04:49:21,378.73,in_acc,844790.88
51345,7965339,37.0.127.195,1036.0,cash_in,25,8165,171586193,CREDIT,0,active,2030-11-16,2024-03-16 05:51:56,378.79,country_transfer,844412.09
51346,8190006,46.0.176.180,130.0,ATM,20,8219,171586193,CREDIT,0,active,2030-11-16,2024-04-12 03:15:30,379.33,out,844032.76
51347,8687108,193.0.151.0,49.0,pos trm,30,7813,171586193,CREDIT,0,active,2030-11-16,2024-05-30 09:17:09,379.03,transfer,843653.73
51348,8890106,46.0.176.195,131.0,prtbl trm,-1,7469,171586193,CREDIT,1,active,2030-11-16,2024-06-02 21:41:18,379.19,bad,843653.73
51349,8928256,46.0.176.195,131.0,prtbl trm,30,8213,171586193,CREDIT,0,active,2030-11-16,2024-06-09 13:30:01,379.17,transfer,843274.56
51350,8958926,46.0.128.30,701.0,cash_out,30,3481,171586193,CREDIT,0,active,2030-11-16,2024-06-28 06:44:12,378.6,transfer,842895.96
51351,8965724,46.0.176.195,131.0,prtbl trm,30,2837,171586193,CREDIT,0,active,2030-11-16,2024-08-18 22:04:15,378.73,transfer,842517.23
51352,8994215,45.154.0.210,314.0,atm,20,5227,171586193,CREDIT,0,active,2030-11-16,2024-08-30 05:15:08,378.81,out,842138.42
51353,9147686,217.112.0.105,1480.0,Portable term,30,8165,171586193,CREDIT,0,active,2030-11-16,2024-10-05 17:37:38,378.91,transfer,841759.51
51354,9447023,86.111.0.150,1354.0,ATM,20,4675,171586193,CREDIT,0,active,2030-11-16,2024-10-30 03:28:43,379.08,from_acc,841380.43
51355,9573052,188.191.0.15,1140.0,ATM,20,7433,171586193,CREDIT,0,active,2030-11-16,2024-11-04 12:20:52,378.92,from_acc,841001.51
51356,9893715,217.112.0.105,1480.0,Portable term,30,4501,171586193,CREDIT,0,active,2030-11-16,2024-11-13 04:32:29,379.25,transfer,840622.26
51357,9898528,217.112.0.105,1480.0,Portable term,-1,6809,171586193,CREDIT,1,active,2030-11-16,2024-11-16 12:24:12,378.78,bad,840622.26
51358,1086027,188.18.0.0,220.0,atm,20,2226,971886936,DEBIT,0,act,2025-12-16,2022-01-28 03:56:49,1060.1,decrease_on_acc,67817.9
51359,1467000,46.0.143.15,811.0,atm,20,8937,971886936,DEBIT,0,act,2025-12-16,2022-03-20 09:27:38,1060.2,out,66757.7
51360,1492278,194.156.0.15,22.0,pos trm,-1,2671,971886936,DEBIT,1,act,2025-12-16,2022-04-01 13:24:35,1060.08,bad,66757.7
51361,1657798,134.0.98.165,802.0,cash_out,20,4323,971886936,DEBIT,0,act,2025-12-16,2022-04-04 22:17:38,1060.13,out,65697.57
51362,1995479,185.173.0.0,1272.0,atm,20,6919,971886936,DEBIT,0,act,2025-12-16,2022-04-19 11:43:49,1060.27,decrease_on_acc,64637.3
51363,2052172,109.126.0.30,366.0,atm,-1,2466,971886936,DEBIT,1,act,2025-12-16,2022-05-06 12:52:58,1059.92,err,64637.3
51364,2302526,194.156.0.210,39.0,pos trm,-1,4323,971886936,DEBIT,2,act,2025-12-16,2022-05-16 14:05:33,1059.93,bad,64637.3
51365,2361103,109.126.0.30,366.0,atm,451,2591,971886936,DEBIT,0,act,2025-12-16,2022-06-16 15:23:25,1059.6,payment,63577.7
51366,2408245,194.156.0.15,22.0,pos trm,451,8661,971886936,DEBIT,0,act,2025-12-16,2022-06-25 18:12:28,1060.03,payment,62517.67
51367,2500612,128.0.82.195,630.0,ATM,10,8661,971886936,DEBIT,0,act,2025-12-16,2022-06-28 05:22:43,1060.13,in_acc,63577.8
51368,2691355,62.118.0.135,531.0,ATM,25,6919,971886936,DEBIT,0,act,2025-12-16,2022-07-25 21:46:44,1060.02,country_transfer,62517.78
51369,3052455,95.181.0.45,251.0,prtbl trm,25,8714,971886936,DEBIT,0,act,2025-12-16,2022-08-06 01:42:56,1059.77,diff_cntry,61458.01
51370,3083677,46.0.54.120,1082.0,pos trm,25,4925,971886936,DEBIT,0,act,2025-12-16,2022-08-15 01:49:40,1060.0,country_transfer,60398.01
51371,3162229,62.118.0.135,531.0,ATM,451,2466,971886936,DEBIT,0,act,2025-12-16,2022-08-28 18:11:44,1059.67,payment,59338.34
51372,3213768,194.156.0.15,22.0,pos trm,-1,1376,971886936,DEBIT,1,act,2025-12-16,2022-09-26 08:38:31,1059.97,bad,59338.34
51373,3400557,95.106.0.210,562.0,cash_in,10,2226,971886936,DEBIT,0,act,2025-12-16,2022-11-20 14:57:28,1060.01,in_acc,60398.35
51374,3444334,194.87.0.225,584.0,atm,20,6570,971886936,DEBIT,0,act,2025-12-16,2023-01-10 08:48:16,1059.98,decrease_on_acc,59338.37
51375,3493360,109.126.0.30,366.0,atm,451,2466,971886936,DEBIT,0,act,2025-12-16,2023-02-26 06:24:35,1059.91,payment,58278.46
51376,3992929,79.104.0.240,653.0,cash_in,10,1211,971886936,DEBIT,0,act,2025-12-16,2023-03-26 18:13:27,1059.83,in_acc,59338.29
51377,4095328,213.151.0.0,996.0,atm,20,4323,971886936,DEBIT,0,act,2025-12-16,2023-06-06 15:16:05,1060.09,from_acc,58278.2
51378,4505332,95.181.0.45,251.0,prtbl trm,451,4961,971886936,DEBIT,0,act,2025-12-16,2023-06-29 23:59:29,1059.98,payment,57218.22
51379,4608123,194.156.0.15,22.0,pos trm,451,1376,971886936,DEBIT,0,act,2025-12-16,2023-07-19 06:58:24,1059.96,payment,56158.26
51380,4886343,95.106.0.75,549.0,cash_in,10,1376,971886936,DEBIT,0,act,2025-12-16,2023-09-03 03:43:57,1060.15,in,57218.41
51381,4985284,109.126.0.30,366.0,atm,30,2226,971886936,DEBIT,0,act,2025-12-16,2023-09-13 21:39:23,1059.91,transfer,56158.5
51382,5052245,62.118.0.135,531.0,ATM,30,4323,971886936,DEBIT,0,act,2025-12-16,2023-09-15 19:58:11,1060.02,transfer,55098.48
51383,5647105,194.156.0.210,39.0,pos trm,-1,1376,971886936,DEBIT,1,act,2025-12-16,2023-10-18 23:06:58,1059.8,err_code,55098.48
51384,5706480,46.0.8.135,147.0,atm,10,2226,971886936,DEBIT,0,act,2025-12-16,2023-10-22 13:59:21,1060.13,in_acc,56158.61
51385,5945755,46.0.54.120,1082.0,pos trm,451,2466,971886936,DEBIT,0,act,2025-12-16,2023-10-27 19:07:09,1059.83,payment,55098.78
51386,6099679,194.156.0.210,39.0,pos trm,-1,8661,971886936,DEBIT,1,act,2025-12-16,2023-11-03 05:17:35,1059.9,bad,55098.78
51387,6426648,78.24.158.249,951.0,atm,20,8671,971886936,DEBIT,0,act,2025-12-16,2023-11-09 19:06:27,1060.47,decrease_on_acc,54038.31
51388,6599493,194.156.0.210,39.0,pos trm,-1,2466,971886936,DEBIT,1,act,2025-12-16,2023-11-24 01:13:04,1060.07,err_code,54038.31
51389,6624273,46.0.54.120,1082.0,pos trm,-1,4961,971886936,DEBIT,2,act,2025-12-16,2024-01-19 07:04:08,1060.03,err,54038.31
51390,6640663,95.181.0.45,251.0,prtbl trm,451,6919,971886936,DEBIT,0,act,2025-12-16,2024-01-22 17:11:30,1060.17,payment,52978.14
51391,6771180,78.24.158.24,931.0,ATM,10,8719,971886936,DEBIT,0,act,2025-12-16,2024-03-15 09:27:58,1059.84,add_on_acc,54037.98
51392,6807506,194.156.0.15,22.0,pos trm,30,5631,971886936,DEBIT,0,act,2025-12-16,2024-04-01 11:18:49,1059.69,transfer,52978.29
51393,7146247,193.0.151.150,64.0,ATM,10,2226,971886936,DEBIT,0,act,2025-12-16,2024-04-03 02:24:50,1060.3,in,54038.59
51394,7637850,46.0.54.120,1082.0,pos trm,30,8671,971886936,DEBIT,0,act,2025-12-16,2024-05-10 00:50:07,1059.89,transfer,52978.7
51395,7664022,194.156.0.210,39.0,pos trm,451,8714,971886936,DEBIT,0,act,2025-12-16,2024-05-13 07:31:23,1060.1,payment,51918.6
51396,8339562,194.156.0.210,39.0,pos trm,30,2671,971886936,DEBIT,0,act,2025-12-16,2024-05-21 10:15:06,1060.45,transfer,50858.15
51397,8406084,46.0.54.120,1082.0,pos trm,25,2226,971886936,DEBIT,0,act,2025-12-16,2024-05-31 10:58:42,1059.82,diff_cntry,49798.33
51398,8966724,217.112.0.150,1483.0,ATM,20,6919,971886936,DEBIT,0,act,2025-12-16,2024-06-28 01:51:12,1059.66,from_acc,48738.67
51399,8988492,91.107.0.180,990.0,atm,10,6570,971886936,DEBIT,0,act,2025-12-16,2024-07-12 18:04:40,1059.75,in,49798.42
51400,9159629,194.156.0.15,22.0,pos trm,30,5631,971886936,DEBIT,0,act,2025-12-16,2024-07-31 08:17:34,1059.99,transfer,48738.43
51401,9224634,194.156.0.15,22.0,pos trm,30,8671,971886936,DEBIT,0,act,2025-12-16,2024-08-29 16:16:27,1059.85,transfer,47678.58
51402,9239263,46.0.54.120,1082.0,pos trm,25,4961,971886936,DEBIT,0,act,2025-12-16,2024-09-04 08:53:22,1059.85,diff_cntry,46618.73
51403,9356103,46.0.176.165,129.0,ATM,20,4323,971886936,DEBIT,0,act,2025-12-16,2024-09-16 07:17:42,1060.22,out,45558.51
51404,9419026,79.104.0.240,653.0,cash_in,10,2466,971886936,DEBIT,0,act,2025-12-16,2024-09-27 20:46:05,1059.91,in_acc,46618.42
51405,9550860,217.112.0.150,1483.0,ATM,10,8719,971886936,DEBIT,0,act,2025-12-16,2024-11-08 16:31:59,1059.85,in,47678.27
51406,9774253,194.156.0.210,39.0,pos trm,25,8719,971886936,DEBIT,0,act,2025-12-16,2024-11-13 05:50:56,1059.95,country_transfer,46618.32
51407,9972783,194.156.0.210,39.0,pos trm,451,4925,971886936,DEBIT,0,act,2025-12-16,2024-11-13 13:52:50,1059.84,payment,45558.48
51408,1107763,95.181.0.150,259.0,port_trm,-1,6359,394801746,DEBIT,1,act,2028-07-17,2022-01-28 21:45:52,534.88,err_code,960055.0
51409,1337605,193.31.0.60,591.0,atm,10,5003,394801746,DEBIT,0,act,2028-07-17,2022-02-20 09:24:07,534.93,in_acc,960589.93
51410,1423245,95.181.0.150,259.0,port_trm,-1,7198,394801746,DEBIT,1,act,2028-07-17,2022-03-08 17:35:35,535.18,err_code,960589.93
51411,1892524,91.107.0.135,987.0,Portable term,-1,5003,394801746,DEBIT,2,act,2028-07-17,2022-03-16 14:39:22,535.15,bad,960589.93
51412,1960787,91.107.0.135,987.0,Portable term,451,3036,394801746,DEBIT,0,act,2028-07-17,2022-04-15 07:01:01,535.15,payment,960054.78
51413,2108239,95.181.0.150,259.0,port_trm,451,5629,394801746,DEBIT,0,act,2028-07-17,2022-04-18 00:18:13,534.88,payment,959519.9
51414,2193690,77.242.0.150,282.0,cash_out,30,7263,394801746,DEBIT,0,act,2028-07-17,2022-04-24 13:58:06,535.03,transfer,958984.87
51415,2369701,46.0.0.105,662.0,cash_in,30,8868,394801746,DEBIT,0,act,2028-07-17,2022-04-26 18:33:00,535.1,transfer,958449.77
51416,2611160,78.24.158.189,947.0,cash_out,20,3276,394801746,DEBIT,0,act,2028-07-17,2022-05-23 18:19:45,535.02,from_acc,957914.75
51417,2816621,46.0.0.105,662.0,cash_in,30,3276,394801746,DEBIT,0,act,2028-07-17,2022-06-15 06:19:54,535.01,transfer,957379.74
51418,2940352,212.20.0.30,448.0,ATM,20,2198,394801746,DEBIT,0,act,2028-07-17,2022-06-26 02:21:45,535.15,decrease_on_acc,956844.59
51419,2948456,46.0.0.105,662.0,cash_in,30,3036,394801746,DEBIT,0,act,2028-07-17,2022-07-09 19:41:53,534.88,transfer,956309.71
51420,3028934,37.0.124.195,734.0,ATM,10,3801,394801746,DEBIT,0,act,2028-07-17,2022-08-10 03:39:50,535.22,in_acc,956844.93
51421,3416655,46.0.0.105,662.0,cash_in,451,5629,394801746,DEBIT,0,act,2028-07-17,2022-08-30 12:16:22,535.17,payment,956309.76
51422,3745516,109.126.0.165,377.0,port_trm,25,6474,394801746,DEBIT,0,act,2028-07-17,2022-09-12 17:58:59,535.02,country_transfer,955774.74
51423,3875832,37.0.127.120,1030.0,Portable term,-1,3036,394801746,DEBIT,1,act,2028-07-17,2022-09-25 21:09:31,534.93,err_code,955774.74
51424,3941834,46.0.0.105,662.0,cash_in,30,6512,394801746,DEBIT,0,act,2028-07-17,2022-10-02 02:15:24,535.13,transfer,955239.61
51425,3987325,37.0.127.120,1030.0,Portable term,451,8868,394801746,DEBIT,0,act,2028-07-17,2022-10-13 22:26:56,534.79,payment,954704.82
51426,4188716,193.0.151.90,58.0,cash_out,20,7263,394801746,DEBIT,0,act,2028-07-17,2022-11-23 14:27:37,534.76,from_acc,954170.06
51427,4293152,77.242.0.150,282.0,cash_out,451,6130,394801746,DEBIT,0,act,2028-07-17,2023-01-17 06:23:07,534.97,payment,953635.09
51428,4518050,37.0.127.120,1030.0,Portable term,25,4997,394801746,DEBIT,0,act,2028-07-17,2023-01-19 06:00:01,534.91,diff_cntry,953100.18
51429,4580520,91.107.0.135,987.0,Portable term,30,3036,394801746,DEBIT,0,act,2028-07-17,2023-05-15 05:16:03,534.67,transfer,952565.51
51430,4603063,77.242.0.150,282.0,cash_out,-1,6508,394801746,DEBIT,1,act,2028-07-17,2023-05-31 09:33:08,534.88,err_code,952565.51
51431,4751731,88.210.0.15,341.0,atm,30,3722,394801746,DEBIT,0,act,2028-07-17,2023-06-12 10:08:00,535.06,transfer,952030.45
51432,4758599,37.0.127.120,1030.0,Portable term,451,3722,394801746,DEBIT,0,act,2028-07-17,2023-07-19 03:00:05,534.72,payment,951495.73
51433,4828814,91.107.0.135,987.0,Portable term,451,9492,394801746,DEBIT,0,act,2028-07-17,2023-08-06 13:54:17,534.91,payment,950960.82
51434,5360614,151.0.38.120,398.0,ATM,20,3276,394801746,DEBIT,0,act,2028-07-17,2023-08-22 05:54:50,535.07,out,950425.75
51435,5950160,46.0.0.105,662.0,cash_in,451,5003,394801746,DEBIT,0,act,2028-07-17,2023-08-24 10:37:42,535.1,payment,949890.65
51436,6328964,37.0.127.120,1030.0,Portable term,451,7263,394801746,DEBIT,0,act,2028-07-17,2023-09-04 08:28:33,535.08,payment,949355.57
51437,6369215,194.0.162.210,757.0,ATM,10,5588,394801746,DEBIT,0,act,2028-07-17,2023-09-23 14:32:40,534.8,in_acc,949890.37
51438,6407631,188.0.166.210,1314.0,cash_out,20,6820,394801746,DEBIT,0,act,2028-07-17,2023-10-01 12:08:16,535.03,out,949355.34
51439,6552391,37.0.127.120,1030.0,Portable term,451,9492,394801746,DEBIT,0,act,2028-07-17,2023-10-05 04:35:45,534.92,payment,948820.42
51440,6940595,194.156.0.165,34.0,cash_in,10,7990,394801746,DEBIT,0,act,2028-07-17,2023-10-10 21:06:42,535.09,add_on_acc,949355.51
51441,7112619,188.0.166.210,1314.0,cash_out,20,6820,394801746,DEBIT,0,act,2028-07-17,2023-10-13 20:39:24,534.87,from_acc,948820.64
51442,7252565,194.87.0.120,574.0,cash_out,20,3036,394801746,DEBIT,0,act,2028-07-17,2023-12-10 05:33:55,535.27,from_acc,948285.37
51443,7385806,37.0.127.120,1030.0,Portable term,25,7990,394801746,DEBIT,0,act,2028-07-17,2023-12-27 13:54:27,534.85,country_transfer,947750.52
51444,7392429,213.151.0.165,1012.0,atm,10,5359,394801746,DEBIT,0,act,2028-07-17,2024-01-08 20:58:50,534.77,in_acc,948285.29
51445,7698140,77.242.0.150,282.0,cash_out,451,6512,394801746,DEBIT,0,act,2028-07-17,2024-01-16 21:41:06,535.09,payment,947750.2
51446,7833161,91.107.0.135,987.0,Portable term,30,6359,394801746,DEBIT,0,act,2028-07-17,2024-01-24 19:43:22,534.91,transfer,947215.29
51447,8076430,77.242.0.150,282.0,cash_out,25,8868,394801746,DEBIT,0,act,2028-07-17,2024-02-25 10:26:37,535.26,country_transfer,946680.03
51448,8259984,5.189.0.150,867.0,ATM,20,1973,394801746,DEBIT,0,act,2028-07-17,2024-02-27 15:23:46,534.99,decrease_on_acc,946145.04
51449,8503864,88.210.0.150,355.0,cash_in,10,7014,394801746,DEBIT,0,act,2028-07-17,2024-04-05 02:01:04,534.94,in_acc,946679.98
51450,8600027,46.0.0.105,662.0,cash_in,451,3722,394801746,DEBIT,0,act,2028-07-17,2024-04-21 23:55:28,534.91,payment,946145.07
51451,8725160,46.0.0.105,662.0,cash_in,25,5801,394801746,DEBIT,0,act,2028-07-17,2024-04-27 15:30:55,534.89,diff_cntry,945610.18
51452,8784026,91.107.0.135,987.0,Portable term,25,6512,394801746,DEBIT,0,act,2028-07-17,2024-05-11 21:12:27,535.03,diff_cntry,945075.15
51453,8829614,91.107.0.135,987.0,Portable term,30,7198,394801746,DEBIT,0,act,2028-07-17,2024-07-01 10:48:39,535.03,transfer,944540.12
51454,8888773,88.210.0.15,341.0,atm,-1,8206,394801746,DEBIT,1,act,2028-07-17,2024-07-16 10:31:00,534.84,err_code,944540.12
51455,8999585,109.126.0.165,377.0,port_trm,30,5801,394801746,DEBIT,0,act,2028-07-17,2024-07-30 10:49:08,535.01,transfer,944005.11
51456,9002547,79.104.0.60,640.0,Portable term,451,2050,394801746,DEBIT,0,act,2028-07-17,2024-08-09 05:21:39,534.89,payment,943470.22
51457,9410836,88.210.0.15,341.0,atm,25,1973,394801746,DEBIT,0,act,2028-07-17,2024-09-08 12:04:35,534.82,country_transfer,942935.4
51458,9564325,109.126.0.165,377.0,port_trm,30,5359,394801746,DEBIT,0,act,2028-07-17,2024-09-09 12:51:08,534.8,transfer,942400.6
51459,9847179,109.126.0.165,377.0,port_trm,-1,5359,394801746,DEBIT,1,act,2028-07-17,2024-11-24 02:05:37,535.04,bad,942400.6
51460,1069052,188.0.169.210,484.0,atm,451,6617,724547962,DEBIT,0,active,2025-02-03,2022-01-07 23:34:26,310.39,payment,802604.61
51461,1187980,80.234.0.0,410.0,prtbl trm,451,4192,724547962,DEBIT,0,active,2025-02-03,2022-01-15 12:43:28,310.21,payment,802294.4
51462,1227293,80.234.0.0,410.0,prtbl trm,451,4068,724547962,DEBIT,0,active,2025-02-03,2022-01-21 03:23:13,309.88,payment,801984.52
51463,1234158,46.0.9.180,1333.0,Portable term,25,1222,724547962,DEBIT,0,active,2025-02-03,2022-02-28 05:10:22,310.16,country_transfer,801674.36
51464,1461596,188.0.169.210,484.0,atm,451,9776,724547962,DEBIT,0,active,2025-02-03,2022-03-08 17:06:09,310.02,payment,801364.34
51465,1754960,5.189.0.210,874.0,Portable term,-1,7950,724547962,DEBIT,1,active,2025-02-03,2022-04-28 23:04:52,309.89,err,801364.34
51466,1932889,95.106.0.75,549.0,cash_in,10,6907,724547962,DEBIT,0,active,2025-02-03,2022-05-18 04:56:21,310.09,in,801674.43
51467,2080905,46.0.2.135,191.0,pos trm,30,5884,724547962,DEBIT,0,active,2025-02-03,2022-05-28 11:16:37,310.06,transfer,801364.37
51468,2119350,212.20.0.225,465.0,atm,10,1864,724547962,DEBIT,0,active,2025-02-03,2022-06-02 01:12:37,310.17,in,801674.54
51469,2239469,46.0.2.135,191.0,pos trm,25,5884,724547962,DEBIT,0,active,2025-02-03,2022-06-02 15:34:47,309.79,diff_cntry,801364.75
51470,2257766,91.107.0.225,994.0,prtbl trm,451,8572,724547962,DEBIT,0,active,2025-02-03,2022-07-18 13:52:05,309.96,payment,801054.79
51471,2414217,37.0.123.15,319.0,atm,20,1864,724547962,DEBIT,0,active,2025-02-03,2022-09-10 07:50:48,309.84,from_acc,800744.95
51472,2742163,80.234.0.0,410.0,prtbl trm,25,8036,724547962,DEBIT,0,active,2025-02-03,2022-11-20 02:35:13,309.68,diff_cntry,800435.27
51473,2840807,46.0.176.180,130.0,ATM,-1,1073,724547962,DEBIT,1,active,2025-02-03,2022-11-20 03:55:15,310.4,bad,800435.27
51474,3042697,80.234.0.0,410.0,prtbl trm,451,6300,724547962,DEBIT,0,active,2025-02-03,2022-12-03 09:08:59,309.89,payment,800125.38
51475,3145355,188.0.169.210,484.0,atm,30,5884,724547962,DEBIT,0,active,2025-02-03,2022-12-14 09:10:59,309.7,transfer,799815.68
51476,3228604,95.167.0.225,218.0,ATM,20,9724,724547962,DEBIT,0,active,2025-02-03,2022-12-22 06:01:21,310.09,from_acc,799505.59
51477,3537548,46.0.176.180,130.0,ATM,-1,1222,724547962,DEBIT,1,active,2025-02-03,2023-01-20 02:17:58,309.63,bad,799505.59
51478,3637047,188.18.0.0,220.0,atm,20,6907,724547962,DEBIT,0,active,2025-02-03,2023-01-31 08:43:31,309.93,from_acc,799195.66
51479,3776702,217.26.0.195,694.0,cash_out,20,5884,724547962,DEBIT,0,active,2025-02-03,2023-02-23 10:04:28,309.93,decrease_on_acc,798885.73
51480,3914387,188.0.166.225,1315.0,atm,20,9724,724547962,DEBIT,0,active,2025-02-03,2023-03-19 18:39:38,309.56,out,798576.17
51481,3967376,80.234.0.135,420.0,prtbl trm,451,6300,724547962,DEBIT,0,active,2025-02-03,2023-03-28 18:31:04,309.97,payment,798266.2
51482,4291797,80.234.0.0,410.0,prtbl trm,-1,1073,724547962,DEBIT,1,active,2025-02-03,2023-04-13 07:52:23,310.09,bad,798266.2
51483,4512577,91.107.0.225,994.0,prtbl trm,30,7950,724547962,DEBIT,0,active,2025-02-03,2023-04-22 14:40:59,310.0,transfer,797956.2
51484,4534792,195.161.0.210,1179.0,atm,20,9724,724547962,DEBIT,0,active,2025-02-03,2023-06-02 04:16:17,309.94,decrease_on_acc,797646.26
51485,4552205,193.31.0.45,589.0,cash_in,10,7950,724547962,DEBIT,0,active,2025-02-03,2023-06-07 10:22:13,309.97,add_on_acc,797956.23
51486,4815650,88.210.0.105,349.0,cash_out,20,4068,724547962,DEBIT,0,active,2025-02-03,2023-07-05 01:06:54,309.9,out,797646.33
51487,4885686,79.104.60.240,444.0,cash_out,20,7530,724547962,DEBIT,0,active,2025-02-03,2023-07-09 02:19:53,310.04,out,797336.29
51488,4926406,80.234.0.0,410.0,prtbl trm,30,1073,724547962,DEBIT,0,active,2025-02-03,2023-07-29 02:47:46,309.88,transfer,797026.41
51489,5191285,46.0.2.135,191.0,pos trm,-1,5204,724547962,DEBIT,1,active,2025-02-03,2023-08-29 03:31:09,310.07,err,797026.41
51490,5191290,91.107.0.225,994.0,prtbl trm,451,5884,724547962,DEBIT,0,active,2025-02-03,2023-08-31 17:43:14,309.78,payment,796716.63
51491,5409274,5.189.0.210,874.0,Portable term,25,2707,724547962,DEBIT,0,active,2025-02-03,2023-09-10 19:56:21,310.21,diff_cntry,796406.42
51492,5544898,188.0.169.210,484.0,atm,25,2707,724547962,DEBIT,0,active,2025-02-03,2023-10-01 10:16:31,309.99,country_transfer,796096.43
51493,5556971,45.154.0.75,300.0,ATM,10,5204,724547962,DEBIT,0,active,2025-02-03,2023-10-08 05:49:32,309.94,in,796406.37
51494,5846641,46.0.9.180,1333.0,Portable term,451,8036,724547962,DEBIT,0,active,2025-02-03,2023-11-21 02:26:09,309.96,payment,796096.41
51495,6178640,46.0.9.180,1333.0,Portable term,451,8850,724547962,DEBIT,0,active,2025-02-03,2023-11-29 02:14:57,309.89,payment,795786.52
51496,6276574,188.0.169.210,484.0,atm,451,4192,724547962,DEBIT,0,active,2025-02-03,2023-12-05 09:19:05,310.16,payment,795476.36
51497,6696012,46.0.2.135,191.0,pos trm,-1,2707,724547962,DEBIT,1,active,2025-02-03,2023-12-20 18:41:24,310.0,err_code,795476.36
51498,6743518,80.234.0.0,410.0,prtbl trm,-1,8323,724547962,DEBIT,2,active,2025-02-03,2024-01-21 02:38:00,309.57,err,795476.36
51499,6849433,91.107.0.225,994.0,prtbl trm,30,1898,724547962,DEBIT,0,active,2025-02-03,2024-01-22 16:17:01,310.22,transfer,795166.14
51500,6962961,151.0.38.195,404.0,cash_in,10,1973,724547962,DEBIT,0,active,2025-02-03,2024-02-23 22:25:39,309.85,in,795475.99
51501,7254083,5.189.0.210,874.0,Portable term,30,4684,724547962,DEBIT,0,active,2025-02-03,2024-03-05 00:58:12,309.84,transfer,795166.15
51502,7377819,188.0.169.210,484.0,atm,451,8572,724547962,DEBIT,0,active,2025-02-03,2024-03-13 00:38:43,310.26,payment,794855.89
51503,7609267,46.0.176.180,130.0,ATM,451,4449,724547962,DEBIT,0,active,2025-02-03,2024-03-18 16:01:03,309.82,payment,794546.07
51504,7680940,195.58.0.135,1436.0,atm,10,5884,724547962,DEBIT,0,active,2025-02-03,2024-04-03 10:12:53,310.0,in,794856.07
51505,7698981,217.26.0.45,677.0,ATM,20,1864,724547962,DEBIT,0,active,2025-02-03,2024-04-29 13:59:51,310.02,out,794546.05
51506,7857386,46.0.2.135,191.0,pos trm,25,7950,724547962,DEBIT,0,active,2025-02-03,2024-05-11 20:57:11,310.07,diff_cntry,794235.98
51507,7947120,46.0.176.180,130.0,ATM,-1,4684,724547962,DEBIT,1,active,2025-02-03,2024-05-13 22:45:25,310.03,err_code,794235.98
51508,8221931,62.118.0.75,525.0,ATM,20,1864,724547962,DEBIT,0,active,2025-02-03,2024-05-25 15:28:01,310.13,decrease_on_acc,793925.85
51509,8240717,46.0.2.135,191.0,pos trm,25,5204,724547962,DEBIT,0,active,2025-02-03,2024-05-27 09:45:55,309.96,diff_cntry,793615.89
51510,8489850,46.0.176.180,130.0,ATM,30,9271,724547962,DEBIT,0,active,2025-02-03,2024-06-12 00:08:48,309.78,transfer,793306.11
51511,8859076,188.0.169.210,484.0,atm,-1,8850,724547962,DEBIT,1,active,2025-02-03,2024-06-18 03:12:00,310.16,err,793306.11
51512,8931415,91.107.0.225,994.0,prtbl trm,451,1898,724547962,DEBIT,0,active,2025-02-03,2024-07-19 07:03:34,309.86,payment,792996.25
51513,9144336,46.0.143.105,819.0,cash_out,20,8036,724547962,DEBIT,0,active,2025-02-03,2024-08-01 13:09:55,309.99,from_acc,792686.26
51514,9449731,80.234.0.0,410.0,prtbl trm,451,1973,724547962,DEBIT,0,active,2025-02-03,2024-08-17 00:02:12,310.03,payment,792376.23
51515,9462071,95.106.0.90,550.0,atm,20,9724,724547962,DEBIT,0,active,2025-02-03,2024-08-23 03:48:31,310.23,from_acc,792066.0
51516,9606808,80.234.0.0,410.0,prtbl trm,451,1864,724547962,DEBIT,0,active,2025-02-03,2024-10-15 01:51:16,310.01,payment,791755.99
51517,9885472,46.0.9.180,1333.0,Portable term,451,6907,724547962,DEBIT,0,active,2025-02-03,2024-10-20 04:13:15,309.76,payment,791446.23
51518,9937678,80.234.0.0,410.0,prtbl trm,-1,4449,724547962,DEBIT,1,active,2025-02-03,2024-11-17 10:20:54,309.95,bad,791446.23
51519,1020002,195.58.0.30,1426.0,cash_in,10,7240,932383991,CREDIT,0,act,2025-02-06,2022-01-13 00:12:37,910.03,in,802683.03
51520,1296654,46.0.9.45,1320.0,pos trm,-1,2805,932383991,CREDIT,1,act,2025-02-06,2022-03-17 16:59:15,909.77,err_code,802683.03
51521,1428190,109.126.0.180,378.0,atm,30,2805,932383991,CREDIT,0,act,2025-02-06,2022-06-17 14:11:44,910.11,transfer,801772.92
51522,1711360,46.0.9.45,1320.0,pos trm,451,6782,932383991,CREDIT,0,act,2025-02-06,2022-07-22 15:22:29,909.83,payment,800863.09
51523,1793557,95.106.0.105,551.0,atm,451,3639,932383991,CREDIT,0,act,2025-02-06,2022-07-27 18:09:04,910.09,payment,799953.0
51524,2093070,95.106.0.180,560.0,cash_out,30,1911,932383991,CREDIT,0,act,2025-02-06,2022-09-20 21:44:10,910.02,transfer,799042.98
51525,2152334,109.126.0.180,378.0,atm,451,8486,932383991,CREDIT,0,act,2025-02-06,2022-10-17 11:33:30,910.03,payment,798132.95
51526,2230623,95.106.0.180,560.0,cash_out,25,2805,932383991,CREDIT,0,act,2025-02-06,2022-11-12 02:12:56,910.01,diff_cntry,797222.94
51527,2241640,46.0.123.225,929.0,ATM,10,4484,932383991,CREDIT,0,act,2025-02-06,2022-12-13 19:42:03,910.0,in,798132.94
51528,2413431,46.0.54.195,1089.0,atm,20,8983,932383991,CREDIT,0,act,2025-02-06,2022-12-21 03:01:29,910.16,from_acc,797222.78
51529,2826956,95.106.0.180,560.0,cash_out,25,7436,932383991,CREDIT,0,act,2025-02-06,2022-12-21 18:49:57,910.22,diff_cntry,796312.56
51530,2890567,109.126.0.180,378.0,atm,30,9171,932383991,CREDIT,0,act,2025-02-06,2022-12-21 19:37:47,910.05,transfer,795402.51
51531,2901501,188.0.189.45,834.0,ATM,10,3170,932383991,CREDIT,0,act,2025-02-06,2023-01-08 21:10:28,910.24,in,796312.75
51532,3063073,95.106.0.180,560.0,cash_out,-1,2562,932383991,CREDIT,1,act,2025-02-06,2023-01-14 16:01:24,910.11,bad,796312.75
51533,3166096,95.167.0.240,219.0,ATM,10,4336,932383991,CREDIT,0,act,2025-02-06,2023-02-11 16:42:06,910.17,in_acc,797222.92
51534,3729824,195.58.0.165,1439.0,Portable term,25,8744,932383991,CREDIT,0,act,2025-02-06,2023-02-14 09:52:54,910.26,country_transfer,796312.66
51535,3974165,46.0.176.180,130.0,ATM,10,2562,932383991,CREDIT,0,act,2025-02-06,2023-03-01 03:55:02,909.99,add_on_acc,797222.65
51536,4087357,78.24.158.24,931.0,ATM,20,6782,932383991,CREDIT,0,act,2025-02-06,2023-03-09 01:30:50,909.99,from_acc,796312.66
51537,4158360,193.0.151.15,51.0,ATM,20,5505,932383991,CREDIT,0,act,2025-02-06,2023-03-20 02:42:00,910.01,out,795402.65
51538,4492655,95.167.0.75,205.0,ATM,10,1346,932383991,CREDIT,0,act,2025-02-06,2023-04-05 01:10:32,909.86,in,796312.51
51539,4676786,95.106.0.180,560.0,cash_out,25,1841,932383991,CREDIT,0,act,2025-02-06,2023-04-12 15:45:55,910.0,diff_cntry,795402.51
51540,4704815,46.0.9.45,1320.0,pos trm,25,6782,932383991,CREDIT,0,act,2025-02-06,2023-04-12 18:22:41,909.79,country_transfer,794492.72
51541,4874558,95.106.0.105,551.0,atm,451,7240,932383991,CREDIT,0,act,2025-02-06,2023-04-29 18:59:16,910.25,payment,793582.47
51542,5019551,95.106.0.105,551.0,atm,451,2805,932383991,CREDIT,0,act,2025-02-06,2023-05-17 08:01:17,909.88,payment,792672.59
51543,5471281,46.0.0.210,670.0,ATM,10,2805,932383991,CREDIT,0,act,2025-02-06,2023-06-15 06:33:29,909.84,in_acc,793582.43
51544,5650814,109.126.0.180,378.0,atm,-1,3170,932383991,CREDIT,1,act,2025-02-06,2023-07-04 04:17:29,909.94,bad,793582.43
51545,5806035,195.58.0.165,1439.0,Portable term,25,4362,932383991,CREDIT,0,act,2025-02-06,2023-07-19 10:12:06,910.07,country_transfer,792672.36
51546,5874329,109.126.0.180,378.0,atm,30,8734,932383991,CREDIT,0,act,2025-02-06,2023-09-11 05:24:53,910.05,transfer,791762.31
51547,6160675,195.58.0.165,1439.0,Portable term,25,4362,932383991,CREDIT,0,act,2025-02-06,2023-09-18 12:44:51,909.84,country_transfer,790852.47
51548,6526913,46.0.9.120,1325.0,ATM,20,7240,932383991,CREDIT,0,act,2025-02-06,2023-10-19 05:25:23,909.76,decrease_on_acc,789942.71
51549,6593448,195.161.0.0,1162.0,cash_out,20,6440,932383991,CREDIT,0,act,2025-02-06,2023-11-05 16:10:24,909.93,from_acc,789032.78
51550,6670861,109.126.0.180,378.0,atm,25,4484,932383991,CREDIT,0,act,2025-02-06,2023-11-17 12:49:07,910.21,diff_cntry,788122.57
51551,6880611,46.0.9.45,1320.0,pos trm,-1,3170,932383991,CREDIT,1,act,2025-02-06,2023-12-07 00:01:32,909.94,err_code,788122.57
51552,7143216,95.106.0.180,560.0,cash_out,451,5505,932383991,CREDIT,0,act,2025-02-06,2023-12-09 22:24:28,910.12,payment,787212.45
51553,7146535,95.167.0.45,203.0,atm,20,3368,932383991,CREDIT,0,act,2025-02-06,2023-12-31 02:29:40,910.16,decrease_on_acc,786302.29
51554,7203091,95.106.0.180,560.0,cash_out,30,6440,932383991,CREDIT,0,act,2025-02-06,2024-01-08 23:37:31,909.97,transfer,785392.32
51555,7225636,95.106.0.105,551.0,atm,30,1911,932383991,CREDIT,0,act,2025-02-06,2024-01-26 06:02:03,909.98,transfer,784482.34
51556,7391838,95.106.0.180,560.0,cash_out,30,1841,932383991,CREDIT,0,act,2025-02-06,2024-01-28 00:41:58,909.94,transfer,783572.4
51557,7836608,5.189.0.180,871.0,ATM,20,9171,932383991,CREDIT,0,act,2025-02-06,2024-02-03 18:09:20,910.14,from_acc,782662.26
51558,7869982,95.106.0.105,551.0,atm,25,4362,932383991,CREDIT,0,act,2025-02-06,2024-03-15 01:49:46,910.14,country_transfer,781752.12
51559,7904332,95.106.0.180,560.0,cash_out,25,5505,932383991,CREDIT,0,act,2025-02-06,2024-03-21 23:31:27,910.07,country_transfer,780842.05
51560,7949481,95.106.0.105,551.0,atm,451,8744,932383991,CREDIT,0,act,2025-02-06,2024-03-24 00:32:39,910.08,payment,779931.97
51561,8263922,95.106.0.180,560.0,cash_out,25,1346,932383991,CREDIT,0,act,2025-02-06,2024-05-10 16:36:18,909.84,diff_cntry,779022.13
51562,8538329,95.106.0.105,551.0,atm,30,4484,932383991,CREDIT,0,act,2025-02-06,2024-06-06 04:10:25,910.16,transfer,778111.97
51563,8676839,95.106.0.180,560.0,cash_out,451,1841,932383991,CREDIT,0,act,2025-02-06,2024-07-16 23:30:08,910.1,payment,777201.87
51564,8742704,195.58.0.165,1439.0,Portable term,30,5505,932383991,CREDIT,0,act,2025-02-06,2024-07-25 18:13:32,910.02,transfer,776291.85
51565,8842982,134.0.98.75,796.0,cash_out,20,9171,932383991,CREDIT,0,act,2025-02-06,2024-08-03 19:21:51,909.96,decrease_on_acc,775381.89
51566,9218868,95.106.0.180,560.0,cash_out,451,1346,932383991,CREDIT,0,act,2025-02-06,2024-09-12 08:10:30,910.14,payment,774471.75
51567,9307918,185.233.0.60,81.0,ATM,10,9662,932383991,CREDIT,0,act,2025-02-06,2024-09-19 13:14:33,910.02,in_acc,775381.77
51568,9769888,195.58.0.165,1439.0,Portable term,25,8744,932383991,CREDIT,0,act,2025-02-06,2024-10-04 10:54:37,910.17,diff_cntry,774471.6
51569,9794885,46.0.9.45,1320.0,pos trm,30,9662,932383991,CREDIT,0,act,2025-02-06,2024-10-14 13:22:33,910.17,transfer,773561.43
51570,9845293,109.126.0.180,378.0,atm,25,8744,932383991,CREDIT,0,act,2025-02-06,2024-11-01 01:05:51,909.98,diff_cntry,772651.45
51571,1000642,185.17.0.45,1045.0,prtbl trm,25,2755,182676943,DEBIT,0,act,2026-01-09,2022-01-02 21:51:39,597.8,diff_cntry,874365.2
51572,1072007,217.112.0.0,1471.0,ATM,20,8803,182676943,DEBIT,0,act,2026-01-09,2022-02-14 15:43:32,597.85,decrease_on_acc,873767.35
51573,1088543,188.0.166.120,1307.0,ATM,25,5167,182676943,DEBIT,0,act,2026-01-09,2022-02-24 21:29:01,597.8,diff_cntry,873169.55
51574,1497367,95.181.0.165,260.0,atm,20,2755,182676943,DEBIT,0,act,2026-01-09,2022-03-06 12:00:11,597.84,decrease_on_acc,872571.71
51575,1738722,185.17.0.45,1045.0,prtbl trm,451,7344,182676943,DEBIT,0,act,2026-01-09,2022-04-15 16:21:39,598.17,payment,871973.54
51576,1846736,194.156.0.120,30.0,prtbl trm,25,2568,182676943,DEBIT,0,act,2026-01-09,2022-04-30 13:09:16,597.94,diff_cntry,871375.6
51577,1877637,213.151.0.105,1007.0,cash_out,20,5962,182676943,DEBIT,0,act,2026-01-09,2022-05-25 15:15:59,597.86,decrease_on_acc,870777.74
51578,1902550,185.17.0.45,1045.0,prtbl trm,-1,5165,182676943,DEBIT,1,act,2026-01-09,2022-06-05 14:45:11,597.97,err,870777.74
51579,2298265,188.191.0.15,1140.0,ATM,20,2568,182676943,DEBIT,0,act,2026-01-09,2022-06-06 06:44:41,597.91,from_acc,870179.83
51580,2313457,62.118.0.15,520.0,prtbl trm,451,2568,182676943,DEBIT,0,act,2026-01-09,2022-08-24 08:27:05,598.34,payment,869581.49
51581,2635292,188.0.169.165,480.0,atm,10,7619,182676943,DEBIT,0,act,2026-01-09,2022-09-04 02:25:02,597.85,in_acc,870179.34
51582,3004758,109.126.0.75,370.0,prtbl trm,451,8803,182676943,DEBIT,0,act,2026-01-09,2022-11-05 11:56:36,597.77,payment,869581.57
51583,3253912,46.0.8.150,148.0,cash_in,10,9513,182676943,DEBIT,0,act,2026-01-09,2022-11-08 09:50:44,598.13,add_on_acc,870179.7
51584,4053942,78.24.158.99,939.0,atm,30,2430,182676943,DEBIT,0,act,2026-01-09,2023-01-03 05:52:22,598.24,transfer,869581.46
51585,4552149,194.156.0.120,30.0,prtbl trm,30,6365,182676943,DEBIT,0,act,2026-01-09,2023-01-14 03:16:22,597.86,transfer,868983.6
51586,4874400,185.17.0.45,1045.0,prtbl trm,451,9513,182676943,DEBIT,0,act,2026-01-09,2023-02-05 09:43:10,598.12,payment,868385.48
51587,4896701,37.0.123.15,319.0,atm,20,6497,182676943,DEBIT,0,act,2026-01-09,2023-02-20 15:34:28,597.83,decrease_on_acc,867787.65
51588,4896978,46.0.143.180,825.0,cash_out,20,7344,182676943,DEBIT,0,act,2026-01-09,2023-03-02 19:31:53,598.04,from_acc,867189.61
51589,5393916,37.0.124.210,735.0,cash_in,10,2755,182676943,DEBIT,0,act,2026-01-09,2023-04-04 11:04:34,598.0,add_on_acc,867787.61
51590,5452734,46.0.123.75,916.0,ATM,451,6868,182676943,DEBIT,0,act,2026-01-09,2023-05-09 02:47:08,598.29,payment,867189.32
51591,5618933,185.17.0.45,1045.0,prtbl trm,30,6497,182676943,DEBIT,0,act,2026-01-09,2023-07-16 20:39:27,597.71,transfer,866591.61
51592,5627800,128.0.24.30,882.0,atm,10,6868,182676943,DEBIT,0,act,2026-01-09,2023-07-18 01:31:35,598.05,in_acc,867189.66
51593,5633468,46.0.123.75,916.0,ATM,451,4880,182676943,DEBIT,0,act,2026-01-09,2023-07-29 03:44:58,597.92,payment,866591.74
51594,5803984,109.126.0.75,370.0,prtbl trm,451,2096,182676943,DEBIT,0,act,2026-01-09,2023-08-30 01:26:53,598.09,payment,865993.65
51595,5819551,78.24.158.99,939.0,atm,30,8037,182676943,DEBIT,0,act,2026-01-09,2023-10-01 07:18:51,597.95,transfer,865395.7
51596,5826995,128.0.82.195,630.0,ATM,20,8037,182676943,DEBIT,0,act,2026-01-09,2023-11-03 12:42:27,598.01,decrease_on_acc,864797.69
51597,6469858,128.0.24.135,893.0,Portable term,-1,4178,182676943,DEBIT,1,act,2026-01-09,2023-11-04 13:18:54,597.81,err,864797.69
51598,6784139,188.244.0.60,1454.0,cash_in,10,2712,182676943,DEBIT,0,act,2026-01-09,2023-11-29 23:31:16,598.18,in_acc,865395.87
51599,6807812,128.0.24.165,895.0,ATM,20,7619,182676943,DEBIT,0,act,2026-01-09,2023-12-01 01:06:45,598.04,out,864797.83
51600,6854322,109.126.0.75,370.0,prtbl trm,-1,2712,182676943,DEBIT,1,act,2026-01-09,2023-12-02 00:10:49,598.07,err_code,864797.83
51601,7298849,95.167.0.240,219.0,ATM,20,2712,182676943,DEBIT,0,act,2026-01-09,2024-01-10 03:48:42,598.01,decrease_on_acc,864199.82
51602,7393578,109.126.0.75,370.0,prtbl trm,451,2755,182676943,DEBIT,0,act,2026-01-09,2024-01-15 20:29:05,597.94,payment,863601.88
51603,7576182,128.0.24.240,907.0,atm,20,2430,182676943,DEBIT,0,act,2026-01-09,2024-01-20 10:42:18,598.04,from_acc,863003.84
51604,7598295,185.17.0.45,1045.0,prtbl trm,30,7344,182676943,DEBIT,0,act,2026-01-09,2024-02-03 21:59:09,597.95,transfer,862405.89
51605,7667134,46.0.123.75,916.0,ATM,-1,3105,182676943,DEBIT,1,act,2026-01-09,2024-03-08 08:51:30,598.0,bad,862405.89
51606,7672015,94.243.0.15,98.0,ATM,10,8037,182676943,DEBIT,0,act,2026-01-09,2024-03-28 03:39:39,597.88,in_acc,863003.77
51607,7718989,46.0.54.240,1093.0,atm,20,7344,182676943,DEBIT,0,act,2026-01-09,2024-03-31 22:14:07,598.11,from_acc,862405.66
51608,7746964,128.0.24.135,893.0,Portable term,30,5962,182676943,DEBIT,0,act,2026-01-09,2024-05-12 19:04:59,598.0,transfer,861807.66
51609,7809904,194.156.0.120,30.0,prtbl trm,-1,5962,182676943,DEBIT,1,act,2026-01-09,2024-05-16 12:55:01,597.71,err,861807.66
51610,7855764,188.0.166.120,1307.0,ATM,451,2568,182676943,DEBIT,0,act,2026-01-09,2024-06-16 20:02:58,597.97,payment,861209.69
51611,7898505,194.156.0.120,30.0,prtbl trm,451,7761,182676943,DEBIT,0,act,2026-01-09,2024-06-19 17:51:50,598.16,payment,860611.53
51612,7989901,62.118.0.15,520.0,prtbl trm,30,7344,182676943,DEBIT,0,act,2026-01-09,2024-07-04 14:17:41,598.16,transfer,860013.37
51613,8072524,188.0.166.120,1307.0,ATM,25,7619,182676943,DEBIT,0,act,2026-01-09,2024-07-24 08:12:18,597.75,country_transfer,859415.62
51614,8430338,194.156.0.120,30.0,prtbl trm,30,5163,182676943,DEBIT,0,act,2026-01-09,2024-08-02 13:24:53,598.04,transfer,858817.58
51615,8464593,46.0.8.105,145.0,atm,10,2430,182676943,DEBIT,0,act,2026-01-09,2024-08-21 22:35:24,597.73,add_on_acc,859415.31
51616,8510462,185.17.0.30,1044.0,ATM,20,5962,182676943,DEBIT,0,act,2026-01-09,2024-08-29 16:14:46,598.24,from_acc,858817.07
51617,8511726,109.126.0.75,370.0,prtbl trm,451,7761,182676943,DEBIT,0,act,2026-01-09,2024-09-06 12:51:04,597.98,payment,858219.09
51618,8564264,46.0.9.60,1321.0,ATM,20,8037,182676943,DEBIT,0,act,2026-01-09,2024-10-14 06:13:35,598.14,out,857620.95
51619,8686770,46.0.123.105,918.0,cash_out,20,2430,182676943,DEBIT,0,act,2026-01-09,2024-10-29 16:16:45,598.0,decrease_on_acc,857022.95
51620,8695990,128.0.24.135,893.0,Portable term,30,8037,182676943,DEBIT,0,act,2026-01-09,2024-11-01 19:55:17,598.05,transfer,856424.9
51621,9282787,109.126.0.75,370.0,prtbl trm,25,1632,182676943,DEBIT,0,act,2026-01-09,2024-11-02 02:27:41,598.07,diff_cntry,855826.83
51622,9399238,185.17.0.45,1045.0,prtbl trm,-1,4178,182676943,DEBIT,1,act,2026-01-09,2024-11-02 06:27:20,597.53,err,855826.83
51623,9473402,185.17.0.45,1045.0,prtbl trm,30,6497,182676943,DEBIT,0,act,2026-01-09,2024-11-18 19:26:01,597.82,transfer,855229.01
51624,9556884,128.0.24.135,893.0,Portable term,-1,5962,182676943,DEBIT,1,act,2026-01-09,2024-11-23 12:09:06,597.71,bad,855229.01
51625,1006948,78.24.158.84,938.0,Portable term,-1,2932,598582551,CREDIT,1,act,2028-12-25,2022-01-10 14:31:27,146.94,err_code,368526.0
51626,1044003,195.161.0.165,1175.0,cash_out,30,3256,598582551,CREDIT,0,act,2028-12-25,2022-02-06 21:02:08,146.87,transfer,368379.13
51627,1055566,46.0.128.195,714.0,cash_out,451,2615,598582551,CREDIT,0,act,2028-12-25,2022-02-21 04:40:22,147.04,payment,368232.09
51628,1122591,195.58.0.105,1434.0,ATM,20,3256,598582551,CREDIT,0,act,2028-12-25,2022-02-21 22:52:05,146.87,decrease_on_acc,368085.22
51629,1157676,78.24.158.84,938.0,Portable term,451,2004,598582551,CREDIT,0,act,2028-12-25,2022-03-07 05:35:50,147.07,payment,367938.15
51630,1325874,193.31.0.120,597.0,prtbl trm,25,4618,598582551,CREDIT,0,act,2028-12-25,2022-04-08 02:23:49,147.04,country_transfer,367791.11
51631,1621015,194.0.162.0,739.0,cash_in,25,7529,598582551,CREDIT,0,act,2028-12-25,2022-04-16 03:33:13,146.89,country_transfer,367644.22
51632,1778416,88.210.0.180,358.0,prtbl trm,-1,2583,598582551,CREDIT,1,act,2028-12-25,2022-04-18 09:43:33,146.95,err_code,367644.22
51633,1978655,46.0.188.15,1227.0,atm,10,8054,598582551,CREDIT,0,act,2028-12-25,2022-05-22 01:28:03,147.02,add_on_acc,367791.24
51634,2502429,194.156.0.30,23.0,atm,20,5248,598582551,CREDIT,0,act,2028-12-25,2022-06-13 07:43:30,147.21,out,367644.03
51635,2731414,194.0.162.0,739.0,cash_in,-1,7529,598582551,CREDIT,1,act,2028-12-25,2022-06-15 09:18:07,146.93,bad,367644.03
51636,3117813,193.31.0.120,597.0,prtbl trm,-1,8054,598582551,CREDIT,2,act,2028-12-25,2022-06-23 06:16:27,146.93,err,367644.03
51637,3136142,195.143.0.195,1380.0,atm,20,7529,598582551,CREDIT,0,act,2028-12-25,2022-07-03 21:11:45,147.04,out,367496.99
51638,3144793,193.31.0.120,597.0,prtbl trm,451,9181,598582551,CREDIT,0,act,2028-12-25,2022-07-20 17:30:09,146.9,payment,367350.09
51639,3285627,46.0.0.180,667.0,prtbl trm,-1,6359,598582551,CREDIT,1,act,2028-12-25,2022-10-20 15:49:16,146.94,err_code,367350.09
51640,3473567,78.24.158.84,938.0,Portable term,451,1283,598582551,CREDIT,0,act,2028-12-25,2022-10-21 13:59:25,146.93,payment,367203.16
51641,3664799,46.0.128.195,714.0,cash_out,25,7333,598582551,CREDIT,0,act,2028-12-25,2022-11-08 09:58:36,146.93,country_transfer,367056.23
51642,3722967,185.233.0.225,95.0,cash_out,20,8054,598582551,CREDIT,0,act,2028-12-25,2022-12-25 16:39:06,146.92,from_acc,366909.31
51643,3757247,78.24.158.114,940.0,cash_in,10,7529,598582551,CREDIT,0,act,2028-12-25,2022-12-27 19:07:47,146.79,in,367056.1
51644,4072139,45.154.0.180,309.0,atm,-1,2583,598582551,CREDIT,1,act,2028-12-25,2023-01-12 00:02:01,147.13,bad,367056.1
51645,4163651,45.154.0.180,309.0,atm,30,7529,598582551,CREDIT,0,act,2028-12-25,2023-01-25 05:18:16,147.15,transfer,366908.95
51646,4206087,95.106.0.165,558.0,ATM,10,9658,598582551,CREDIT,0,act,2028-12-25,2023-02-27 08:49:55,147.08,in,367056.03
51647,4508764,213.151.0.30,998.0,ATM,20,6359,598582551,CREDIT,0,act,2028-12-25,2023-03-12 02:05:37,147.2,out,366908.83
51648,4555454,193.31.0.120,597.0,prtbl trm,-1,7529,598582551,CREDIT,1,act,2028-12-25,2023-03-20 09:23:51,146.93,err,366908.83
51649,4647469,46.0.0.180,667.0,prtbl trm,-1,6359,598582551,CREDIT,2,act,2028-12-25,2023-04-05 01:46:27,146.96,err_code,366908.83
51650,4647755,195.161.0.30,1164.0,ATM,20,6893,598582551,CREDIT,0,act,2028-12-25,2023-04-08 02:39:21,146.99,decrease_on_acc,366761.84
51651,4825720,78.24.158.84,938.0,Portable term,-1,6857,598582551,CREDIT,1,act,2028-12-25,2023-06-17 19:28:46,147.22,err,366761.84
51652,5052229,45.154.0.180,309.0,atm,30,2932,598582551,CREDIT,0,act,2028-12-25,2023-07-08 12:57:52,146.79,transfer,366615.05
51653,5075664,46.0.128.195,714.0,cash_out,25,8910,598582551,CREDIT,0,act,2028-12-25,2023-07-16 09:46:08,147.13,country_transfer,366467.92
51654,5170829,5.189.0.60,860.0,cash_in,10,7529,598582551,CREDIT,0,act,2028-12-25,2023-07-28 15:18:18,147.0,in,366614.92
51655,5191215,46.0.128.195,714.0,cash_out,30,2932,598582551,CREDIT,0,act,2028-12-25,2023-07-29 17:33:32,146.95,transfer,366467.97
51656,5288817,88.210.0.180,358.0,prtbl trm,25,2932,598582551,CREDIT,0,act,2028-12-25,2023-08-02 00:19:41,147.13,diff_cntry,366320.84
51657,5488447,46.0.0.180,667.0,prtbl trm,451,7830,598582551,CREDIT,0,act,2028-12-25,2023-08-17 03:01:02,147.19,payment,366173.65
51658,5899563,193.31.0.120,597.0,prtbl trm,451,3256,598582551,CREDIT,0,act,2028-12-25,2023-08-17 10:03:41,147.02,payment,366026.63
51659,5965809,45.154.0.180,309.0,atm,30,6893,598582551,CREDIT,0,act,2028-12-25,2023-10-05 08:43:17,147.13,transfer,365879.5
51660,6137630,88.210.0.180,358.0,prtbl trm,25,9451,598582551,CREDIT,0,act,2028-12-25,2023-10-20 22:01:06,146.97,country_transfer,365732.53
51661,6449051,45.154.0.180,309.0,atm,-1,2932,598582551,CREDIT,1,act,2028-12-25,2023-11-13 20:54:19,147.34,bad,365732.53
51662,6696002,188.0.166.75,1304.0,atm,10,3256,598582551,CREDIT,0,act,2028-12-25,2023-11-17 00:59:58,147.02,in,365879.55
51663,6783778,195.161.0.165,1175.0,cash_out,451,9658,598582551,CREDIT,0,act,2028-12-25,2023-11-19 04:07:32,147.22,payment,365732.33
51664,6836325,188.18.0.195,239.0,cash_in,10,7529,598582551,CREDIT,0,act,2028-12-25,2023-12-02 15:32:52,147.02,in,365879.35
51665,7139895,195.161.0.165,1175.0,cash_out,30,6359,598582551,CREDIT,0,act,2028-12-25,2023-12-05 20:44:31,146.96,transfer,365732.39
51666,7210386,95.167.0.180,215.0,ATM,10,9973,598582551,CREDIT,0,act,2028-12-25,2024-02-07 01:57:15,147.24,in_acc,365879.63
51667,7272301,193.31.0.120,597.0,prtbl trm,25,2583,598582551,CREDIT,0,act,2028-12-25,2024-02-19 01:03:53,146.87,diff_cntry,365732.76
51668,7321766,78.24.158.84,938.0,Portable term,25,8054,598582551,CREDIT,0,act,2028-12-25,2024-03-11 03:54:39,147.01,country_transfer,365585.75
51669,7380917,128.0.94.75,1102.0,cash_out,20,5248,598582551,CREDIT,0,act,2028-12-25,2024-04-13 21:30:02,146.95,from_acc,365438.8
51670,7395755,46.0.0.180,667.0,prtbl trm,451,2417,598582551,CREDIT,0,act,2028-12-25,2024-04-16 01:45:59,146.81,payment,365291.99
51671,7593019,78.24.158.84,938.0,Portable term,451,8910,598582551,CREDIT,0,act,2028-12-25,2024-04-17 01:52:32,147.03,payment,365144.96
51672,7746959,193.0.151.150,64.0,ATM,10,7529,598582551,CREDIT,0,act,2028-12-25,2024-04-22 17:21:41,146.96,in_acc,365291.92
51673,7784519,45.154.0.180,309.0,atm,451,9181,598582551,CREDIT,0,act,2028-12-25,2024-05-21 10:38:30,147.08,payment,365144.84
51674,7838918,194.0.162.0,739.0,cash_in,451,1283,598582551,CREDIT,0,act,2028-12-25,2024-06-04 08:19:18,146.98,payment,364997.86
51675,7877315,45.154.0.180,309.0,atm,451,8910,598582551,CREDIT,0,act,2028-12-25,2024-06-11 23:57:11,146.96,payment,364850.9
51676,8460655,45.154.0.105,303.0,ATM,10,6857,598582551,CREDIT,0,act,2028-12-25,2024-06-17 17:53:53,147.12,in,364998.02
51677,9206907,188.0.0.165,1217.0,ATM,10,2583,598582551,CREDIT,0,act,2028-12-25,2024-08-18 17:43:29,147.08,add_on_acc,365145.1
51678,9252855,45.154.0.225,316.0,cash_out,20,6893,598582551,CREDIT,0,act,2028-12-25,2024-08-20 12:30:05,146.98,decrease_on_acc,364998.12
51679,9334176,46.0.128.195,714.0,cash_out,25,6359,598582551,CREDIT,0,act,2028-12-25,2024-08-23 07:00:07,146.84,diff_cntry,364851.28
51680,9743676,46.0.0.180,667.0,prtbl trm,30,3147,598582551,CREDIT,0,act,2028-12-25,2024-08-26 09:04:09,146.99,transfer,364704.29
51681,9888025,45.154.0.180,309.0,atm,30,9181,598582551,CREDIT,0,act,2028-12-25,2024-08-27 12:34:31,146.96,transfer,364557.33
51682,9897286,188.0.166.120,1307.0,ATM,20,9181,598582551,CREDIT,0,act,2028-12-25,2024-10-12 14:22:31,146.85,out,364410.48
51683,9935722,195.161.0.165,1175.0,cash_out,451,6359,598582551,CREDIT,0,act,2028-12-25,2024-11-28 05:03:26,147.18,payment,364263.3
51684,1067845,95.181.0.0,247.0,Portable term,25,2316,498719439,DEBIT,0,active,2029-09-25,2022-01-19 15:34:42,234.08,diff_cntry,688885.92
51685,1090731,37.0.124.0,719.0,port_trm,451,3452,498719439,DEBIT,0,active,2029-09-25,2022-01-22 20:34:50,234.14,payment,688651.78
51686,1117601,46.0.123.90,917.0,atm,10,3881,498719439,DEBIT,0,active,2029-09-25,2022-02-04 00:49:19,233.9,in,688885.68
51687,1305644,188.128.16.61,1187.0,prtbl trm,451,8100,498719439,DEBIT,0,active,2029-09-25,2022-03-17 05:41:12,234.17,payment,688651.51
51688,2323113,37.0.123.240,339.0,prtbl trm,-1,2316,498719439,DEBIT,1,active,2029-09-25,2022-05-26 02:20:13,234.06,err,688651.51
51689,2651816,185.17.0.180,1063.0,atm,20,2106,498719439,DEBIT,0,active,2029-09-25,2022-05-28 02:02:53,234.17,decrease_on_acc,688417.34
51690,2671766,188.128.16.61,1187.0,prtbl trm,-1,9666,498719439,DEBIT,1,active,2029-09-25,2022-06-26 09:02:36,234.07,bad,688417.34
51691,2755251,188.128.16.61,1187.0,prtbl trm,25,6851,498719439,DEBIT,0,active,2029-09-25,2022-07-25 08:34:23,233.81,country_transfer,688183.53
51692,3110358,188.128.16.61,1187.0,prtbl trm,-1,3278,498719439,DEBIT,1,active,2029-09-25,2022-08-05 03:15:18,234.1,err_code,688183.53
51693,3517747,37.0.124.0,719.0,port_trm,25,2316,498719439,DEBIT,0,active,2029-09-25,2022-08-17 17:43:47,234.29,country_transfer,687949.24
51694,3629738,46.0.128.90,705.0,cash_in,10,1804,498719439,DEBIT,0,active,2029-09-25,2022-09-14 15:26:04,233.89,add_on_acc,688183.13
51695,3758677,195.161.0.105,1170.0,atm,20,3035,498719439,DEBIT,0,active,2029-09-25,2022-09-20 17:48:04,234.15,out,687948.98
51696,3930765,95.167.0.225,218.0,ATM,20,9666,498719439,DEBIT,0,active,2029-09-25,2022-10-03 07:58:10,234.2,decrease_on_acc,687714.78
51697,4238769,37.0.123.240,339.0,prtbl trm,451,7363,498719439,DEBIT,0,active,2029-09-25,2022-12-10 19:24:01,233.8,payment,687480.98
51698,4312602,62.118.0.210,537.0,ATM,20,2106,498719439,DEBIT,0,active,2029-09-25,2022-12-13 11:38:24,233.91,from_acc,687247.07
51699,4539056,185.17.0.105,1053.0,cash_in,10,2155,498719439,DEBIT,0,active,2029-09-25,2023-05-08 07:35:53,234.05,in_acc,687481.12
51700,4585260,188.0.0.165,1217.0,ATM,10,9222,498719439,DEBIT,0,active,2029-09-25,2023-05-20 21:01:13,233.82,in_acc,687714.94
51701,4599278,79.104.0.90,642.0,ATM,10,2774,498719439,DEBIT,0,active,2029-09-25,2023-06-09 15:12:50,233.86,in_acc,687948.8
51702,4628446,185.173.0.0,1272.0,atm,20,9222,498719439,DEBIT,0,active,2029-09-25,2023-06-16 23:27:38,234.08,from_acc,687714.72
51703,4719258,185.17.0.165,1062.0,pos trm,-1,7281,498719439,DEBIT,1,active,2029-09-25,2023-06-28 07:49:39,234.12,bad,687714.72
51704,4972631,46.173.0.120,503.0,ATM,20,7059,498719439,DEBIT,0,active,2029-09-25,2023-07-12 17:47:57,233.84,from_acc,687480.88
51705,5089707,95.181.0.0,247.0,Portable term,30,3035,498719439,DEBIT,0,active,2029-09-25,2023-07-16 03:54:34,233.82,transfer,687247.06
51706,5143692,188.128.16.61,1187.0,prtbl trm,30,3881,498719439,DEBIT,0,active,2029-09-25,2023-08-19 08:17:20,233.92,transfer,687013.14
51707,5386161,86.111.0.150,1354.0,ATM,-1,9222,498719439,DEBIT,1,active,2029-09-25,2023-09-29 18:20:16,234.04,err,687013.14
51708,5408266,37.0.123.240,339.0,prtbl trm,-1,3082,498719439,DEBIT,2,active,2029-09-25,2023-10-07 05:55:21,234.11,err,687013.14
51709,5601391,185.17.0.165,1062.0,pos trm,451,4504,498719439,DEBIT,0,active,2029-09-25,2023-10-26 12:52:06,234.1,payment,686779.04
51710,5657195,188.0.166.180,1312.0,ATM,20,9222,498719439,DEBIT,0,active,2029-09-25,2023-11-11 01:59:48,233.96,decrease_on_acc,686545.08
51711,5859211,86.111.0.150,1354.0,ATM,-1,3604,498719439,DEBIT,1,active,2029-09-25,2023-11-27 03:42:08,233.99,bad,686545.08
51712,6310939,86.111.0.150,1354.0,ATM,451,8100,498719439,DEBIT,0,active,2029-09-25,2023-12-15 02:23:05,233.83,payment,686311.25
51713,6577841,188.0.169.0,467.0,atm,20,2316,498719439,DEBIT,0,active,2029-09-25,2024-01-23 04:58:14,234.03,decrease_on_acc,686077.22
51714,6923520,86.111.0.150,1354.0,ATM,451,7113,498719439,DEBIT,0,active,2029-09-25,2024-01-30 08:13:58,233.96,payment,685843.26
51715,6969039,86.111.0.150,1354.0,ATM,30,2316,498719439,DEBIT,0,active,2029-09-25,2024-02-11 13:53:45,233.86,transfer,685609.4
51716,7135272,37.0.124.0,719.0,port_trm,30,7184,498719439,DEBIT,0,active,2029-09-25,2024-02-16 06:06:54,233.98,transfer,685375.42
51717,7918417,86.111.0.150,1354.0,ATM,25,2106,498719439,DEBIT,0,active,2029-09-25,2024-03-17 10:56:00,234.04,country_transfer,685141.38
51718,8195631,37.0.123.240,339.0,prtbl trm,30,3452,498719439,DEBIT,0,active,2029-09-25,2024-03-25 14:15:51,234.06,transfer,684907.32
51719,8436126,188.128.16.61,1187.0,prtbl trm,451,3881,498719439,DEBIT,0,active,2029-09-25,2024-05-11 07:05:42,234.05,payment,684673.27
51720,8619080,185.17.0.165,1062.0,pos trm,30,1199,498719439,DEBIT,0,active,2029-09-25,2024-05-15 05:16:12,233.74,transfer,684439.53
51721,8753533,37.0.124.0,719.0,port_trm,30,7059,498719439,DEBIT,0,active,2029-09-25,2024-05-28 01:30:46,234.14,transfer,684205.39
51722,8802134,37.0.123.240,339.0,prtbl trm,451,7281,498719439,DEBIT,0,active,2029-09-25,2024-05-29 07:03:30,234.06,payment,683971.33
51723,8893333,213.151.0.60,1000.0,ATM,10,2316,498719439,DEBIT,0,active,2029-09-25,2024-06-18 15:57:38,234.14,in,684205.47
51724,8947828,37.0.124.120,729.0,atm,20,3881,498719439,DEBIT,0,active,2029-09-25,2024-06-20 00:11:58,233.94,from_acc,683971.53
51725,9065288,188.244.0.15,1449.0,ATM,10,3604,498719439,DEBIT,0,active,2029-09-25,2024-06-28 01:16:01,234.19,in_acc,684205.72
51726,9116235,91.107.0.60,979.0,ATM,10,7184,498719439,DEBIT,0,active,2029-09-25,2024-08-15 07:32:59,234.11,add_on_acc,684439.83
51727,9317613,188.128.16.61,1187.0,prtbl trm,451,4504,498719439,DEBIT,0,active,2029-09-25,2024-09-14 11:15:43,234.23,payment,684205.6
51728,9399656,95.181.0.0,247.0,Portable term,30,9177,498719439,DEBIT,0,active,2029-09-25,2024-10-07 06:11:46,234.13,transfer,683971.47
51729,9421376,46.0.54.195,1089.0,atm,20,7363,498719439,DEBIT,0,active,2029-09-25,2024-10-19 02:17:39,233.97,from_acc,683737.5
51730,9577254,95.181.0.0,247.0,Portable term,25,3035,498719439,DEBIT,0,active,2029-09-25,2024-11-07 15:40:30,233.75,country_transfer,683503.75
51731,9860005,37.0.124.0,719.0,port_trm,451,3278,498719439,DEBIT,0,active,2029-09-25,2024-11-09 11:10:04,234.09,payment,683269.66
51732,9867833,188.128.16.61,1187.0,prtbl trm,-1,3082,498719439,DEBIT,1,active,2029-09-25,2024-11-11 14:18:40,233.97,err,683269.66
51733,9957265,95.181.0.0,247.0,Portable term,451,1804,498719439,DEBIT,0,active,2029-09-25,2024-11-22 11:10:03,234.09,payment,683035.57
51734,1142452,79.104.0.60,640.0,Portable term,30,9919,942296868,CREDIT,0,active,2028-04-22,2022-01-03 09:44:11,674.95,transfer,125612.05
51735,1540095,62.118.0.30,522.0,ATM,10,2499,942296868,CREDIT,0,active,2028-04-22,2022-01-21 07:51:27,674.68,in,126286.73
51736,1636799,193.31.0.195,605.0,atm,-1,9575,942296868,CREDIT,1,active,2028-04-22,2022-01-31 06:27:13,675.15,bad,126286.73
51737,1766827,151.0.38.120,398.0,ATM,25,6281,942296868,CREDIT,0,active,2028-04-22,2022-03-02 04:15:25,675.06,diff_cntry,125611.67
51738,1767125,213.151.0.60,1000.0,ATM,20,3824,942296868,CREDIT,0,active,2028-04-22,2022-03-11 23:19:34,674.94,decrease_on_acc,124936.73
51739,2128484,46.0.54.45,1072.0,atm,10,1791,942296868,CREDIT,0,active,2028-04-22,2022-04-26 08:13:27,675.06,in_acc,125611.79
51740,2770492,217.112.0.195,1488.0,atm,-1,9575,942296868,CREDIT,1,active,2028-04-22,2022-04-28 00:06:59,674.83,err,125611.79
51741,2793975,134.0.98.45,794.0,cash_out,25,2015,942296868,CREDIT,0,active,2028-04-22,2022-05-22 17:05:43,675.04,diff_cntry,124936.75
51742,2959041,151.0.38.120,398.0,ATM,451,9575,942296868,CREDIT,0,active,2028-04-22,2022-06-03 00:12:04,675.01,payment,124261.74
51743,2974587,134.0.98.45,794.0,cash_out,25,1872,942296868,CREDIT,0,active,2028-04-22,2022-06-17 13:55:27,674.92,country_transfer,123586.82
51744,3137317,212.20.0.195,463.0,cash_in,10,9453,942296868,CREDIT,0,active,2028-04-22,2022-06-22 01:11:31,674.87,in_acc,124261.69
51745,3339297,188.162.0.150,965.0,Portable term,-1,6534,942296868,CREDIT,1,active,2028-04-22,2022-07-15 03:45:07,675.1,err,124261.69
51746,3496282,188.43.0.240,1423.0,pos trm,451,9919,942296868,CREDIT,0,active,2028-04-22,2022-07-18 00:09:13,674.96,payment,123586.73
51747,3625841,31.134.0.105,1123.0,cash_out,20,5497,942296868,CREDIT,0,active,2028-04-22,2022-07-26 16:26:18,674.92,from_acc,122911.81
51748,3742516,188.162.0.150,965.0,Portable term,451,1020,942296868,CREDIT,0,active,2028-04-22,2022-08-10 02:39:48,675.03,payment,122236.78
51749,3852248,79.104.0.60,640.0,Portable term,451,9919,942296868,CREDIT,0,active,2028-04-22,2022-08-11 08:13:02,674.87,payment,121561.91
51750,3855604,46.0.9.180,1333.0,Portable term,-1,6281,942296868,CREDIT,1,active,2028-04-22,2022-08-23 06:28:36,675.19,bad,121561.91
51751,4244854,188.162.0.150,965.0,Portable term,451,1791,942296868,CREDIT,0,active,2028-04-22,2022-09-23 10:10:24,675.0,payment,120886.91
51752,4568879,193.31.0.195,605.0,atm,451,9873,942296868,CREDIT,0,active,2028-04-22,2022-10-08 11:58:24,674.92,payment,120211.99
51753,4678554,217.112.0.195,1488.0,atm,-1,9453,942296868,CREDIT,1,active,2028-04-22,2022-10-08 13:20:16,675.12,err,120211.99
51754,5137720,193.31.0.195,605.0,atm,-1,5497,942296868,CREDIT,2,active,2028-04-22,2022-11-04 16:25:26,675.2,err_code,120211.99
51755,5142040,193.31.0.195,605.0,atm,451,9873,942296868,CREDIT,0,active,2028-04-22,2022-12-27 13:17:31,675.21,payment,119536.78
51756,5239566,217.26.0.75,679.0,ATM,10,8160,942296868,CREDIT,0,active,2028-04-22,2023-02-04 02:32:32,675.01,add_on_acc,120211.79
51757,5399720,79.104.0.60,640.0,Portable term,25,6281,942296868,CREDIT,0,active,2028-04-22,2023-02-10 05:58:53,674.71,country_transfer,119537.08
51758,5584550,85.140.0.240,1271.0,ATM,10,2499,942296868,CREDIT,0,active,2028-04-22,2023-03-25 02:46:53,674.89,in_acc,120211.97
51759,5754561,109.126.0.30,366.0,atm,20,3824,942296868,CREDIT,0,active,2028-04-22,2023-06-02 13:33:14,674.89,out,119537.08
51760,5791708,188.162.0.150,965.0,Portable term,-1,9453,942296868,CREDIT,1,active,2028-04-22,2023-06-05 17:34:45,675.3,bad,119537.08
51761,5868995,193.31.0.195,605.0,atm,25,9873,942296868,CREDIT,0,active,2028-04-22,2023-06-06 16:54:29,675.04,diff_cntry,118862.04
51762,6020197,81.17.0.60,1388.0,cash_in,10,6223,942296868,CREDIT,0,active,2028-04-22,2023-08-20 14:20:45,674.83,in,119536.87
51763,6112738,79.104.0.60,640.0,Portable term,30,6223,942296868,CREDIT,0,active,2028-04-22,2023-09-17 11:54:47,674.68,transfer,118862.19
51764,6221603,188.0.0.165,1217.0,ATM,10,1791,942296868,CREDIT,0,active,2028-04-22,2023-09-22 19:53:03,675.0,in,119537.19
51765,6431501,79.104.0.60,640.0,Portable term,-1,9575,942296868,CREDIT,1,active,2028-04-22,2023-09-27 06:19:02,675.1,err,119537.19
51766,6910880,134.0.98.45,794.0,cash_out,451,1872,942296868,CREDIT,0,active,2028-04-22,2023-10-12 21:51:01,675.23,payment,118861.96
51767,6922363,134.0.98.45,794.0,cash_out,451,5497,942296868,CREDIT,0,active,2028-04-22,2023-10-14 02:22:00,675.08,payment,118186.88
51768,7099294,46.0.54.195,1089.0,atm,20,6534,942296868,CREDIT,0,active,2028-04-22,2023-11-02 10:03:47,674.78,decrease_on_acc,117512.1
51769,7118023,188.43.0.240,1423.0,pos trm,451,2015,942296868,CREDIT,0,active,2028-04-22,2023-11-03 04:30:07,674.96,payment,116837.14
51770,7252568,193.31.0.195,605.0,atm,30,6534,942296868,CREDIT,0,active,2028-04-22,2023-11-08 10:10:53,674.81,transfer,116162.33
51771,7252617,217.112.0.195,1488.0,atm,451,1020,942296868,CREDIT,0,active,2028-04-22,2023-12-01 01:22:40,675.15,payment,115487.18
51772,7313927,193.31.0.195,605.0,atm,451,9575,942296868,CREDIT,0,active,2028-04-22,2023-12-30 19:14:18,674.74,payment,114812.44
51773,7361638,188.43.0.240,1423.0,pos trm,30,9873,942296868,CREDIT,0,active,2028-04-22,2024-01-07 10:09:02,674.96,transfer,114137.48
51774,7461196,217.112.0.195,1488.0,atm,451,6534,942296868,CREDIT,0,active,2028-04-22,2024-01-08 02:10:13,674.92,payment,113462.56
51775,7466220,79.104.0.60,640.0,Portable term,25,6281,942296868,CREDIT,0,active,2028-04-22,2024-01-13 01:11:24,674.96,country_transfer,112787.6
51776,7487559,188.43.0.240,1423.0,pos trm,451,5497,942296868,CREDIT,0,active,2028-04-22,2024-02-02 05:46:56,674.87,payment,112112.73
51777,7940113,212.20.0.210,464.0,cash_in,10,1872,942296868,CREDIT,0,active,2028-04-22,2024-02-14 11:18:20,675.12,add_on_acc,112787.85
51778,8147768,79.104.0.60,640.0,Portable term,-1,6281,942296868,CREDIT,1,active,2028-04-22,2024-02-15 14:21:54,675.14,bad,112787.85
51779,8396141,134.0.98.45,794.0,cash_out,25,8284,942296868,CREDIT,0,active,2028-04-22,2024-02-21 19:04:06,674.77,diff_cntry,112113.08
51780,8510499,31.134.0.180,1128.0,cash_out,20,6534,942296868,CREDIT,0,active,2028-04-22,2024-03-11 19:14:15,674.87,out,111438.21
51781,8631477,217.112.0.195,1488.0,atm,30,3824,942296868,CREDIT,0,active,2028-04-22,2024-04-02 11:22:22,675.05,transfer,110763.16
51782,8635821,79.104.0.60,640.0,Portable term,451,6281,942296868,CREDIT,0,active,2028-04-22,2024-04-02 13:53:58,674.98,payment,110088.18
51783,8868724,79.104.60.150,438.0,cash_in,10,9873,942296868,CREDIT,0,active,2028-04-22,2024-04-20 18:15:58,674.98,add_on_acc,110763.16
51784,9104858,151.0.38.120,398.0,ATM,-1,1791,942296868,CREDIT,1,active,2028-04-22,2024-05-16 21:03:39,675.06,err,110763.16
51785,9235807,188.43.0.240,1423.0,pos trm,451,8284,942296868,CREDIT,0,active,2028-04-22,2024-06-01 09:59:22,674.91,payment,110088.25
51786,9384988,79.104.0.60,640.0,Portable term,30,9873,942296868,CREDIT,0,active,2028-04-22,2024-06-17 07:48:31,675.2,transfer,109413.05
51787,9393293,46.0.9.180,1333.0,Portable term,451,2499,942296868,CREDIT,0,active,2028-04-22,2024-06-19 04:39:37,675.13,payment,108737.92
51788,9482498,194.87.0.60,570.0,cash_out,20,8284,942296868,CREDIT,0,active,2028-04-22,2024-09-05 23:27:06,675.15,from_acc,108062.77
51789,9975141,217.112.0.195,1488.0,atm,25,8160,942296868,CREDIT,0,active,2028-04-22,2024-11-06 20:41:07,675.01,diff_cntry,107387.76
51790,1410432,128.0.24.120,892.0,port_trm,451,5612,961067216,DEBIT,0,act,2029-03-16,2022-01-16 11:04:13,151.81,payment,529932.19
51791,1900445,195.143.0.240,1383.0,Portable term,451,9767,961067216,DEBIT,0,act,2029-03-16,2022-01-20 21:22:55,152.0,payment,529780.19
51792,1947042,81.17.0.75,1389.0,Portable term,30,5043,961067216,DEBIT,0,act,2029-03-16,2022-03-01 23:01:26,151.92,transfer,529628.27
51793,1967465,37.0.123.15,319.0,atm,10,9767,961067216,DEBIT,0,act,2029-03-16,2022-03-07 18:32:44,152.18,add_on_acc,529780.45
51794,2152334,188.43.0.45,1407.0,prtbl trm,-1,3199,961067216,DEBIT,1,act,2029-03-16,2022-03-22 01:03:20,151.78,err,529780.45
51795,2212854,188.43.0.45,1407.0,prtbl trm,-1,5043,961067216,DEBIT,2,act,2029-03-16,2022-04-25 06:07:38,151.91,err_code,529780.45
51796,2545895,81.17.0.75,1389.0,Portable term,25,9767,961067216,DEBIT,0,act,2029-03-16,2022-05-24 16:37:20,152.0,country_transfer,529628.45
51797,2596142,151.0.38.90,394.0,ATM,10,8934,961067216,DEBIT,0,act,2029-03-16,2022-06-27 21:13:32,151.82,in_acc,529780.27
51798,2697734,188.43.0.45,1407.0,prtbl trm,451,1253,961067216,DEBIT,0,act,2029-03-16,2022-08-15 02:53:44,151.82,payment,529628.45
51799,2821292,78.24.158.159,944.0,cash_out,451,1074,961067216,DEBIT,0,act,2029-03-16,2022-08-17 20:36:48,152.06,payment,529476.39
51800,3138039,195.143.0.240,1383.0,Portable term,30,9615,961067216,DEBIT,0,act,2029-03-16,2022-08-19 06:30:55,151.68,transfer,529324.71
51801,3161483,78.24.158.159,944.0,cash_out,451,8930,961067216,DEBIT,0,act,2029-03-16,2022-08-24 04:57:39,151.99,payment,529172.72
51802,3511888,128.0.24.120,892.0,port_trm,451,5043,961067216,DEBIT,0,act,2029-03-16,2022-09-05 03:32:10,152.0,payment,529020.72
51803,3557074,128.0.24.120,892.0,port_trm,451,8531,961067216,DEBIT,0,act,2029-03-16,2022-10-25 01:54:08,151.89,payment,528868.83
51804,3770773,195.143.0.240,1383.0,Portable term,451,8531,961067216,DEBIT,0,act,2029-03-16,2022-10-31 23:44:37,151.79,payment,528717.04
51805,3854802,78.24.158.159,944.0,cash_out,25,6831,961067216,DEBIT,0,act,2029-03-16,2022-11-04 09:53:45,152.01,diff_cntry,528565.03
51806,3929741,128.0.24.120,892.0,port_trm,25,5612,961067216,DEBIT,0,act,2029-03-16,2022-11-21 05:21:39,151.95,diff_cntry,528413.08
51807,4013474,128.0.94.135,1108.0,cash_in,10,7491,961067216,DEBIT,0,act,2029-03-16,2022-12-31 07:13:32,151.77,in,528564.85
51808,4344443,188.43.0.45,1407.0,prtbl trm,451,7674,961067216,DEBIT,0,act,2029-03-16,2023-02-14 15:39:45,151.96,payment,528412.89
51809,4508671,128.0.24.120,892.0,port_trm,30,3199,961067216,DEBIT,0,act,2029-03-16,2023-02-17 20:57:57,151.77,transfer,528261.12
51810,4960009,78.24.158.159,944.0,cash_out,451,4176,961067216,DEBIT,0,act,2029-03-16,2023-03-12 23:26:21,152.03,payment,528109.09
51811,5186298,188.43.0.45,1407.0,prtbl trm,-1,8531,961067216,DEBIT,1,act,2029-03-16,2023-04-10 17:37:47,152.06,bad,528109.09
51812,5377383,88.210.0.15,341.0,atm,10,8937,961067216,DEBIT,0,act,2029-03-16,2023-05-31 15:27:30,152.11,add_on_acc,528261.2
51813,5554011,194.84.192.237,47.0,cash_in,10,1525,961067216,DEBIT,0,act,2029-03-16,2023-07-05 13:47:30,152.08,in,528413.28
51814,5647923,188.43.0.45,1407.0,prtbl trm,25,8531,961067216,DEBIT,0,act,2029-03-16,2023-07-25 06:18:07,151.98,diff_cntry,528261.3
51815,5744697,37.0.127.105,1029.0,atm,10,8545,961067216,DEBIT,0,act,2029-03-16,2023-09-06 11:27:41,152.08,in_acc,528413.38
51816,5778000,128.0.24.120,892.0,port_trm,451,8934,961067216,DEBIT,0,act,2029-03-16,2023-09-14 12:46:39,151.75,payment,528261.63
51817,6082611,78.24.158.159,944.0,cash_out,30,4176,961067216,DEBIT,0,act,2029-03-16,2023-10-30 17:14:00,152.42,transfer,528109.21
51818,6353823,188.43.0.45,1407.0,prtbl trm,451,6517,961067216,DEBIT,0,act,2029-03-16,2023-11-01 14:28:41,152.06,payment,527957.15
51819,6438131,79.104.0.240,653.0,cash_in,10,1253,961067216,DEBIT,0,act,2029-03-16,2023-11-04 05:16:25,151.87,add_on_acc,528109.02
51820,6928691,78.24.158.159,944.0,cash_out,25,8531,961067216,DEBIT,0,act,2029-03-16,2023-11-30 10:51:56,152.29,country_transfer,527956.73
51821,6949953,188.43.0.45,1407.0,prtbl trm,30,5043,961067216,DEBIT,0,act,2029-03-16,2023-12-09 03:03:05,151.94,transfer,527804.79
51822,7372458,81.17.0.75,1389.0,Portable term,25,8713,961067216,DEBIT,0,act,2029-03-16,2024-01-03 19:38:48,152.18,country_transfer,527652.61
51823,7502582,81.17.0.75,1389.0,Portable term,30,3199,961067216,DEBIT,0,act,2029-03-16,2024-01-31 10:54:50,152.07,transfer,527500.54
51824,7620419,188.43.0.45,1407.0,prtbl trm,451,1074,961067216,DEBIT,0,act,2029-03-16,2024-02-08 13:18:35,151.87,payment,527348.67
51825,7698774,78.24.158.159,944.0,cash_out,25,1334,961067216,DEBIT,0,act,2029-03-16,2024-02-09 15:49:13,151.94,country_transfer,527196.73
51826,7719312,81.17.0.75,1389.0,Portable term,25,4176,961067216,DEBIT,0,act,2029-03-16,2024-02-13 06:03:35,152.22,diff_cntry,527044.51
51827,7795964,81.17.0.75,1389.0,Portable term,-1,4532,961067216,DEBIT,1,act,2029-03-16,2024-02-15 09:40:49,151.88,bad,527044.51
51828,7829303,78.24.158.159,944.0,cash_out,-1,8713,961067216,DEBIT,2,act,2029-03-16,2024-02-29 05:21:04,151.92,bad,527044.51
51829,8163184,188.162.0.75,958.0,cash_out,20,1074,961067216,DEBIT,0,act,2029-03-16,2024-03-10 03:52:21,152.03,decrease_on_acc,526892.48
51830,8308671,188.0.166.180,1312.0,ATM,10,7491,961067216,DEBIT,0,act,2029-03-16,2024-03-19 13:33:44,151.94,in_acc,527044.42
51831,8474867,188.43.0.45,1407.0,prtbl trm,-1,8930,961067216,DEBIT,1,act,2029-03-16,2024-04-22 03:47:47,152.02,bad,527044.42
51832,8516551,128.0.24.120,892.0,port_trm,451,1253,961067216,DEBIT,0,act,2029-03-16,2024-06-03 23:57:30,151.72,payment,526892.7
51833,8687501,81.17.0.75,1389.0,Portable term,451,4532,961067216,DEBIT,0,act,2029-03-16,2024-07-17 22:04:22,151.91,payment,526740.79
51834,8858142,81.17.0.75,1389.0,Portable term,451,1074,961067216,DEBIT,0,act,2029-03-16,2024-07-18 05:30:53,152.11,payment,526588.68
51835,9089206,128.0.24.120,892.0,port_trm,25,6517,961067216,DEBIT,0,act,2029-03-16,2024-07-18 07:02:56,151.96,country_transfer,526436.72
51836,9815323,78.24.158.159,944.0,cash_out,-1,1334,961067216,DEBIT,1,act,2029-03-16,2024-08-02 10:31:05,151.98,err,526436.72
51837,9815818,188.43.0.45,1407.0,prtbl trm,-1,8545,961067216,DEBIT,2,act,2029-03-16,2024-09-28 22:27:08,151.91,bad,526436.72
51838,9891274,91.107.0.210,993.0,atm,10,5612,961067216,DEBIT,0,act,2029-03-16,2024-11-04 19:49:02,152.08,in,526588.8
51839,9970258,46.0.2.0,180.0,atm,10,8930,961067216,DEBIT,0,act,2029-03-16,2024-11-25 19:48:58,152.07,in_acc,526740.87
51840,1171749,185.233.0.240,96.0,atm,10,2054,319941461,CREDIT,0,act,2030-06-02,2022-01-05 20:10:08,566.92,add_on_acc,638376.92
51841,1410624,37.0.123.60,325.0,ATM,20,2054,319941461,CREDIT,0,act,2030-06-02,2022-01-16 16:27:54,566.99,out,637809.93
51842,1532699,193.31.0.45,589.0,cash_in,25,4749,319941461,CREDIT,0,act,2030-06-02,2022-02-25 16:43:24,567.14,country_transfer,637242.79
51843,1619289,77.242.0.150,282.0,cash_out,20,4351,319941461,CREDIT,0,act,2030-06-02,2022-03-13 00:31:07,567.26,out,636675.53
51844,1760993,128.0.94.90,1103.0,port_trm,25,7076,319941461,CREDIT,0,act,2030-06-02,2022-04-16 19:11:05,567.05,country_transfer,636108.48
51845,1842734,128.0.94.90,1103.0,port_trm,25,8341,319941461,CREDIT,0,act,2030-06-02,2022-04-22 01:42:20,566.88,country_transfer,635541.6
51846,1909329,46.0.188.180,1241.0,pos trm,451,4335,319941461,CREDIT,0,act,2030-06-02,2022-05-03 02:46:48,566.93,payment,634974.67
51847,2195177,88.210.0.0,340.0,Portable term,25,4048,319941461,CREDIT,0,act,2030-06-02,2022-05-04 14:51:35,566.96,diff_cntry,634407.71
51848,2383268,188.18.0.0,220.0,atm,25,6123,319941461,CREDIT,0,act,2030-06-02,2022-05-19 05:40:22,566.77,diff_cntry,633840.94
51849,2553718,188.191.0.195,1155.0,atm,-1,4335,319941461,CREDIT,1,act,2030-06-02,2022-06-17 22:05:58,567.05,err_code,633840.94
51850,2971298,188.18.0.0,220.0,atm,451,2215,319941461,CREDIT,0,act,2030-06-02,2022-06-23 10:08:28,567.12,payment,633273.82
51851,2981794,128.0.94.90,1103.0,port_trm,30,3033,319941461,CREDIT,0,act,2030-06-02,2022-08-14 05:41:44,566.91,transfer,632706.91
51852,3204592,88.210.0.0,340.0,Portable term,30,4351,319941461,CREDIT,0,act,2030-06-02,2022-09-08 05:10:36,567.02,transfer,632139.89
51853,3227613,185.233.0.240,96.0,atm,20,2121,319941461,CREDIT,0,act,2030-06-02,2022-10-01 06:38:01,567.18,out,631572.71
51854,3334607,188.191.0.195,1155.0,atm,451,4048,319941461,CREDIT,0,act,2030-06-02,2022-11-27 23:06:21,567.02,payment,631005.69
51855,3339182,88.210.0.0,340.0,Portable term,451,2121,319941461,CREDIT,0,act,2030-06-02,2022-12-05 19:52:44,567.3,payment,630438.39
51856,3429931,213.151.0.75,1001.0,prtbl trm,451,7076,319941461,CREDIT,0,act,2030-06-02,2022-12-07 22:28:46,567.24,payment,629871.15
51857,3626385,128.0.94.90,1103.0,port_trm,-1,4351,319941461,CREDIT,1,act,2030-06-02,2022-12-13 00:25:35,566.73,err_code,629871.15
51858,3914753,188.18.0.0,220.0,atm,30,4351,319941461,CREDIT,0,act,2030-06-02,2023-01-21 03:37:52,567.07,transfer,629304.08
51859,4039093,188.18.0.0,220.0,atm,-1,5396,319941461,CREDIT,1,act,2030-06-02,2023-01-25 04:11:32,567.03,bad,629304.08
51860,4063772,195.161.0.210,1179.0,atm,20,4048,319941461,CREDIT,0,act,2030-06-02,2023-02-11 10:46:17,567.12,from_acc,628736.96
51861,4351193,79.104.60.210,442.0,pos trm,25,5481,319941461,CREDIT,0,act,2030-06-02,2023-02-17 07:34:01,567.11,diff_cntry,628169.85
51862,4398116,88.210.0.0,340.0,Portable term,451,6123,319941461,CREDIT,0,act,2030-06-02,2023-02-28 12:46:04,567.17,payment,627602.68
51863,4408112,188.18.0.0,220.0,atm,25,5649,319941461,CREDIT,0,act,2030-06-02,2023-03-06 17:23:37,567.0,diff_cntry,627035.68
51864,4450158,85.140.0.45,1250.0,cash_in,10,5481,319941461,CREDIT,0,act,2030-06-02,2023-03-20 00:21:00,567.05,add_on_acc,627602.73
51865,4515962,213.151.0.75,1001.0,prtbl trm,-1,5396,319941461,CREDIT,1,act,2030-06-02,2023-04-09 17:01:00,566.84,err,627602.73
51866,4772395,79.104.60.210,442.0,pos trm,-1,4351,319941461,CREDIT,2,act,2030-06-02,2023-05-17 02:11:00,566.96,err,627602.73
51867,4997107,213.151.0.75,1001.0,prtbl trm,30,8341,319941461,CREDIT,0,act,2030-06-02,2023-05-23 22:06:07,566.91,transfer,627035.82
51868,5577086,109.126.0.105,372.0,ATM,20,3992,319941461,CREDIT,0,act,2030-06-02,2023-05-24 14:39:23,566.93,out,626468.89
51869,5647273,188.191.0.195,1155.0,atm,451,5649,319941461,CREDIT,0,act,2030-06-02,2023-07-07 07:08:28,566.79,payment,625902.1
51870,5783221,188.18.0.0,220.0,atm,451,3542,319941461,CREDIT,0,act,2030-06-02,2023-07-12 14:22:32,566.85,payment,625335.25
51871,6086289,213.151.0.75,1001.0,prtbl trm,451,4048,319941461,CREDIT,0,act,2030-06-02,2023-09-03 04:13:29,566.83,payment,624768.42
51872,6145031,188.18.0.0,220.0,atm,30,9591,319941461,CREDIT,0,act,2030-06-02,2023-09-07 07:39:19,566.9,transfer,624201.52
51873,6216673,193.31.0.45,589.0,cash_in,-1,5639,319941461,CREDIT,1,act,2030-06-02,2023-09-09 12:45:31,567.22,err,624201.52
51874,6341437,46.0.188.240,1245.0,cash_in,10,3094,319941461,CREDIT,0,act,2030-06-02,2023-10-10 00:49:00,566.82,in,624768.34
51875,6736500,46.0.188.180,1241.0,pos trm,-1,4351,319941461,CREDIT,1,act,2030-06-02,2023-12-18 15:06:37,567.06,err_code,624768.34
51876,6813251,46.0.188.180,1241.0,pos trm,451,4335,319941461,CREDIT,0,act,2030-06-02,2023-12-26 18:18:43,566.95,payment,624201.39
51877,7207543,188.191.0.135,1150.0,atm,20,5639,319941461,CREDIT,0,act,2030-06-02,2024-03-07 10:02:22,566.94,from_acc,623634.45
51878,7325136,193.31.0.45,589.0,cash_in,25,4351,319941461,CREDIT,0,act,2030-06-02,2024-03-15 06:58:35,566.74,country_transfer,623067.71
51879,7840687,188.18.0.0,220.0,atm,451,7076,319941461,CREDIT,0,act,2030-06-02,2024-05-19 01:58:21,567.09,payment,622500.62
51880,8190618,79.104.60.210,442.0,pos trm,30,6123,319941461,CREDIT,0,act,2030-06-02,2024-05-21 01:03:37,567.03,transfer,621933.59
51881,8260661,45.154.0.120,304.0,ATM,20,5649,319941461,CREDIT,0,act,2030-06-02,2024-05-28 14:54:28,566.55,from_acc,621367.04
51882,8431090,79.104.0.90,642.0,ATM,10,4335,319941461,CREDIT,0,act,2030-06-02,2024-06-25 15:55:29,566.75,in_acc,621933.79
51883,8433102,62.118.0.0,518.0,cash_out,20,4351,319941461,CREDIT,0,act,2030-06-02,2024-07-11 21:30:42,567.16,from_acc,621366.63
51884,8763185,193.31.0.45,589.0,cash_in,-1,4749,319941461,CREDIT,1,act,2030-06-02,2024-07-29 16:58:30,566.86,bad,621366.63
51885,8824688,213.151.0.75,1001.0,prtbl trm,30,3542,319941461,CREDIT,0,act,2030-06-02,2024-08-02 21:29:56,567.12,transfer,620799.51
51886,9264123,193.31.0.45,589.0,cash_in,30,5481,319941461,CREDIT,0,act,2030-06-02,2024-08-24 18:26:54,567.11,transfer,620232.4
51887,9282045,193.0.151.15,51.0,ATM,20,2121,319941461,CREDIT,0,act,2030-06-02,2024-09-28 01:38:01,566.94,out,619665.46
51888,9637875,128.0.94.240,1115.0,cash_in,10,9591,319941461,CREDIT,0,act,2030-06-02,2024-10-05 00:20:23,567.02,in,620232.48
51889,9669361,188.18.0.0,220.0,atm,451,4749,319941461,CREDIT,0,act,2030-06-02,2024-10-27 03:40:38,566.94,payment,619665.54
51890,9846725,128.0.94.90,1103.0,port_trm,30,3992,319941461,CREDIT,0,act,2030-06-02,2024-10-30 13:28:02,567.01,transfer,619098.53
51891,9883192,193.31.0.45,589.0,cash_in,451,4474,319941461,CREDIT,0,act,2030-06-02,2024-11-10 16:43:21,566.87,payment,618531.66
51892,1033113,188.0.0.30,1208.0,prtbl trm,451,2538,526745565,CREDIT,0,act,2028-01-25,2022-01-23 13:09:15,521.13,payment,206235.87
51893,1210780,188.0.0.30,1208.0,prtbl trm,25,9842,526745565,CREDIT,0,act,2028-01-25,2022-01-27 17:13:00,521.15,diff_cntry,205714.72
51894,1235710,95.106.0.135,554.0,prtbl trm,451,2956,526745565,CREDIT,0,act,2028-01-25,2022-03-06 11:22:07,521.15,payment,205193.57
51895,1400661,188.0.0.30,1208.0,prtbl trm,-1,2438,526745565,CREDIT,1,act,2028-01-25,2022-07-02 05:59:14,520.82,bad,205193.57
51896,1416820,95.106.0.135,554.0,prtbl trm,25,5194,526745565,CREDIT,0,act,2028-01-25,2022-07-09 01:49:47,521.26,diff_cntry,204672.31
51897,1551896,95.106.0.120,553.0,cash_in,10,9599,526745565,CREDIT,0,act,2028-01-25,2022-08-24 17:44:13,520.99,in_acc,205193.3
51898,1711671,188.191.0.0,1139.0,pos trm,451,1719,526745565,CREDIT,0,act,2028-01-25,2022-08-25 22:02:56,521.24,payment,204672.06
51899,2079952,88.210.0.75,346.0,atm,20,9235,526745565,CREDIT,0,act,2028-01-25,2022-09-23 05:49:02,520.88,decrease_on_acc,204151.18
51900,2204886,188.191.0.0,1139.0,pos trm,30,2968,526745565,CREDIT,0,act,2028-01-25,2022-12-05 12:31:18,521.03,transfer,203630.15
51901,2295763,188.191.0.0,1139.0,pos trm,451,2538,526745565,CREDIT,0,act,2028-01-25,2022-12-18 06:39:57,520.83,payment,203109.32
51902,2382219,188.0.0.30,1208.0,prtbl trm,451,8547,526745565,CREDIT,0,act,2028-01-25,2023-01-07 08:17:38,521.3,payment,202588.02
51903,2958819,95.106.0.135,554.0,prtbl trm,-1,5194,526745565,CREDIT,1,act,2028-01-25,2023-01-25 21:59:10,521.05,err,202588.02
51904,3188496,188.0.0.30,1208.0,prtbl trm,451,1719,526745565,CREDIT,0,act,2028-01-25,2023-01-27 10:54:00,520.97,payment,202067.05
51905,3550000,5.189.0.90,862.0,port_trm,25,4372,526745565,CREDIT,0,act,2028-01-25,2023-02-09 15:01:49,521.04,diff_cntry,201546.01
51906,3724161,188.191.0.0,1139.0,pos trm,30,9656,526745565,CREDIT,0,act,2028-01-25,2023-02-22 10:04:06,521.28,transfer,201024.73
51907,3958763,217.112.0.0,1471.0,ATM,20,8295,526745565,CREDIT,0,act,2028-01-25,2023-05-05 15:37:56,521.08,from_acc,200503.65
51908,4085159,95.106.0.135,554.0,prtbl trm,451,9656,526745565,CREDIT,0,act,2028-01-25,2023-05-08 05:07:00,521.01,payment,199982.64
51909,4330482,188.0.166.90,1305.0,cash_out,20,1092,526745565,CREDIT,0,act,2028-01-25,2023-05-15 14:40:33,520.87,out,199461.77
51910,4372900,95.106.0.135,554.0,prtbl trm,30,9842,526745565,CREDIT,0,act,2028-01-25,2023-05-17 21:02:06,520.77,transfer,198941.0
51911,4429543,46.0.123.45,913.0,atm,-1,4372,526745565,CREDIT,1,act,2028-01-25,2023-05-29 06:26:59,520.85,bad,198941.0
51912,4430512,95.106.0.135,554.0,prtbl trm,25,8547,526745565,CREDIT,0,act,2028-01-25,2023-06-02 19:35:03,521.31,diff_cntry,198419.69
51913,4719045,188.0.169.195,482.0,cash_in,10,4372,526745565,CREDIT,0,act,2028-01-25,2023-06-03 04:05:52,521.08,in,198940.77
51914,4743642,188.0.0.30,1208.0,prtbl trm,25,9656,526745565,CREDIT,0,act,2028-01-25,2023-06-17 06:39:21,521.07,diff_cntry,198419.7
51915,5203656,188.191.0.0,1139.0,pos trm,25,9235,526745565,CREDIT,0,act,2028-01-25,2023-06-20 19:45:32,520.75,diff_cntry,197898.95
51916,5356216,46.0.188.60,1232.0,cash_in,10,9656,526745565,CREDIT,0,act,2028-01-25,2023-07-09 11:35:05,520.91,in,198419.86
51917,5521983,188.191.0.0,1139.0,pos trm,25,2956,526745565,CREDIT,0,act,2028-01-25,2023-07-14 22:40:04,521.19,diff_cntry,197898.67
51918,5553640,95.106.0.135,554.0,prtbl trm,451,2398,526745565,CREDIT,0,act,2028-01-25,2023-07-15 03:14:23,521.1,payment,197377.57
51919,5824741,188.0.0.30,1208.0,prtbl trm,-1,8295,526745565,CREDIT,1,act,2028-01-25,2023-09-04 00:52:00,521.01,bad,197377.57
51920,5912761,95.106.0.135,554.0,prtbl trm,451,8318,526745565,CREDIT,0,act,2028-01-25,2023-09-04 04:46:13,521.19,payment,196856.38
51921,6386240,5.189.0.90,862.0,port_trm,451,5435,526745565,CREDIT,0,act,2028-01-25,2023-09-07 14:53:35,520.93,payment,196335.45
51922,6469425,5.189.0.90,862.0,port_trm,30,1719,526745565,CREDIT,0,act,2028-01-25,2023-10-22 09:33:24,521.23,transfer,195814.22
51923,6545687,188.0.0.30,1208.0,prtbl trm,30,9235,526745565,CREDIT,0,act,2028-01-25,2023-11-12 20:45:25,520.99,transfer,195293.23
51924,6705777,5.189.0.90,862.0,port_trm,25,2956,526745565,CREDIT,0,act,2028-01-25,2024-01-10 01:25:57,521.28,diff_cntry,194771.95
51925,6884791,188.191.0.0,1139.0,pos trm,451,8547,526745565,CREDIT,0,act,2028-01-25,2024-01-27 21:13:17,520.87,payment,194251.08
51926,6918945,188.0.0.30,1208.0,prtbl trm,25,4372,526745565,CREDIT,0,act,2028-01-25,2024-02-18 04:17:55,520.94,diff_cntry,193730.14
51927,6982874,95.106.0.210,562.0,cash_in,10,2968,526745565,CREDIT,0,act,2028-01-25,2024-03-04 06:01:45,520.92,in_acc,194251.06
51928,7088380,46.0.123.45,913.0,atm,451,9235,526745565,CREDIT,0,act,2028-01-25,2024-03-09 15:10:46,520.97,payment,193730.09
51929,7206270,95.181.0.240,267.0,ATM,20,9599,526745565,CREDIT,0,act,2028-01-25,2024-03-17 09:01:15,520.95,decrease_on_acc,193209.14
51930,7293975,188.191.0.0,1139.0,pos trm,25,2438,526745565,CREDIT,0,act,2028-01-25,2024-03-22 17:18:36,521.04,diff_cntry,192688.1
51931,7440373,46.0.123.45,913.0,atm,30,3193,526745565,CREDIT,0,act,2028-01-25,2024-03-27 23:05:42,521.05,transfer,192167.05
51932,7546741,46.0.123.45,913.0,atm,-1,5435,526745565,CREDIT,1,act,2028-01-25,2024-04-22 16:23:35,521.06,bad,192167.05
51933,7939090,46.0.123.45,913.0,atm,25,1719,526745565,CREDIT,0,act,2028-01-25,2024-04-26 04:25:17,521.09,diff_cntry,191645.96
51934,7966438,188.191.0.225,1159.0,atm,10,9235,526745565,CREDIT,0,act,2028-01-25,2024-05-05 09:16:19,521.04,add_on_acc,192167.0
51935,9003633,46.0.123.45,913.0,atm,25,8547,526745565,CREDIT,0,act,2028-01-25,2024-05-07 01:40:12,520.92,diff_cntry,191646.08
51936,9241628,95.167.0.45,203.0,atm,10,8295,526745565,CREDIT,0,act,2028-01-25,2024-05-27 09:43:48,521.0,add_on_acc,192167.08
51937,9335973,188.0.0.30,1208.0,prtbl trm,451,5194,526745565,CREDIT,0,act,2028-01-25,2024-05-31 04:43:58,521.07,payment,191646.01
51938,9370856,151.0.0.30,14.0,cash_out,20,2438,526745565,CREDIT,0,act,2028-01-25,2024-06-19 12:56:25,521.18,out,191124.83
51939,9738515,95.106.0.135,554.0,prtbl trm,25,5435,526745565,CREDIT,0,act,2028-01-25,2024-06-20 07:57:40,520.89,diff_cntry,190603.94
51940,9795835,188.191.0.0,1139.0,pos trm,25,4372,526745565,CREDIT,0,act,2028-01-25,2024-08-16 16:04:43,521.01,diff_cntry,190082.93
51941,9797886,46.0.123.45,913.0,atm,451,1728,526745565,CREDIT,0,act,2028-01-25,2024-09-23 18:07:17,521.03,payment,189561.9
51942,9909697,37.0.127.30,1023.0,cash_out,20,2538,526745565,CREDIT,0,act,2028-01-25,2024-10-10 07:46:53,520.99,decrease_on_acc,189040.91
51943,9919603,188.0.0.30,1208.0,prtbl trm,25,3193,526745565,CREDIT,0,act,2028-01-25,2024-10-28 09:38:58,521.37,country_transfer,188519.54
51944,1741578,217.112.0.60,1476.0,atm,20,9778,364757022,CREDIT,0,active,2028-08-16,2022-01-09 02:27:01,619.29,from_acc,359184.71
51945,1891229,194.0.162.15,741.0,pos trm,30,5761,364757022,CREDIT,0,active,2028-08-16,2022-01-18 12:18:22,619.01,transfer,358565.7
51946,2042091,194.0.162.15,741.0,pos trm,451,3757,364757022,CREDIT,0,active,2028-08-16,2022-02-01 10:47:42,618.93,payment,357946.77
51947,2165040,194.0.162.15,741.0,pos trm,-1,5841,364757022,CREDIT,1,active,2028-08-16,2022-02-12 00:48:20,619.14,err,357946.77
51948,2193353,194.87.0.45,569.0,port_trm,451,2746,364757022,CREDIT,0,active,2028-08-16,2022-02-28 08:08:52,619.18,payment,357327.59
51949,2665549,78.24.158.24,931.0,ATM,-1,9928,364757022,CREDIT,1,active,2028-08-16,2022-03-07 21:50:27,619.24,err_code,357327.59
51950,2799694,188.191.0.195,1155.0,atm,10,8183,364757022,CREDIT,0,active,2028-08-16,2022-03-24 18:34:04,619.06,add_on_acc,357946.65
51951,2825164,151.0.38.90,394.0,ATM,451,2887,364757022,CREDIT,0,active,2028-08-16,2022-05-04 02:08:25,619.23,payment,357327.42
51952,2880059,46.0.128.150,711.0,cash_out,20,2264,364757022,CREDIT,0,active,2028-08-16,2022-05-09 02:58:43,619.06,out,356708.36
51953,2965518,194.0.162.15,741.0,pos trm,30,2519,364757022,CREDIT,0,active,2028-08-16,2022-05-23 18:25:15,618.85,transfer,356089.51
51954,2985926,128.0.24.0,879.0,cash_in,10,3757,364757022,CREDIT,0,active,2028-08-16,2022-06-21 07:51:37,618.95,in_acc,356708.46
51955,3149763,195.161.0.210,1179.0,atm,10,3701,364757022,CREDIT,0,active,2028-08-16,2022-07-23 02:29:32,619.21,add_on_acc,357327.67
51956,3311973,194.0.162.15,741.0,pos trm,451,5841,364757022,CREDIT,0,active,2028-08-16,2022-08-12 08:57:31,618.7,payment,356708.97
51957,3353335,78.24.158.24,931.0,ATM,451,2264,364757022,CREDIT,0,active,2028-08-16,2022-10-19 16:28:34,619.16,payment,356089.81
51958,3363208,194.0.162.15,741.0,pos trm,30,2034,364757022,CREDIT,0,active,2028-08-16,2022-10-26 18:50:56,618.96,transfer,355470.85
51959,3625404,194.0.162.15,741.0,pos trm,30,8082,364757022,CREDIT,0,active,2028-08-16,2022-11-29 22:04:51,619.13,transfer,354851.72
51960,3802271,151.0.38.90,394.0,ATM,30,8183,364757022,CREDIT,0,active,2028-08-16,2023-01-03 23:48:47,619.05,transfer,354232.67
51961,3881932,46.0.128.180,713.0,ATM,10,2034,364757022,CREDIT,0,active,2028-08-16,2023-02-05 09:12:25,618.86,add_on_acc,354851.53
51962,4340684,46.0.188.105,1235.0,cash_in,10,2746,364757022,CREDIT,0,active,2028-08-16,2023-02-07 08:02:28,618.95,in_acc,355470.48
51963,4424030,46.0.0.135,664.0,cash_out,20,8397,364757022,CREDIT,0,active,2028-08-16,2023-03-02 10:27:28,618.95,out,354851.53
51964,4491728,194.87.0.45,569.0,port_trm,451,4966,364757022,CREDIT,0,active,2028-08-16,2023-04-19 08:43:40,619.14,payment,354232.39
51965,4578523,217.112.0.30,1474.0,ATM,10,6451,364757022,CREDIT,0,active,2028-08-16,2023-04-24 06:15:34,618.94,in,354851.33
51966,4623189,78.24.158.24,931.0,ATM,451,8143,364757022,CREDIT,0,active,2028-08-16,2023-04-28 05:10:23,619.08,payment,354232.25
51967,4941221,151.0.38.90,394.0,ATM,30,7995,364757022,CREDIT,0,active,2028-08-16,2023-06-06 20:04:16,618.65,transfer,353613.6
51968,5064002,188.0.0.0,1206.0,atm,20,5761,364757022,CREDIT,0,active,2028-08-16,2023-06-23 07:06:58,619.02,decrease_on_acc,352994.58
51969,5256439,194.0.162.15,741.0,pos trm,-1,2519,364757022,CREDIT,1,active,2028-08-16,2023-07-03 07:15:03,619.02,bad,352994.58
51970,5430652,194.87.0.45,569.0,port_trm,25,8143,364757022,CREDIT,0,active,2028-08-16,2023-07-23 09:21:17,619.04,country_transfer,352375.54
51971,5807784,194.87.0.45,569.0,port_trm,30,2887,364757022,CREDIT,0,active,2028-08-16,2023-08-18 06:30:28,619.06,transfer,351756.48
51972,5890315,195.143.0.105,1370.0,prtbl trm,-1,6372,364757022,CREDIT,1,active,2028-08-16,2023-08-20 10:46:12,619.22,err,351756.48
51973,5929856,91.107.0.240,995.0,cash_in,10,4966,364757022,CREDIT,0,active,2028-08-16,2023-09-03 02:13:07,619.02,in_acc,352375.5
51974,5986407,46.0.2.195,195.0,cash_in,10,8397,364757022,CREDIT,0,active,2028-08-16,2023-09-21 12:02:15,618.83,in,352994.33
51975,6026952,194.87.0.45,569.0,port_trm,451,8817,364757022,CREDIT,0,active,2028-08-16,2023-09-24 01:50:30,618.96,payment,352375.37
51976,6128200,62.118.0.0,518.0,cash_out,20,2264,364757022,CREDIT,0,active,2028-08-16,2023-09-29 20:51:04,619.09,decrease_on_acc,351756.28
51977,6647976,46.173.0.165,509.0,ATM,10,7995,364757022,CREDIT,0,active,2028-08-16,2023-10-06 11:08:28,619.1,in_acc,352375.38
51978,6747203,46.0.0.60,659.0,port_trm,25,9773,364757022,CREDIT,0,active,2028-08-16,2023-11-02 09:50:15,618.98,country_transfer,351756.4
51979,6796183,46.0.0.135,664.0,cash_out,20,7158,364757022,CREDIT,0,active,2028-08-16,2023-11-12 04:59:39,619.04,out,351137.36
51980,6876277,151.0.38.90,394.0,ATM,451,4966,364757022,CREDIT,0,active,2028-08-16,2023-12-14 12:05:38,619.01,payment,350518.35
51981,7260694,194.87.0.45,569.0,port_trm,451,3701,364757022,CREDIT,0,active,2028-08-16,2024-01-01 12:23:03,619.26,payment,349899.09
51982,7400806,46.0.0.60,659.0,port_trm,451,7995,364757022,CREDIT,0,active,2028-08-16,2024-01-06 14:38:52,618.82,payment,349280.27
51983,7405941,37.0.124.240,738.0,cash_out,20,9773,364757022,CREDIT,0,active,2028-08-16,2024-01-25 04:46:02,618.85,out,348661.42
51984,7425139,195.143.0.105,1370.0,prtbl trm,-1,5761,364757022,CREDIT,1,active,2028-08-16,2024-02-27 03:49:27,618.85,err_code,348661.42
51985,7575980,194.0.162.15,741.0,pos trm,-1,8240,364757022,CREDIT,2,active,2028-08-16,2024-04-30 20:52:37,618.85,bad,348661.42
51986,7600261,78.24.158.174,945.0,cash_in,10,3701,364757022,CREDIT,0,active,2028-08-16,2024-05-04 09:55:01,619.11,in_acc,349280.53
51987,7952347,194.87.0.45,569.0,port_trm,-1,8328,364757022,CREDIT,1,active,2028-08-16,2024-05-07 02:15:16,619.18,err_code,349280.53
51988,8120409,195.143.0.105,1370.0,prtbl trm,25,2519,364757022,CREDIT,0,active,2028-08-16,2024-05-30 00:03:28,619.16,diff_cntry,348661.37
51989,8251364,78.24.158.24,931.0,ATM,-1,2746,364757022,CREDIT,1,active,2028-08-16,2024-06-17 18:30:58,619.35,err_code,348661.37
51990,8372565,195.143.0.105,1370.0,prtbl trm,451,7158,364757022,CREDIT,0,active,2028-08-16,2024-06-23 20:52:34,619.0,payment,348042.37
51991,8400334,195.143.0.105,1370.0,prtbl trm,30,4966,364757022,CREDIT,0,active,2028-08-16,2024-06-26 11:43:17,618.95,transfer,347423.42
51992,8798745,78.24.158.24,931.0,ATM,-1,7158,364757022,CREDIT,1,active,2028-08-16,2024-07-02 00:34:01,619.2,err,347423.42
51993,8968385,151.0.38.90,394.0,ATM,451,7158,364757022,CREDIT,0,active,2028-08-16,2024-08-25 02:03:02,619.08,payment,346804.34
51994,9117956,195.143.0.105,1370.0,prtbl trm,451,6372,364757022,CREDIT,0,active,2028-08-16,2024-08-27 11:15:59,618.78,payment,346185.56
51995,9175043,195.143.0.105,1370.0,prtbl trm,451,3757,364757022,CREDIT,0,active,2028-08-16,2024-09-04 07:38:35,619.09,payment,345566.47
51996,9420630,46.0.0.60,659.0,port_trm,25,8143,364757022,CREDIT,0,active,2028-08-16,2024-09-15 20:41:21,619.13,diff_cntry,344947.34
51997,9494697,194.87.0.45,569.0,port_trm,451,6451,364757022,CREDIT,0,active,2028-08-16,2024-10-18 21:20:15,619.04,payment,344328.3
51998,9782968,85.140.0.0,1246.0,atm,20,5761,364757022,CREDIT,0,active,2028-08-16,2024-10-28 23:33:38,619.07,from_acc,343709.23
51999,9897446,188.191.0.225,1159.0,atm,20,3757,364757022,CREDIT,0,active,2028-08-16,2024-11-12 00:01:45,619.01,decrease_on_acc,343090.22
52000,9902368,62.118.0.120,530.0,ATM,10,7071,364757022,CREDIT,0,active,2028-08-16,2024-11-13 03:44:07,618.99,add_on_acc,343709.21
52001,1000067,95.167.0.75,205.0,ATM,-1,3496,828308371,DEBIT,1,active,2030-03-08,2022-01-08 04:52:03,956.18,bad,151521.0
52002,1027267,37.0.127.195,1036.0,cash_in,25,6446,828308371,DEBIT,0,active,2030-03-08,2022-01-24 21:56:38,956.31,diff_cntry,150564.69
52003,1050906,217.26.0.135,688.0,ATM,30,6446,828308371,DEBIT,0,active,2030-03-08,2022-01-31 17:59:49,956.31,transfer,149608.38
52004,1133293,188.0.169.60,471.0,atm,451,6446,828308371,DEBIT,0,active,2030-03-08,2022-03-07 22:24:39,956.07,payment,148652.31
52005,1135829,188.0.189.90,838.0,Portable term,-1,8754,828308371,DEBIT,1,active,2030-03-08,2022-03-28 04:27:46,956.09,bad,148652.31
52006,1197788,37.0.127.195,1036.0,cash_in,451,8573,828308371,DEBIT,0,active,2030-03-08,2022-03-30 04:36:12,955.66,payment,147696.65
52007,1361996,79.104.60.150,438.0,cash_in,10,3686,828308371,DEBIT,0,active,2030-03-08,2022-04-10 12:29:59,956.09,in,148652.74
52008,1384295,188.0.189.90,838.0,Portable term,30,3496,828308371,DEBIT,0,active,2030-03-08,2022-04-16 12:36:36,956.19,transfer,147696.55
52009,1791666,217.26.0.135,688.0,ATM,25,4594,828308371,DEBIT,0,active,2030-03-08,2022-05-10 13:03:03,956.33,diff_cntry,146740.22
52010,2120606,188.0.189.90,838.0,Portable term,30,1719,828308371,DEBIT,0,active,2030-03-08,2022-05-18 23:19:29,956.29,transfer,145783.93
52011,2643344,95.167.0.75,205.0,ATM,451,7959,828308371,DEBIT,0,active,2030-03-08,2022-06-06 12:29:04,955.99,payment,144827.94
52012,2756293,37.0.127.195,1036.0,cash_in,25,5784,828308371,DEBIT,0,active,2030-03-08,2022-06-08 01:56:36,956.47,diff_cntry,143871.47
52013,3079740,217.26.0.210,695.0,cash_out,20,3686,828308371,DEBIT,0,active,2030-03-08,2022-06-17 01:09:25,955.92,from_acc,142915.55
52014,3283493,95.167.0.75,205.0,ATM,-1,5784,828308371,DEBIT,1,active,2030-03-08,2022-06-20 15:46:55,955.9,err_code,142915.55
52015,3426536,217.26.0.135,688.0,ATM,25,1719,828308371,DEBIT,0,active,2030-03-08,2022-08-12 17:36:14,956.12,diff_cntry,141959.43
52016,3498219,194.0.162.105,747.0,cash_in,25,5873,828308371,DEBIT,0,active,2030-03-08,2022-09-04 00:26:36,956.0,diff_cntry,141003.43
52017,3565940,188.0.189.90,838.0,Portable term,-1,5873,828308371,DEBIT,1,active,2030-03-08,2022-09-08 11:13:26,955.81,bad,141003.43
52018,3937702,151.0.38.90,394.0,ATM,20,6446,828308371,DEBIT,0,active,2030-03-08,2022-09-12 09:14:20,956.1,out,140047.33
52019,4124073,46.0.9.150,1327.0,prtbl trm,451,5784,828308371,DEBIT,0,active,2030-03-08,2022-09-27 07:22:23,955.98,payment,139091.35
52020,4145536,46.0.8.90,144.0,cash_in,10,4319,828308371,DEBIT,0,active,2030-03-08,2022-10-27 21:49:11,956.06,in_acc,140047.41
52021,4211112,37.0.127.195,1036.0,cash_in,30,5188,828308371,DEBIT,0,active,2030-03-08,2022-10-28 14:07:23,956.2,transfer,139091.21
52022,4277140,188.0.169.60,471.0,atm,-1,8420,828308371,DEBIT,1,active,2030-03-08,2022-10-31 06:15:07,956.29,bad,139091.21
52023,4374716,185.233.0.60,81.0,ATM,10,9054,828308371,DEBIT,0,active,2030-03-08,2023-01-05 23:09:04,956.09,in_acc,140047.3
52024,4539199,217.26.0.135,688.0,ATM,30,5188,828308371,DEBIT,0,active,2030-03-08,2023-01-11 03:03:49,955.75,transfer,139091.55
52025,4646657,217.26.0.135,688.0,ATM,25,3496,828308371,DEBIT,0,active,2030-03-08,2023-01-18 05:29:29,955.64,country_transfer,138135.91
52026,5078668,195.143.0.0,1361.0,cash_out,20,9054,828308371,DEBIT,0,active,2030-03-08,2023-02-27 21:33:51,955.85,out,137180.06
52027,5287715,188.0.169.60,471.0,atm,-1,8754,828308371,DEBIT,1,active,2030-03-08,2023-03-18 08:44:27,955.91,bad,137180.06
52028,5290569,46.0.9.75,1322.0,cash_out,20,4594,828308371,DEBIT,0,active,2030-03-08,2023-03-23 14:25:14,956.04,decrease_on_acc,136224.02
52029,5319047,217.26.0.135,688.0,ATM,451,4319,828308371,DEBIT,0,active,2030-03-08,2023-04-20 10:07:56,956.08,payment,135267.94
52030,5404510,37.0.127.180,1035.0,atm,20,5188,828308371,DEBIT,0,active,2030-03-08,2023-04-20 15:20:27,956.14,from_acc,134311.8
52031,5432058,217.26.0.135,688.0,ATM,25,3686,828308371,DEBIT,0,active,2030-03-08,2023-04-23 23:09:10,956.14,country_transfer,133355.66
52032,5556588,217.26.0.135,688.0,ATM,30,8573,828308371,DEBIT,0,active,2030-03-08,2023-05-29 07:01:13,955.62,transfer,132400.04
52033,5627077,128.0.24.90,889.0,ATM,10,4594,828308371,DEBIT,0,active,2030-03-08,2023-08-17 14:57:08,955.93,in_acc,133355.97
52034,5685523,188.0.169.60,471.0,atm,30,9054,828308371,DEBIT,0,active,2030-03-08,2023-08-29 12:46:35,956.03,transfer,132399.94
52035,5765009,188.128.16.76,1189.0,cash_out,20,7959,828308371,DEBIT,0,active,2030-03-08,2023-09-10 00:04:32,955.76,decrease_on_acc,131444.18
52036,5891525,217.26.0.135,688.0,ATM,451,4319,828308371,DEBIT,0,active,2030-03-08,2023-09-22 23:38:22,956.04,payment,130488.14
52037,5946527,95.167.0.75,205.0,ATM,30,4594,828308371,DEBIT,0,active,2030-03-08,2023-10-04 12:06:59,956.12,transfer,129532.02
52038,6023381,188.0.189.90,838.0,Portable term,-1,5873,828308371,DEBIT,1,active,2030-03-08,2023-10-18 05:23:22,955.96,err_code,129532.02
52039,6198542,46.0.9.150,1327.0,prtbl trm,-1,8573,828308371,DEBIT,2,active,2030-03-08,2023-11-15 10:17:01,956.12,err,129532.02
52040,6227131,185.17.0.30,1044.0,ATM,10,9054,828308371,DEBIT,0,active,2030-03-08,2023-12-18 19:22:37,956.02,add_on_acc,130488.04
52041,6258575,46.0.9.150,1327.0,prtbl trm,451,8814,828308371,DEBIT,0,active,2030-03-08,2023-12-30 22:14:29,955.94,payment,129532.1
52042,6395540,217.26.0.135,688.0,ATM,30,4319,828308371,DEBIT,0,active,2030-03-08,2023-12-31 20:32:50,955.97,transfer,128576.13
52043,6470010,188.0.169.60,471.0,atm,451,5784,828308371,DEBIT,0,active,2030-03-08,2024-01-15 01:37:45,955.91,payment,127620.22
52044,6607549,194.0.162.105,747.0,cash_in,25,7959,828308371,DEBIT,0,active,2030-03-08,2024-01-26 11:37:33,956.09,country_transfer,126664.13
52045,6609566,79.104.0.75,641.0,atm,10,8754,828308371,DEBIT,0,active,2030-03-08,2024-03-07 10:25:16,956.07,in,127620.2
52046,6713672,188.0.189.90,838.0,Portable term,30,3496,828308371,DEBIT,0,active,2030-03-08,2024-03-09 16:37:10,955.84,transfer,126664.36
52047,6749585,217.26.0.135,688.0,ATM,-1,8754,828308371,DEBIT,1,active,2030-03-08,2024-05-07 14:41:18,956.05,err,126664.36
52048,6898055,217.26.0.135,688.0,ATM,25,8573,828308371,DEBIT,0,active,2030-03-08,2024-06-27 12:49:01,956.06,diff_cntry,125708.3
52049,7042706,46.0.9.150,1327.0,prtbl trm,451,5873,828308371,DEBIT,0,active,2030-03-08,2024-07-16 09:51:04,955.76,payment,124752.54
52050,7319375,95.167.0.240,219.0,ATM,10,9054,828308371,DEBIT,0,active,2030-03-08,2024-07-19 14:12:16,956.32,in,125708.86
52051,8274618,128.0.24.15,880.0,cash_in,10,8573,828308371,DEBIT,0,active,2030-03-08,2024-08-31 07:56:49,955.95,add_on_acc,126664.81
52052,8420740,46.0.9.150,1327.0,prtbl trm,30,9054,828308371,DEBIT,0,active,2030-03-08,2024-09-05 08:10:56,955.93,transfer,125708.88
52053,8706177,188.0.189.90,838.0,Portable term,30,4319,828308371,DEBIT,0,active,2030-03-08,2024-09-08 02:53:09,955.75,transfer,124753.13
52054,8987647,193.0.151.180,68.0,atm,10,4594,828308371,DEBIT,0,active,2030-03-08,2024-09-18 17:42:33,956.16,in,125709.29
52055,9692057,188.0.189.90,838.0,Portable term,451,3968,828308371,DEBIT,0,active,2030-03-08,2024-10-06 02:00:36,956.18,payment,124753.11
52056,9939025,37.0.127.195,1036.0,cash_in,451,8420,828308371,DEBIT,0,active,2030-03-08,2024-10-22 10:21:33,956.02,payment,123797.09
52057,9939710,95.106.0.105,551.0,atm,10,3686,828308371,DEBIT,0,active,2030-03-08,2024-11-04 14:41:05,956.15,in_acc,124753.24
52058,1285426,193.0.151.225,75.0,pos trm,25,2784,191845802,CREDIT,0,act,2025-06-04,2022-02-01 22:59:05,1193.92,diff_cntry,183353.08
52059,1488692,188.0.169.150,479.0,cash_out,30,3779,191845802,CREDIT,0,act,2025-06-04,2022-02-14 03:11:42,1193.86,transfer,182159.22
52060,1569647,193.0.151.225,75.0,pos trm,30,9267,191845802,CREDIT,0,act,2025-06-04,2022-02-17 20:15:48,1193.84,transfer,180965.38
52061,1601284,188.0.169.150,479.0,cash_out,451,2784,191845802,CREDIT,0,act,2025-06-04,2022-06-16 08:03:18,1193.98,payment,179771.4
52062,1875106,95.106.0.15,542.0,atm,10,7925,191845802,CREDIT,0,act,2025-06-04,2022-07-03 19:38:51,1194.01,add_on_acc,180965.41
52063,1925327,45.154.0.0,292.0,cash_in,10,2355,191845802,CREDIT,0,act,2025-06-04,2022-07-05 19:00:09,1194.14,in,182159.55
52064,1939258,85.140.0.180,1265.0,port_trm,451,5564,191845802,CREDIT,0,act,2025-06-04,2022-08-15 12:01:24,1193.91,payment,180965.64
52065,2020813,85.140.0.180,1265.0,port_trm,-1,7602,191845802,CREDIT,1,act,2025-06-04,2022-11-02 02:52:47,1194.25,bad,180965.64
52066,2166351,188.43.0.0,1404.0,cash_out,451,9267,191845802,CREDIT,0,act,2025-06-04,2022-11-13 02:32:45,1194.12,payment,179771.52
52067,2594861,188.43.0.0,1404.0,cash_out,-1,2784,191845802,CREDIT,1,act,2025-06-04,2022-11-18 18:52:24,1194.12,bad,179771.52
52068,2810096,46.0.128.90,705.0,cash_in,10,8456,191845802,CREDIT,0,act,2025-06-04,2022-12-28 05:40:57,1194.02,in_acc,180965.54
52069,2966038,5.189.0.165,869.0,cash_out,30,1622,191845802,CREDIT,0,act,2025-06-04,2022-12-28 11:24:44,1194.05,transfer,179771.49
52070,3133880,188.43.0.0,1404.0,cash_out,451,1622,191845802,CREDIT,0,act,2025-06-04,2023-01-05 09:43:14,1194.08,payment,178577.41
52071,3531499,5.189.0.165,869.0,cash_out,451,7602,191845802,CREDIT,0,act,2025-06-04,2023-01-07 07:48:52,1193.98,payment,177383.43
52072,3802750,85.140.0.180,1265.0,port_trm,-1,2784,191845802,CREDIT,1,act,2025-06-04,2023-01-13 15:10:27,1194.01,err,177383.43
52073,3885229,85.140.0.180,1265.0,port_trm,-1,2357,191845802,CREDIT,2,act,2025-06-04,2023-02-10 20:38:43,1193.99,bad,177383.43
52074,4170538,62.118.0.30,522.0,ATM,451,2784,191845802,CREDIT,0,act,2025-06-04,2023-02-22 08:18:40,1194.02,payment,176189.41
52075,4206555,188.0.169.150,479.0,cash_out,25,1481,191845802,CREDIT,0,act,2025-06-04,2023-02-26 11:59:15,1194.04,diff_cntry,174995.37
52076,4291830,188.43.0.0,1404.0,cash_out,451,7925,191845802,CREDIT,0,act,2025-06-04,2023-03-11 23:03:43,1193.62,payment,173801.75
52077,4443528,193.0.151.225,75.0,pos trm,-1,3892,191845802,CREDIT,1,act,2025-06-04,2023-03-13 18:10:24,1194.12,bad,173801.75
52078,4529023,188.43.0.0,1404.0,cash_out,25,3892,191845802,CREDIT,0,act,2025-06-04,2023-03-13 21:15:24,1194.16,country_transfer,172607.59
52079,5039722,193.0.151.225,75.0,pos trm,451,8844,191845802,CREDIT,0,act,2025-06-04,2023-04-24 13:15:29,1194.04,payment,171413.55
52080,5173958,193.0.151.225,75.0,pos trm,25,7925,191845802,CREDIT,0,act,2025-06-04,2023-07-04 05:05:27,1194.04,country_transfer,170219.51
52081,5582193,188.0.169.150,479.0,cash_out,-1,4651,191845802,CREDIT,1,act,2025-06-04,2023-07-17 22:49:55,1193.65,err_code,170219.51
52082,5673230,188.43.0.0,1404.0,cash_out,451,1622,191845802,CREDIT,0,act,2025-06-04,2023-08-02 14:02:36,1193.99,payment,169025.52
52083,5995260,5.189.0.165,869.0,cash_out,30,2357,191845802,CREDIT,0,act,2025-06-04,2023-08-17 11:49:51,1194.14,transfer,167831.38
52084,6270548,188.0.169.150,479.0,cash_out,-1,3779,191845802,CREDIT,1,act,2025-06-04,2023-09-22 13:32:59,1194.04,err,167831.38
52085,6314080,188.43.0.0,1404.0,cash_out,451,7823,191845802,CREDIT,0,act,2025-06-04,2023-10-01 05:11:11,1194.16,payment,166637.22
52086,6464582,62.118.0.30,522.0,ATM,30,3779,191845802,CREDIT,0,act,2025-06-04,2023-10-05 05:54:29,1193.97,transfer,165443.25
52087,6484408,85.140.0.240,1271.0,ATM,20,4066,191845802,CREDIT,0,act,2025-06-04,2023-10-06 04:29:00,1193.82,from_acc,164249.43
52088,6647040,188.43.0.0,1404.0,cash_out,451,5564,191845802,CREDIT,0,act,2025-06-04,2023-10-12 23:21:26,1193.74,payment,163055.69
52089,6690862,5.189.0.165,869.0,cash_out,451,7303,191845802,CREDIT,0,act,2025-06-04,2023-10-27 23:26:29,1194.07,payment,161861.62
52090,7010119,193.0.151.225,75.0,pos trm,25,5856,191845802,CREDIT,0,act,2025-06-04,2023-10-28 18:19:02,1193.78,country_transfer,160667.84
52091,7099400,193.0.151.225,75.0,pos trm,-1,3630,191845802,CREDIT,1,act,2025-06-04,2023-11-12 11:49:26,1194.01,bad,160667.84
52092,7279876,134.0.98.180,804.0,atm,10,7925,191845802,CREDIT,0,act,2025-06-04,2023-11-17 17:01:23,1193.89,in,161861.73
52093,7443316,46.0.176.165,129.0,ATM,10,7925,191845802,CREDIT,0,act,2025-06-04,2023-11-23 19:14:57,1194.03,in,163055.76
52094,7563730,62.118.0.30,522.0,ATM,-1,7602,191845802,CREDIT,1,act,2025-06-04,2023-11-25 10:57:55,1194.02,err_code,163055.76
52095,7631369,193.0.151.225,75.0,pos trm,451,1481,191845802,CREDIT,0,act,2025-06-04,2023-11-25 22:19:09,1193.82,payment,161861.94
52096,7713871,188.43.0.0,1404.0,cash_out,30,5564,191845802,CREDIT,0,act,2025-06-04,2023-11-30 07:22:30,1194.06,transfer,160667.88
52097,7745233,46.0.188.135,1238.0,atm,20,2687,191845802,CREDIT,0,act,2025-06-04,2023-12-31 20:30:52,1194.18,from_acc,159473.7
52098,8090686,62.118.0.30,522.0,ATM,451,9097,191845802,CREDIT,0,act,2025-06-04,2024-01-02 11:52:48,1193.83,payment,158279.87
52099,8253622,62.118.0.30,522.0,ATM,30,9267,191845802,CREDIT,0,act,2025-06-04,2024-02-07 15:30:04,1193.78,transfer,157086.09
52100,8321409,85.140.0.180,1265.0,port_trm,25,7506,191845802,CREDIT,0,act,2025-06-04,2024-04-29 03:29:33,1193.99,diff_cntry,155892.1
52101,8471355,188.0.169.150,479.0,cash_out,451,7823,191845802,CREDIT,0,act,2025-06-04,2024-05-05 22:38:01,1193.96,payment,154698.14
52102,8598055,5.189.0.165,869.0,cash_out,30,7823,191845802,CREDIT,0,act,2025-06-04,2024-05-12 02:12:50,1193.99,transfer,153504.15
52103,9077666,188.0.169.150,479.0,cash_out,25,8844,191845802,CREDIT,0,act,2025-06-04,2024-06-10 09:06:47,1193.82,country_transfer,152310.33
52104,9083393,62.118.0.30,522.0,ATM,451,7823,191845802,CREDIT,0,act,2025-06-04,2024-06-10 15:17:38,1193.87,payment,151116.46
52105,9246913,193.0.151.225,75.0,pos trm,25,8844,191845802,CREDIT,0,act,2025-06-04,2024-06-23 19:31:23,1194.0,diff_cntry,149922.46
52106,9312049,188.0.169.150,479.0,cash_out,30,7823,191845802,CREDIT,0,act,2025-06-04,2024-07-10 01:22:24,1194.09,transfer,148728.37
52107,9416700,217.26.0.15,675.0,cash_out,20,3779,191845802,CREDIT,0,act,2025-06-04,2024-09-18 21:56:51,1193.97,out,147534.4
52108,9449191,5.189.0.165,869.0,cash_out,30,8794,191845802,CREDIT,0,act,2025-06-04,2024-10-15 04:22:16,1194.1,transfer,146340.3
52109,9471142,193.0.151.225,75.0,pos trm,451,9267,191845802,CREDIT,0,act,2025-06-04,2024-10-21 00:25:18,1193.85,payment,145146.45
52110,9481465,188.0.169.150,479.0,cash_out,451,5856,191845802,CREDIT,0,act,2025-06-04,2024-11-05 04:53:29,1194.23,payment,143952.22
52111,9516133,188.0.169.150,479.0,cash_out,25,9329,191845802,CREDIT,0,act,2025-06-04,2024-11-08 10:38:53,1194.24,country_transfer,142757.98
52112,9606915,85.140.0.180,1265.0,port_trm,25,3172,191845802,CREDIT,0,act,2025-06-04,2024-11-22 06:14:07,1194.14,diff_cntry,141563.84
52113,9876312,85.140.0.180,1265.0,port_trm,25,7602,191845802,CREDIT,0,act,2025-06-04,2024-11-23 22:36:43,1194.06,diff_cntry,140369.78
52114,1099889,128.0.24.180,897.0,atm,20,2923,860457500,CREDIT,0,active,2027-04-11,2022-01-08 23:26:47,497.15,decrease_on_acc,160910.85
52115,1151687,188.18.0.15,222.0,cash_out,-1,9049,860457500,CREDIT,1,active,2027-04-11,2022-01-22 13:52:15,496.94,bad,160910.85
52116,1216875,188.0.0.180,1218.0,port_trm,-1,4163,860457500,CREDIT,2,active,2027-04-11,2022-02-06 01:11:32,496.67,err_code,160910.85
52117,1464787,95.106.0.120,553.0,cash_in,451,7493,860457500,CREDIT,0,active,2027-04-11,2022-02-26 13:55:25,497.04,payment,160413.81
52118,1669294,188.18.0.15,222.0,cash_out,20,4757,860457500,CREDIT,0,active,2027-04-11,2022-03-05 22:26:21,497.24,out,159916.57
52119,1676709,128.0.24.45,883.0,atm,10,6431,860457500,CREDIT,0,active,2027-04-11,2022-03-15 08:21:46,497.07,in,160413.64
52120,1820897,78.24.158.219,949.0,port_trm,-1,7862,860457500,CREDIT,1,active,2027-04-11,2022-03-16 11:47:44,496.86,bad,160413.64
52121,2087704,46.0.143.105,819.0,cash_out,20,7493,860457500,CREDIT,0,active,2027-04-11,2022-03-19 04:24:31,497.03,from_acc,159916.61
52122,2583281,212.20.0.0,445.0,ATM,30,9154,860457500,CREDIT,0,active,2027-04-11,2022-04-17 09:11:17,496.9,transfer,159419.71
52123,2594821,95.106.0.120,553.0,cash_in,30,7493,860457500,CREDIT,0,active,2027-04-11,2022-05-26 17:38:36,496.98,transfer,158922.73
52124,2685045,46.0.0.135,664.0,cash_out,25,3507,860457500,CREDIT,0,active,2027-04-11,2022-06-18 21:57:15,497.0,diff_cntry,158425.73
52125,2840336,5.189.0.60,860.0,cash_in,10,7292,860457500,CREDIT,0,active,2027-04-11,2022-07-04 23:49:25,496.88,in,158922.61
52126,3013080,46.0.8.0,137.0,cash_out,20,6431,860457500,CREDIT,0,active,2027-04-11,2022-07-14 06:38:55,497.1,out,158425.51
52127,3132969,212.20.0.0,445.0,ATM,25,5592,860457500,CREDIT,0,active,2027-04-11,2022-07-28 21:16:03,497.05,diff_cntry,157928.46
52128,3186006,86.111.0.210,1358.0,prtbl trm,30,4667,860457500,CREDIT,0,active,2027-04-11,2022-09-12 13:01:31,497.11,transfer,157431.35
52129,3761114,95.106.0.120,553.0,cash_in,451,3491,860457500,CREDIT,0,active,2027-04-11,2022-09-27 03:24:02,497.02,payment,156934.33
52130,3959399,62.118.0.195,535.0,atm,10,7941,860457500,CREDIT,0,active,2027-04-11,2022-11-11 14:01:26,497.0,add_on_acc,157431.33
52131,4237366,86.111.0.210,1358.0,prtbl trm,451,5592,860457500,CREDIT,0,active,2027-04-11,2022-11-16 13:30:19,496.96,payment,156934.37
52132,4618706,46.0.0.135,664.0,cash_out,451,1709,860457500,CREDIT,0,active,2027-04-11,2022-12-22 20:19:44,497.25,payment,156437.12
52133,4677195,212.20.0.0,445.0,ATM,451,3507,860457500,CREDIT,0,active,2027-04-11,2023-01-22 03:01:35,496.98,payment,155940.14
52134,4838138,188.18.0.15,222.0,cash_out,-1,3507,860457500,CREDIT,1,active,2027-04-11,2023-01-30 13:15:47,497.13,err_code,155940.14
52135,4907029,188.18.0.15,222.0,cash_out,25,5856,860457500,CREDIT,0,active,2027-04-11,2023-02-21 11:17:11,497.27,diff_cntry,155442.87
52136,5237379,188.0.0.180,1218.0,port_trm,30,7493,860457500,CREDIT,0,active,2027-04-11,2023-04-17 21:21:30,496.99,transfer,154945.88
52137,5454478,78.24.158.219,949.0,port_trm,-1,9049,860457500,CREDIT,1,active,2027-04-11,2023-05-15 10:18:23,496.77,err,154945.88
52138,5753759,188.18.0.15,222.0,cash_out,25,7941,860457500,CREDIT,0,active,2027-04-11,2023-06-10 05:23:19,497.06,country_transfer,154448.82
52139,5872711,37.0.124.150,731.0,prtbl trm,451,7493,860457500,CREDIT,0,active,2027-04-11,2023-07-14 18:57:00,497.0,payment,153951.82
52140,5887394,86.111.0.210,1358.0,prtbl trm,25,2452,860457500,CREDIT,0,active,2027-04-11,2023-08-11 14:21:44,497.11,diff_cntry,153454.71
52141,6029493,128.0.94.0,1094.0,atm,20,7292,860457500,CREDIT,0,active,2027-04-11,2023-08-23 05:26:29,496.95,from_acc,152957.76
52142,6181929,109.126.0.60,369.0,cash_in,10,1709,860457500,CREDIT,0,active,2027-04-11,2023-08-29 08:26:06,497.22,in,153454.98
52143,6895615,46.0.0.135,664.0,cash_out,30,5953,860457500,CREDIT,0,active,2027-04-11,2023-08-31 01:03:56,496.95,transfer,152958.03
52144,6907303,212.20.0.0,445.0,ATM,451,7941,860457500,CREDIT,0,active,2027-04-11,2023-09-02 11:19:06,496.83,payment,152461.2
52145,6950127,78.24.158.219,949.0,port_trm,30,9154,860457500,CREDIT,0,active,2027-04-11,2023-09-17 08:50:03,496.93,transfer,151964.27
52146,7020638,151.0.38.90,394.0,ATM,10,4320,860457500,CREDIT,0,active,2027-04-11,2023-10-11 07:39:26,497.02,in,152461.29
52147,7054295,188.18.0.15,222.0,cash_out,30,4163,860457500,CREDIT,0,active,2027-04-11,2023-10-17 00:28:04,496.91,transfer,151964.38
52148,7252347,188.18.0.15,222.0,cash_out,30,4966,860457500,CREDIT,0,active,2027-04-11,2023-10-20 23:50:10,496.86,transfer,151467.52
52149,7350112,188.18.0.15,222.0,cash_out,30,9049,860457500,CREDIT,0,active,2027-04-11,2023-10-22 01:53:38,497.26,transfer,150970.26
52150,7512534,188.0.166.60,1303.0,atm,20,4757,860457500,CREDIT,0,active,2027-04-11,2023-12-22 03:22:34,497.1,out,150473.16
52151,7895945,46.0.0.135,664.0,cash_out,30,2288,860457500,CREDIT,0,active,2027-04-11,2024-01-05 06:18:37,497.12,transfer,149976.04
52152,7902993,193.0.151.45,53.0,ATM,20,5592,860457500,CREDIT,0,active,2027-04-11,2024-02-07 09:07:14,497.04,from_acc,149479.0
52153,8093502,31.134.0.0,1116.0,atm,20,2452,860457500,CREDIT,0,active,2027-04-11,2024-04-09 04:03:39,497.08,decrease_on_acc,148981.92
52154,8190223,188.0.166.180,1312.0,ATM,10,1709,860457500,CREDIT,0,active,2027-04-11,2024-04-12 05:01:11,497.03,add_on_acc,149478.95
52155,8243714,37.0.124.150,731.0,prtbl trm,451,9729,860457500,CREDIT,0,active,2027-04-11,2024-04-14 19:42:12,496.97,payment,148981.98
52156,8301423,188.18.0.0,220.0,atm,25,1709,860457500,CREDIT,0,active,2027-04-11,2024-04-15 03:30:30,496.88,country_transfer,148485.1
52157,8321070,88.210.0.195,359.0,cash_out,20,4667,860457500,CREDIT,0,active,2027-04-11,2024-06-07 05:16:35,497.22,out,147987.88
52158,8361382,134.0.98.195,806.0,cash_in,10,1709,860457500,CREDIT,0,active,2027-04-11,2024-06-12 18:58:30,497.2,add_on_acc,148485.08
52159,8787744,95.106.0.120,553.0,cash_in,-1,5856,860457500,CREDIT,1,active,2027-04-11,2024-06-14 02:50:45,497.22,err,148485.08
52160,8878586,188.18.0.15,222.0,cash_out,30,9729,860457500,CREDIT,0,active,2027-04-11,2024-06-21 10:58:57,496.95,transfer,147988.13
52161,9076615,95.167.0.60,204.0,ATM,20,4966,860457500,CREDIT,0,active,2027-04-11,2024-07-19 22:29:16,497.04,out,147491.09
52162,9214931,78.24.158.219,949.0,port_trm,25,5953,860457500,CREDIT,0,active,2027-04-11,2024-08-14 09:59:07,497.03,diff_cntry,146994.06
52163,9432033,95.106.0.120,553.0,cash_in,25,5863,860457500,CREDIT,0,active,2027-04-11,2024-09-10 17:02:49,496.73,diff_cntry,146497.33
52164,9757099,95.106.0.120,553.0,cash_in,30,8719,860457500,CREDIT,0,active,2027-04-11,2024-09-16 07:17:07,496.9,transfer,146000.43
52165,9791766,217.112.0.0,1471.0,ATM,20,9729,860457500,CREDIT,0,active,2027-04-11,2024-11-28 17:40:33,496.93,from_acc,145503.5
52166,9903446,82.200.0.195,624.0,atm,10,7152,969838140,DEBIT,0,active,2030-06-10,2024-08-16 05:03:19,509.82,add_on_acc,652965.0623529411
52167,9999484,193.0.149.210,1158.0,atm,30,7855,198328433,DEBIT,0,act,2028-07-10,2024-11-07 20:47:53,332.13,transfer,906682.2157692309
52168,9843429,212.17.0.210,1330.0,atm,451,9011,527729205,CREDIT,0,act,2030-03-06,2024-11-03 05:48:50,722.0,payment,600833.1892857143
52169,9921632,128.0.81.30,1290.0,atm,30,9494,298813281,CREDIT,0,active,2026-09-13,2024-11-28 17:51:37,624.9,transfer,244238.81615384616
52170,9864567,145.255.0.165,246.0,atm,451,2030,443427305,DEBIT,0,act,2030-09-16,2024-11-03 10:55:14,172.25,payment,637743.3666666667
52171,9841695,2.94.0.225,1472.0,atm,10,7968,514552667,DEBIT,0,active,2029-12-25,2024-09-14 18:44:30,701.19,add_on_acc,692129.122
52172,9961927,212.13.0.75,241.0,atm,25,3455,988406718,CREDIT,0,act,2027-01-31,2024-10-17 17:03:50,950.35,country_transfer,126042.07207547167
52173,9989562,128.0.80.60,432.0,atm,451,8441,943042597,DEBIT,0,active,2030-01-04,2024-11-24 09:00:38,758.85,payment,529703.2023728814
52174,9819582,128.0.80.60,432.0,atm,10,9170,578559870,DEBIT,0,act,2029-08-15,2024-10-31 02:01:31,464.93,in,302541.6855932203
52175,9958641,85.21.0.105,272.0,atm,25,6660,451238135,DEBIT,0,active,2027-09-23,2024-11-19 04:09:45,518.96,country_transfer,399395.4960377359
52176,9628471,178.44.0.90,1293.0,atm,10,4551,168229833,CREDIT,0,act,2027-10-23,2024-11-03 21:12:39,1198.81,add_on_acc,315797.0855555556
52177,9946946,46.0.42.120,1494.0,atm,25,4575,459905582,DEBIT,0,act,2029-04-19,2024-11-23 22:54:12,934.04,diff_cntry,590293.4490909091
52178,9701112,2.94.0.240,1042.0,atm,25,6124,470045409,CREDIT,0,active,2027-12-20,2024-11-28 10:53:15,989.07,country_transfer,188485.8548148148
52179,9664650,46.0.43.105,1489.0,atm,25,3498,645465549,CREDIT,0,active,2027-06-14,2024-10-30 09:40:43,451.16,country_transfer,964263.1598245612
52180,9956651,178.44.0.90,1293.0,atm,30,5279,607040900,CREDIT,0,active,2030-11-22,2024-11-27 20:53:26,762.9,transfer,635844.4445762711
52181,9979690,62.76.0.135,617.0,atm,30,2362,214082706,CREDIT,0,act,2027-06-11,2024-11-17 21:12:29,222.98,transfer,769305.89
52182,9888672,188.0.175.30,1432.0,atm,451,4891,260907808,CREDIT,0,active,2028-11-20,2024-11-23 23:57:47,161.98,payment,620414.9232142858
52183,9513623,2.94.0.240,1042.0,atm,10,7468,658283009,DEBIT,0,act,2029-03-25,2024-11-11 21:21:20,613.18,add_on_acc,825290.6803703704
52184,9965011,46.0.43.105,1489.0,atm,451,3742,131225348,DEBIT,0,act,2025-09-02,2024-11-08 09:46:09,421.01,payment,907581.1242307692
52185,9498166,128.0.80.60,432.0,atm,25,6397,229831613,DEBIT,0,active,2025-10-18,2024-11-28 07:39:06,628.26,country_transfer,328693.10363636364
52186,9794867,212.17.0.210,1330.0,atm,-1,8556,305428527,DEBIT,1,act,2028-03-22,2024-11-27 23:54:26,859.88,err,374471.174
52187,9609721,145.255.0.165,246.0,atm,30,1330,420335531,DEBIT,0,act,2029-11-18,2024-10-11 02:30:47,710.93,transfer,746848.5921568627
52188,9925215,193.0.149.210,1158.0,atm,30,6774,926691384,DEBIT,0,act,2027-11-18,2024-11-06 14:25:52,289.93,transfer,735727.5130188679
52189,9973638,178.44.0.90,1293.0,atm,-1,1740,673168203,DEBIT,1,active,2030-01-08,2024-11-02 21:45:50,636.14,err,260154.1410526316
52190,9492690,85.21.0.105,272.0,atm,-1,7655,991618345,CREDIT,1,active,2029-10-24,2024-11-27 10:54:33,118.02,err,152623.51859649122
52191,9625710,188.0.175.30,1432.0,atm,20,4262,712762401,CREDIT,0,act,2027-10-14,2024-11-27 20:52:59,334.03,from_acc,666956.4644444444
52192,9909992,31.204.0.225,932.0,atm,25,1608,754271714,DEBIT,0,act,2028-05-05,2024-10-17 12:22:14,339.92,country_transfer,102119.15428571428
52193,9847719,83.222.0.180,407.0,atm,30,3233,283474675,DEBIT,0,active,2030-04-06,2024-11-21 15:49:17,268.69,transfer,446538.0076470588
52194,9657629,31.204.0.225,932.0,atm,-1,5130,302066811,DEBIT,1,active,2030-08-01,2024-09-29 22:04:12,320.99,err_code,250020.008
52195,9908345,128.0.80.60,432.0,atm,25,9352,856512306,CREDIT,0,act,2030-08-03,2024-11-03 04:54:39,898.21,country_transfer,811365.9823728814
52196,9808904,212.13.0.75,241.0,atm,-1,9363,769945989,DEBIT,1,active,2028-02-18,2024-11-23 07:53:28,183.02,err_code,118451.23909090908
52197,9972171,46.0.42.120,1494.0,atm,-1,8855,983146468,DEBIT,1,active,2025-05-25,2024-11-19 01:38:27,913.08,bad,75632.09296296295
52198,9994969,62.76.0.135,617.0,atm,451,8827,821481548,CREDIT,0,active,2029-03-26,2024-10-24 20:18:45,1186.02,payment,672781.1833333333
52199,9784480,145.255.0.165,246.0,atm,-1,9866,925471139,CREDIT,1,act,2030-02-15,2024-11-09 21:36:43,281.03,bad,857771.1329411764
52200,9999813,178.44.0.90,1293.0,atm,10,5822,378413987,CREDIT,0,active,2030-03-07,2024-10-23 11:33:07,180.13,in,165379.70754716982
52201,9688121,193.0.149.210,1158.0,atm,25,5407,850222340,CREDIT,0,act,2026-11-29,2024-11-21 11:32:02,1069.88,country_transfer,203101.4657142857
52202,9947051,188.0.162.75,494.0,atm,25,4384,393037692,CREDIT,0,active,2030-10-06,2024-11-28 09:31:24,555.27,diff_cntry,83267.47660377358
52203,9747297,185.1.0.120,878.0,atm,20,4909,465388842,CREDIT,0,act,2027-05-04,2024-11-18 21:06:32,123.0,out,599967.9896491228
52204,9649772,85.21.0.105,272.0,atm,30,2242,224496248,DEBIT,0,act,2027-09-05,2024-11-14 07:09:40,336.31,transfer,286468.1106779661
52205,9832461,46.0.42.120,1494.0,atm,30,8405,368567122,CREDIT,0,act,2027-05-31,2024-09-21 15:08:11,233.86,transfer,196664.6572727273
52206,9964275,212.13.0.75,241.0,atm,451,6695,583470867,CREDIT,0,active,2025-01-02,2024-11-09 18:49:55,440.0,payment,161500.28307692308
52207,9667600,31.204.0.225,932.0,atm,25,8952,975299233,DEBIT,0,act,2029-07-09,2024-11-19 19:01:23,115.05,diff_cntry,497786.6837254902
52208,9948378,82.200.0.195,624.0,atm,-1,4809,219605123,CREDIT,1,active,2027-07-16,2024-11-27 14:22:40,1037.78,err,38896.19431372549
52209,9915563,178.44.0.90,1293.0,atm,25,9784,224394340,DEBIT,0,act,2028-08-02,2024-11-11 07:23:09,194.37,diff_cntry,571166.5162745098
52210,9904055,31.204.0.225,932.0,atm,20,9109,492690255,DEBIT,0,active,2025-01-17,2024-11-11 04:12:24,957.21,from_acc,723315.5960714286
52211,9821308,82.200.0.195,624.0,atm,451,2477,955491217,DEBIT,0,active,2025-10-18,2024-11-27 06:28:27,671.02,payment,627967.2920689655
52212,9914470,31.204.0.225,932.0,atm,25,6050,149392052,DEBIT,0,act,2028-06-04,2024-11-14 21:35:23,156.88,diff_cntry,765717.4121428571
52213,9939879,193.0.145.45,489.0,atm,451,4339,737586578,CREDIT,0,active,2025-02-26,2024-11-13 01:31:02,993.01,payment,145312.25392857144
52214,9954532,188.0.162.75,494.0,atm,30,8422,461945067,DEBIT,0,act,2027-10-15,2024-11-27 00:45:48,811.18,transfer,92638.38428571427
52215,9519449,188.0.175.30,1432.0,atm,10,5834,939995366,CREDIT,0,act,2027-09-25,2024-11-23 18:12:35,940.88,in_acc,439913.8811111112
52216,9799707,83.222.0.180,407.0,atm,25,5956,936914118,DEBIT,0,act,2029-10-22,2024-11-25 06:31:19,923.12,country_transfer,707731.7239999999
52217,9839539,188.0.162.75,494.0,atm,30,5690,251702665,CREDIT,0,act,2030-04-05,2024-11-23 15:05:36,932.1,transfer,236230.14396226412
52218,9969299,31.204.0.225,932.0,atm,-1,5494,229072155,DEBIT,1,active,2027-01-21,2024-10-21 23:46:18,1043.99,err_code,216230.30333333332
52219,9616640,2.94.0.225,1472.0,atm,25,8777,615394396,CREDIT,0,active,2027-11-16,2024-11-14 12:22:21,1107.05,country_transfer,742655.6088461538
52220,9959762,188.0.162.75,494.0,atm,451,9804,897084963,CREDIT,0,act,2027-03-13,2024-11-04 21:07:59,379.21,payment,537709.658
52221,9889217,193.0.149.210,1158.0,atm,25,7289,424132168,CREDIT,0,active,2025-05-10,2024-11-07 02:25:13,1014.06,country_transfer,560439.8472413793
52222,9988112,46.0.42.120,1494.0,atm,20,2818,581429430,CREDIT,0,act,2025-11-05,2024-11-13 04:06:41,670.98,decrease_on_acc,660417.3439285714
52223,9939997,185.1.0.120,878.0,atm,10,5503,667437938,DEBIT,0,active,2028-07-23,2024-11-22 16:13:36,755.92,in,632936.6417857143
52224,9974957,46.0.43.105,1489.0,atm,-1,6547,175070237,DEBIT,1,active,2028-11-15,2024-11-24 20:47:37,909.24,bad,793564.4505660377
52225,9984336,85.21.0.105,272.0,atm,30,7529,545445024,DEBIT,0,act,2030-01-07,2024-09-13 04:12:58,957.96,transfer,893316.9416949153
52226,9984336,85.21.0.105,272.0,atm,451,3948,545445024,DEBIT,0,act,2030-01-07,2024-09-17 13:50:43,957.71,payment,892359.2316949153
52227,9752029,193.0.149.210,1158.0,atm,25,1127,989594700,CREDIT,0,active,2029-08-07,2024-11-28 05:25:16,255.1,diff_cntry,836037.8829824561
52228,9947227,2.94.0.225,1472.0,atm,30,8080,591496222,DEBIT,0,act,2030-02-02,2024-11-28 03:19:41,301.16,transfer,851353.7907142858
52229,9983631,193.0.149.210,1158.0,atm,30,8217,826098432,CREDIT,0,act,2028-09-29,2024-11-18 03:44:35,462.17,transfer,968734.0601754386
52230,9688331,82.200.0.195,624.0,atm,451,8515,501887306,CREDIT,0,act,2026-01-26,2024-11-06 05:53:28,937.31,payment,664003.557254902
52231,9679545,185.1.0.120,878.0,atm,30,1608,923992975,CREDIT,0,active,2029-04-29,2024-11-27 12:02:20,362.94,transfer,895794.861509434
52232,9856221,2.94.0.225,1472.0,atm,25,3076,494569529,DEBIT,0,active,2028-01-16,2024-11-18 10:30:45,165.95,country_transfer,794443.2133333334
52233,9964000,2.94.0.225,1472.0,atm,25,9143,857900962,DEBIT,0,act,2028-01-28,2024-10-28 05:14:20,321.82,country_transfer,632530.6945454545
52234,9915790,178.44.0.90,1293.0,atm,25,1390,281641519,DEBIT,0,active,2029-06-19,2024-10-26 01:50:20,935.84,country_transfer,729726.3358620689
52235,9897377,212.17.0.210,1330.0,atm,20,7396,856715242,DEBIT,0,act,2026-05-14,2024-11-05 06:30:33,979.27,from_acc,376665.2205263158
52236,9921123,128.0.81.30,1290.0,atm,451,2714,772933233,DEBIT,0,active,2025-12-05,2024-10-30 20:04:20,534.84,payment,394803.4980392157
52237,9640873,62.76.0.135,617.0,atm,-1,4213,515840267,DEBIT,1,active,2027-06-06,2024-11-17 09:52:38,207.33,err,182554.83947368423
52238,9764030,62.76.0.135,617.0,atm,30,7114,310131389,DEBIT,0,active,2027-07-06,2024-11-25 18:04:44,209.14,transfer,159617.61068965518
52239,9996903,2.94.0.240,1042.0,atm,10,1840,905135745,DEBIT,0,act,2027-12-05,2024-11-09 17:53:12,646.14,in_acc,844837.4710344827
52240,9753141,91.122.0.15,431.0,atm,20,1432,714467275,CREDIT,0,act,2030-09-14,2024-10-18 21:33:42,166.22,out,74670.76689655174
52241,9949672,128.0.81.30,1290.0,atm,10,7365,467548052,CREDIT,0,active,2027-03-01,2024-08-11 06:19:36,199.1,in_acc,102077.28392857144
52242,9811538,2.94.0.240,1042.0,atm,451,7939,319835686,CREDIT,0,act,2025-02-16,2024-11-23 16:06:51,454.91,payment,408251.8532075472
52243,9830438,83.222.0.180,407.0,atm,25,4362,399634036,DEBIT,0,act,2025-04-17,2024-09-15 22:36:05,197.77,diff_cntry,86610.57188679244
52244,9667434,128.0.81.30,1290.0,atm,20,7592,486166303,DEBIT,0,active,2027-02-08,2024-11-18 16:55:12,657.78,decrease_on_acc,308037.27137931035
52245,9630622,82.200.0.195,624.0,atm,30,3890,164812928,DEBIT,0,act,2025-06-11,2024-11-25 04:38:03,118.83,transfer,786034.1920338983
52246,9860478,185.1.0.120,878.0,atm,30,6015,279145349,DEBIT,0,act,2030-03-03,2024-11-09 02:06:37,606.96,transfer,858354.8916949152
52247,9553280,212.17.0.210,1330.0,atm,-1,6108,474184902,DEBIT,1,act,2027-09-15,2024-08-19 13:48:48,1099.97,err,95114.382
52248,9981274,193.0.145.45,489.0,atm,451,3839,134830786,CREDIT,0,act,2028-11-06,2024-09-29 22:33:30,815.86,payment,918360.8303389832
52249,9998955,128.0.80.60,432.0,atm,451,5925,780398344,DEBIT,0,active,2030-04-30,2024-11-09 13:51:26,1022.2,payment,468854.4617857143
52250,9892846,128.0.81.30,1290.0,atm,10,7761,654709929,DEBIT,0,act,2030-08-22,2024-11-27 14:00:49,203.23,in,609197.7096551724
52251,9769601,83.222.0.180,407.0,atm,10,1164,429842896,CREDIT,0,active,2025-02-01,2024-10-14 21:05:30,364.1,in_acc,259447.54925925925
52252,9782582,128.0.81.30,1290.0,atm,20,3484,409070399,DEBIT,0,active,2030-12-09,2024-10-28 18:51:25,420.07,decrease_on_acc,568117.7355555556
52253,9925713,46.0.42.120,1494.0,atm,20,1016,157128422,CREDIT,0,active,2027-08-30,2024-10-22 21:27:08,922.85,out,405535.9536363637
52254,9885355,31.204.0.225,932.0,atm,25,5497,812115634,DEBIT,0,act,2027-10-30,2024-11-14 01:21:44,214.06,country_transfer,955269.816
52255,9811643,46.0.42.120,1494.0,atm,30,4164,818202388,DEBIT,0,active,2027-06-04,2024-11-23 17:13:29,496.96,transfer,346515.5609803921
52256,9945327,31.204.0.225,932.0,atm,451,3348,508181338,DEBIT,0,act,2027-02-27,2024-11-04 06:45:33,694.16,payment,593182.7296551724
52257,9946698,128.0.81.30,1290.0,atm,10,8243,826489252,DEBIT,0,act,2028-03-01,2024-10-11 19:07:07,208.14,in_acc,143297.80615384615
52258,9905886,91.122.0.15,431.0,atm,30,5170,323334099,CREDIT,0,active,2029-11-20,2024-09-20 04:57:52,367.79,transfer,69600.36038461539
52259,9940713,212.17.0.210,1330.0,atm,451,4591,459293283,CREDIT,0,act,2030-11-10,2024-11-25 03:19:18,689.04,payment,870366.3519230769
52260,9804225,193.0.149.210,1158.0,atm,10,4293,671273475,CREDIT,0,act,2025-06-14,2024-11-18 21:55:31,1143.78,add_on_acc,571697.4324137932
52261,9898972,128.0.80.60,432.0,atm,25,7580,758283706,CREDIT,0,act,2030-02-26,2024-11-13 04:47:23,1179.88,country_transfer,238376.925
52262,9870535,145.255.0.165,246.0,atm,30,9392,167165799,DEBIT,0,active,2028-07-15,2024-07-08 05:57:39,141.3,transfer,514099.2272727273
52263,9996827,188.0.162.75,494.0,atm,30,8866,968196121,DEBIT,0,act,2028-11-19,2024-10-15 00:05:01,242.14,transfer,642901.5635294118
52264,9860541,2.94.0.225,1472.0,atm,30,4789,817600628,DEBIT,0,act,2030-11-15,2024-11-16 12:24:38,212.92,transfer,944727.851016949
52265,9951385,128.0.81.30,1290.0,atm,451,4356,281169539,DEBIT,0,act,2029-10-15,2024-11-27 19:11:29,755.02,payment,387726.4501754386
52266,9873039,193.0.145.45,489.0,atm,-1,8575,594143142,DEBIT,1,act,2029-06-22,2024-11-18 22:55:57,306.11,err,296451.14400000003
52267,9843689,212.13.0.75,241.0,atm,451,5452,705241788,CREDIT,0,act,2029-01-08,2024-11-14 23:38:37,532.1,payment,859466.5722807017
52268,9899946,193.0.149.210,1158.0,atm,451,7890,179629363,CREDIT,0,active,2025-01-16,2024-11-24 10:22:18,893.88,payment,906892.764
52269,9978324,188.0.175.30,1432.0,atm,451,8798,588992915,CREDIT,0,act,2030-05-09,2024-11-21 07:46:42,553.8,payment,402826.1011320755
52270,9976380,2.94.0.225,1472.0,atm,451,4257,947936095,DEBIT,0,act,2026-11-13,2024-11-25 02:04:21,914.82,payment,261492.56464285715
52271,9196206,178.44.0.90,1293.0,atm,10,2074,359051066,CREDIT,0,active,2025-04-14,2024-11-28 19:06:58,370.07,add_on_acc,908730.9701886792
52272,9751058,85.21.0.105,272.0,atm,451,3594,689776833,DEBIT,0,act,2025-08-19,2024-11-28 17:10:24,226.94,payment,607267.4154545455
52273,9602582,145.255.0.165,246.0,atm,25,3086,335869622,DEBIT,0,act,2028-06-24,2024-10-28 20:26:01,694.05,diff_cntry,369616.6480769231
52274,9936611,82.200.0.195,624.0,atm,20,5516,419690295,DEBIT,0,act,2026-06-05,2024-10-19 14:35:47,257.06,from_acc,823133.3268965518
52275,9971566,193.0.149.210,1158.0,atm,451,2042,101648380,CREDIT,0,act,2030-07-04,2024-11-16 11:06:35,506.14,payment,781788.23
52276,9987338,85.21.0.105,272.0,atm,451,6839,673793436,CREDIT,0,active,2026-09-05,2024-11-08 11:24:58,1036.98,payment,381531.01385964913
52277,9950905,85.21.0.105,272.0,atm,10,3993,398537125,CREDIT,0,active,2026-07-07,2024-11-26 23:06:07,480.07,add_on_acc,524167.2637735849
52278,9893885,2.94.0.225,1472.0,atm,-1,1898,347085095,DEBIT,2,act,2025-01-19,2024-11-05 12:02:45,1190.07,bad,608079.6255172414
52279,9992114,178.44.0.90,1293.0,atm,30,1030,748595117,DEBIT,0,active,2027-08-07,2024-11-07 15:17:03,514.8,transfer,844149.5442857144
52280,9855515,46.0.43.105,1489.0,atm,10,6742,514625615,CREDIT,0,act,2026-06-22,2024-10-11 21:10:11,460.13,in,602040.3705882352
52281,9761154,46.0.43.105,1489.0,atm,30,6088,417752575,DEBIT,0,active,2025-01-22,2024-10-31 06:15:36,729.94,transfer,909111.2329629628
52282,9839727,85.21.0.105,272.0,atm,451,1536,852977477,CREDIT,0,active,2026-05-28,2024-11-16 13:51:06,108.09,payment,540682.0017857143
52283,9780721,145.255.0.165,246.0,atm,-1,5022,684918605,CREDIT,1,act,2028-09-29,2024-11-12 22:31:03,1117.81,err_code,80078.73068965517
52284,9941249,212.13.0.75,241.0,atm,451,2772,239679825,CREDIT,0,act,2027-09-09,2024-11-06 08:23:01,321.86,payment,85531.5176923077
52285,9975525,46.0.42.120,1494.0,atm,10,8470,665447769,CREDIT,0,act,2029-02-25,2024-09-18 04:11:27,1184.13,in,642441.262
52286,9667479,2.94.0.240,1042.0,atm,451,8141,182067586,CREDIT,0,active,2027-08-20,2024-11-13 12:17:44,232.3,payment,306963.45230769226
52287,9919191,62.76.0.135,617.0,atm,-1,5405,293824996,DEBIT,1,active,2027-07-19,2024-11-27 04:54:12,867.87,err,46066.96892857143
52288,9939175,193.0.145.45,489.0,atm,10,5885,275721560,CREDIT,0,active,2026-04-21,2024-11-14 18:27:01,745.41,in_acc,458838.521372549
52289,9890354,193.0.149.210,1158.0,atm,20,2351,444503121,CREDIT,0,act,2028-03-04,2024-10-30 20:47:43,939.02,decrease_on_acc,321662.78641509434
52290,9953580,62.76.0.135,617.0,atm,20,5119,582462393,DEBIT,0,active,2028-03-01,2024-10-23 02:33:19,789.94,out,61871.52846153846
52291,9871882,83.222.0.180,407.0,atm,-1,1414,658752573,CREDIT,1,act,2026-10-20,2024-11-17 04:14:02,1066.03,err,40016.17730769231
52292,9738968,188.0.175.30,1432.0,atm,451,9275,126726893,DEBIT,0,active,2028-06-22,2024-11-20 07:31:57,951.84,payment,351820.4196551724
52293,9778964,83.222.0.180,407.0,atm,30,5219,126186952,CREDIT,0,act,2030-11-02,2024-09-17 19:06:01,312.95,transfer,303197.0
52294,9843165,83.222.0.180,407.0,atm,451,5491,997093996,DEBIT,0,act,2025-08-10,2024-11-10 22:55:40,196.97,payment,855836.004
52295,9767425,85.21.0.105,272.0,atm,20,6700,774581627,CREDIT,0,act,2029-07-15,2024-09-24 12:27:28,208.72,from_acc,224043.60214285715
52296,9934840,83.222.0.180,407.0,atm,30,9169,454204702,CREDIT,0,act,2028-01-16,2024-11-07 19:25:26,1002.19,transfer,52981.41037735848
52297,9873708,128.0.80.60,432.0,atm,10,4607,511249153,DEBIT,0,act,2028-02-17,2024-10-06 10:59:17,385.23,add_on_acc,584037.366226415
52298,9946613,82.200.0.195,624.0,atm,451,2796,742779127,DEBIT,0,active,2029-07-24,2024-11-14 01:22:57,408.93,payment,401830.4262962963
52299,9866602,188.0.162.75,494.0,atm,30,2783,481348272,CREDIT,0,act,2030-05-20,2024-08-03 00:29:04,183.09,transfer,630965.4109090909
52300,9866602,188.0.162.75,494.0,atm,451,7006,481348272,CREDIT,0,act,2030-05-20,2024-11-09 23:39:36,182.8,payment,630599.6409090909
52301,9638647,212.17.0.210,1330.0,atm,10,2519,129575167,CREDIT,0,act,2028-01-08,2024-11-20 10:57:57,883.32,in_acc,761222.5685714285
52302,9870374,188.0.175.30,1432.0,atm,20,4971,108703643,CREDIT,0,active,2030-10-09,2024-11-11 14:37:14,322.96,out,943820.569661017
52303,9811011,178.44.0.90,1293.0,atm,25,9833,826647770,CREDIT,0,active,2026-12-19,2024-11-05 07:18:22,756.74,country_transfer,267122.7254901961
52304,9914495,62.76.0.135,617.0,atm,30,6463,461642181,DEBIT,0,act,2029-02-04,2024-11-24 17:06:00,358.1,transfer,655041.6136363636
52305,9906114,193.0.149.210,1158.0,atm,451,7292,485922618,CREDIT,0,active,2025-07-21,2024-11-07 12:29:33,993.19,payment,575164.744
52306,9747130,85.21.0.105,272.0,atm,-1,6882,379947848,CREDIT,1,active,2026-10-12,2024-11-04 23:41:32,913.9,err_code,296283.27285714285
52307,9797083,193.0.149.210,1158.0,atm,451,8847,336424105,DEBIT,0,active,2029-04-27,2024-11-26 16:30:24,191.14,payment,802255.69
52308,9917315,188.0.162.75,494.0,atm,451,5167,864966934,CREDIT,0,act,2030-03-19,2024-11-06 22:52:10,1085.13,payment,811281.791372549
52309,9937979,83.222.0.180,407.0,atm,30,5329,549295747,CREDIT,0,active,2030-09-21,2024-11-23 04:02:34,1072.98,transfer,766683.5489473684
52310,9864044,193.0.145.45,489.0,atm,451,1898,921592575,CREDIT,0,act,2027-03-27,2024-11-17 16:49:09,488.95,payment,558013.5259649123
52311,9944333,2.94.0.225,1472.0,atm,30,8495,889260016,DEBIT,0,act,2028-04-03,2024-10-18 11:14:09,222.09,transfer,420196.47566037736
52312,9970092,188.0.162.75,494.0,atm,451,1186,114796321,CREDIT,0,act,2025-02-04,2024-10-22 05:23:26,908.85,payment,91844.11689655171
52313,9227823,212.17.0.210,1330.0,atm,10,8591,833021140,DEBIT,0,act,2026-06-20,2024-10-15 00:02:09,446.25,in,426122.0892307692
52314,9934492,128.0.81.30,1290.0,atm,20,9247,122842879,CREDIT,0,active,2029-04-06,2024-11-16 13:51:56,143.97,out,626463.0148275862
52315,9715208,193.0.145.45,489.0,atm,25,3390,564490757,DEBIT,0,active,2028-02-08,2024-11-24 03:57:02,900.15,country_transfer,200035.5740677966
52316,9964896,128.0.81.30,1290.0,atm,25,1724,874166633,DEBIT,0,active,2028-08-25,2024-11-28 03:52:35,1186.78,country_transfer,929018.0437254902
52317,9974940,85.21.0.105,272.0,atm,25,4085,904764417,DEBIT,0,active,2026-09-27,2024-10-14 14:11:48,103.71,diff_cntry,653178.3490909091
52318,9777841,46.0.42.120,1494.0,atm,25,3111,417837639,CREDIT,0,active,2025-01-07,2024-11-08 19:51:15,1099.91,country_transfer,399817.9827272727
52319,9581491,82.200.0.195,624.0,atm,20,3267,705038233,DEBIT,0,act,2024-12-18,2024-09-25 21:01:26,389.71,decrease_on_acc,972251.7155555557
52320,9719392,212.17.0.210,1330.0,atm,451,6206,554619072,DEBIT,0,active,2025-12-09,2024-10-23 23:18:26,881.91,payment,474913.20784313726
52321,9901697,62.76.0.135,617.0,atm,-1,4430,327555465,CREDIT,1,act,2028-09-22,2024-11-26 03:47:03,294.99,err,937566.086
52322,9836702,128.0.80.60,432.0,atm,20,2387,172741405,CREDIT,0,act,2025-02-01,2024-11-17 00:15:33,148.87,out,234037.8707142857
52323,9616871,188.0.175.30,1432.0,atm,30,9138,472498628,DEBIT,0,act,2027-04-20,2024-11-01 17:06:37,884.27,transfer,490234.65607142856
52324,9922294,85.21.0.105,272.0,atm,451,9501,748801252,CREDIT,0,act,2026-01-12,2024-11-03 07:29:24,765.06,payment,586098.6259999999
52325,9918357,46.0.42.120,1494.0,atm,10,4182,402579063,CREDIT,0,act,2030-06-23,2024-11-14 00:38:49,251.7,in,121902.38892857142
52326,9512054,188.0.175.30,1432.0,atm,25,5686,149172592,DEBIT,0,act,2030-01-26,2024-11-20 16:28:58,755.27,country_transfer,291698.3707692308
52327,9416108,193.0.145.45,489.0,atm,-1,5530,646547518,CREDIT,1,active,2027-03-01,2024-10-02 13:19:24,273.59,bad,701667.988
52328,9910073,82.200.0.195,624.0,atm,-1,7081,790362642,DEBIT,1,active,2026-08-18,2024-11-15 17:27:41,679.19,err_code,686073.0296551724
52329,9792408,2.94.0.240,1042.0,atm,20,5404,429080525,CREDIT,0,active,2029-06-04,2024-11-10 09:23:27,456.93,out,778700.9638461539
52330,9941208,188.0.162.75,494.0,atm,451,7498,278959044,DEBIT,0,act,2026-07-02,2024-11-18 16:57:13,1034.98,payment,236175.0496491228
52331,9958692,91.122.0.15,431.0,atm,10,4664,473667839,CREDIT,0,active,2025-02-15,2024-11-17 14:47:42,925.11,in,255426.305
52332,9819668,193.0.145.45,489.0,atm,30,5780,438874167,DEBIT,0,active,2027-09-23,2024-11-09 00:22:57,456.89,transfer,224050.04172413796
52333,9874879,46.0.43.105,1489.0,atm,-1,6889,966289747,CREDIT,1,active,2030-02-07,2024-11-20 15:46:16,178.13,bad,397817.05
52334,9862969,193.0.149.210,1158.0,atm,-1,5780,727589376,CREDIT,1,act,2027-04-03,2024-11-03 08:23:39,748.05,bad,551779.618888889
52335,9900032,193.0.149.210,1158.0,atm,20,4369,358512450,DEBIT,0,active,2027-12-02,2024-11-27 12:13:56,472.95,from_acc,661509.6671428572
52336,9920890,2.94.0.240,1042.0,atm,451,8770,381038574,CREDIT,0,act,2030-06-30,2024-11-06 16:01:13,654.67,payment,683827.5781818181
52337,9832251,46.0.42.120,1494.0,atm,20,3853,233704457,DEBIT,0,act,2030-05-29,2024-11-12 04:31:22,1155.93,from_acc,590056.9610714285
52338,9945737,193.0.149.210,1158.0,atm,451,9016,222063183,DEBIT,0,act,2025-06-10,2024-11-20 20:21:29,898.92,payment,77599.53333333333
52339,9899808,188.0.162.75,494.0,atm,10,2207,353992071,CREDIT,0,act,2025-06-05,2024-09-22 16:33:30,1181.13,in,238027.84379310344
52340,9904152,193.0.149.210,1158.0,atm,20,6405,518291536,CREDIT,0,act,2026-11-22,2024-11-23 09:56:10,242.89,decrease_on_acc,942671.6470370372
52341,9789693,128.0.81.30,1290.0,atm,-1,2907,685094766,DEBIT,1,active,2029-02-03,2024-11-09 12:48:11,206.8,err_code,200850.736
52342,9745483,128.0.80.60,432.0,atm,10,7015,714847198,DEBIT,0,active,2029-07-14,2024-11-21 16:31:49,428.03,in_acc,328095.422
52343,9857496,128.0.81.30,1290.0,atm,-1,4398,222759098,CREDIT,1,act,2030-01-18,2024-11-13 05:52:59,247.9,bad,366177.0227272727
52344,9697987,2.94.0.225,1472.0,atm,-1,5385,664222450,CREDIT,1,active,2025-03-16,2024-11-25 22:19:53,759.19,bad,371388.3454716981
52345,9948314,2.94.0.240,1042.0,atm,451,7316,506756228,CREDIT,0,active,2025-09-14,2024-11-23 11:56:16,1050.01,payment,269772.7377777778
52346,9879406,128.0.80.60,432.0,atm,25,4441,415567499,DEBIT,0,act,2026-02-14,2024-11-27 03:50:44,995.94,diff_cntry,631703.9088461538
52347,9896751,2.94.0.225,1472.0,atm,451,9201,580695204,CREDIT,0,active,2028-12-28,2024-11-26 23:36:35,187.0,payment,638664.6801754386
52348,9691571,128.0.80.60,432.0,atm,451,2427,246195060,DEBIT,0,active,2029-04-23,2024-11-19 10:46:54,714.87,payment,733253.192
52349,9993562,62.76.0.135,617.0,atm,25,7075,921817490,CREDIT,0,active,2024-12-26,2024-11-25 11:06:35,109.89,country_transfer,126483.964
52350,9936420,188.0.162.75,494.0,atm,30,7286,821667067,CREDIT,0,active,2027-02-22,2024-11-20 12:30:06,278.96,transfer,494822.7115384616
52351,9881484,212.17.0.210,1330.0,atm,451,4905,714860804,CREDIT,0,act,2025-05-01,2024-11-19 21:10:16,354.03,payment,293049.64214285713
52352,9885353,212.13.0.75,241.0,atm,30,9164,357467085,CREDIT,0,act,2027-04-24,2024-11-23 12:45:10,820.07,transfer,870653.1973076923
52353,9898244,188.0.175.30,1432.0,atm,10,8686,301802952,CREDIT,0,act,2026-01-15,2024-11-07 19:54:15,778.85,in,390880.1038983051
52354,9681101,46.0.43.105,1489.0,atm,25,8287,389084217,DEBIT,0,active,2029-12-30,2024-11-12 23:09:52,922.82,diff_cntry,732383.0125490197
52355,9911757,2.94.0.240,1042.0,atm,20,1439,399118971,DEBIT,0,active,2027-06-23,2024-11-17 05:18:55,391.91,from_acc,964629.4933962264
52356,9882478,91.122.0.15,431.0,atm,25,9577,551549191,CREDIT,0,active,2027-04-01,2024-11-22 00:47:08,529.94,country_transfer,832035.284074074
52357,9784105,212.17.0.210,1330.0,atm,20,8305,433907826,CREDIT,0,act,2028-07-07,2024-11-12 07:56:08,764.15,decrease_on_acc,274880.7933962264
52358,9831799,31.204.0.225,932.0,atm,-1,1305,636193227,CREDIT,1,act,2030-05-10,2024-11-28 01:53:56,938.61,bad,200385.4498039216
52359,9874241,185.1.0.120,878.0,atm,-1,7589,540169508,DEBIT,2,active,2026-02-17,2024-11-26 20:52:26,814.08,err,227912.4361016949
52360,9757311,212.13.0.75,241.0,atm,10,5650,518011847,DEBIT,0,active,2027-04-09,2024-11-08 15:26:29,268.94,in,407986.28192307695
52361,9924238,188.0.162.75,494.0,atm,25,2029,216648812,DEBIT,0,act,2025-10-03,2024-11-20 05:23:16,221.94,diff_cntry,667202.4892592593
52362,9844397,31.204.0.225,932.0,atm,30,7338,245293792,DEBIT,0,active,2026-10-12,2024-11-27 21:46:09,842.83,transfer,167384.25689655173
52363,9949235,46.0.43.105,1489.0,atm,10,9319,761493620,DEBIT,0,active,2029-08-22,2024-11-23 16:17:09,624.98,add_on_acc,972845.509019608
52364,9904339,31.204.0.225,932.0,atm,30,6683,183806470,DEBIT,0,act,2027-01-18,2024-11-09 08:51:25,918.07,transfer,727820.21
52365,9856262,193.0.149.210,1158.0,atm,10,9395,241086269,CREDIT,0,active,2026-10-15,2024-11-21 23:40:18,819.11,in_acc,826990.8862711865
52366,9270824,188.0.162.75,494.0,atm,20,9673,177533105,CREDIT,0,act,2028-09-04,2024-10-23 09:41:02,1165.05,out,301624.371509434
52367,9973301,212.13.0.75,241.0,atm,10,4646,395948405,DEBIT,0,active,2029-04-13,2024-11-22 03:24:01,368.02,add_on_acc,186807.412962963
52368,9323723,46.0.43.105,1489.0,atm,25,3026,233100711,CREDIT,0,act,2029-10-28,2024-10-11 21:58:50,154.97,country_transfer,939362.884
52369,9935915,82.200.0.195,624.0,atm,30,9795,583469447,CREDIT,0,act,2027-01-30,2024-11-08 02:14:22,255.09,transfer,693198.8196491228
52370,9899806,82.200.0.195,624.0,atm,10,6767,924149802,DEBIT,0,active,2030-05-05,2024-11-25 17:49:39,880.96,in,530592.8337931033
52371,9886255,188.0.175.30,1432.0,atm,-1,1743,400263609,CREDIT,1,act,2028-05-21,2024-11-13 04:47:37,316.22,err,698891.5486206897
52372,9967089,2.94.0.240,1042.0,atm,30,3754,453828531,CREDIT,0,act,2029-12-22,2024-10-24 21:46:24,1059.8,transfer,320557.10909090907
52373,9998492,91.122.0.15,431.0,atm,30,7582,229673964,DEBIT,0,active,2029-04-29,2024-11-27 06:55:07,996.01,transfer,118489.60403508772
52374,9879885,2.94.0.240,1042.0,atm,25,6177,299665877,DEBIT,0,act,2027-04-07,2024-11-13 00:53:19,213.9,diff_cntry,319287.8587719298
52375,9990985,2.94.0.240,1042.0,atm,30,2826,631514992,CREDIT,0,active,2027-05-16,2024-09-10 23:52:14,361.0,transfer,294127.70074074075
52376,9812530,83.222.0.180,407.0,atm,25,8520,974924620,CREDIT,0,act,2030-11-02,2024-11-27 14:27:44,926.86,country_transfer,618006.6664705883
52377,9791731,2.94.0.225,1472.0,atm,-1,9869,783349011,CREDIT,1,active,2027-12-25,2024-11-28 10:45:25,328.21,bad,84246.75210526315
52378,9784128,128.0.80.60,432.0,atm,451,2956,129256009,CREDIT,0,active,2030-10-16,2024-10-07 22:24:08,985.08,payment,324005.72
52379,9837153,85.21.0.105,272.0,atm,10,2420,607625738,DEBIT,0,active,2030-08-10,2024-11-07 18:16:53,820.08,add_on_acc,858438.2467857143
52380,9861593,62.76.0.135,617.0,atm,-1,8861,837100551,CREDIT,2,active,2028-02-22,2024-11-03 00:40:06,169.18,err,469849.1650980392
52381,9876415,178.44.0.90,1293.0,atm,20,7910,971038539,CREDIT,0,act,2028-01-10,2024-11-11 07:49:05,679.07,decrease_on_acc,260656.2935849056
52382,9748835,46.0.43.105,1489.0,atm,25,2522,530354089,CREDIT,0,act,2026-05-26,2024-11-27 09:13:39,890.79,country_transfer,94906.55433962264
52383,9677801,128.0.80.60,432.0,atm,-1,9240,385881305,DEBIT,1,active,2027-11-23,2024-11-16 20:09:14,723.84,err,165815.2807017544
52384,9945255,193.0.145.45,489.0,atm,-1,8927,188529373,CREDIT,1,active,2026-10-30,2024-11-22 23:02:32,392.19,err,828305.986101695
52385,9830593,193.0.149.210,1158.0,atm,-1,7934,255630552,CREDIT,1,active,2025-11-13,2024-11-28 17:29:42,971.12,bad,851183.9609090909
52386,9768968,178.44.0.90,1293.0,atm,30,1722,687312210,DEBIT,0,active,2026-11-17,2024-11-23 15:16:47,595.96,transfer,534503.2017857144
52387,9943608,188.0.162.75,494.0,atm,451,2325,724006352,DEBIT,0,act,2029-12-12,2024-10-21 20:17:36,679.03,payment,512261.4584745763
52388,9951225,178.44.0.90,1293.0,atm,451,8016,317973552,DEBIT,0,active,2025-05-11,2024-11-24 22:38:59,1022.91,payment,327350.5814814815
52389,9863046,83.222.0.180,407.0,atm,30,5195,341462907,CREDIT,0,act,2029-08-17,2024-11-27 13:07:01,957.91,transfer,487865.3389655173
52390,9554408,145.255.0.165,246.0,atm,30,7520,505316441,DEBIT,0,act,2027-03-12,2024-10-21 07:54:08,1075.05,transfer,652308.0733333334
52391,9689431,62.76.0.135,617.0,atm,30,3830,177214697,DEBIT,0,act,2027-09-20,2024-11-19 23:07:21,1038.09,transfer,183256.17454545453
52392,9992026,62.76.0.135,617.0,atm,451,9400,392457070,CREDIT,0,act,2029-05-03,2024-11-17 01:28:02,776.7,payment,855702.2739285714
52393,9985833,193.0.149.210,1158.0,atm,20,2547,654678389,DEBIT,0,act,2028-02-29,2024-10-03 21:20:30,442.88,from_acc,602661.1144444444
52394,9958809,212.17.0.210,1330.0,atm,30,1367,664030201,CREDIT,0,active,2029-09-24,2024-11-10 12:18:32,160.98,transfer,587495.1181481482
52395,9980872,91.122.0.15,431.0,atm,451,6063,128957034,DEBIT,0,act,2025-03-24,2024-11-17 22:33:08,311.87,payment,544776.1803448276
52396,9960883,91.122.0.15,431.0,atm,-1,7542,732430851,DEBIT,1,active,2025-08-15,2024-11-13 22:05:22,364.75,bad,76964.18357142857
52397,9729706,212.13.0.75,241.0,atm,20,5035,623884950,CREDIT,0,active,2027-12-28,2024-10-05 10:39:45,300.92,out,905517.492
52398,9816292,193.0.149.210,1158.0,atm,20,5153,167866073,CREDIT,0,act,2029-12-06,2024-11-27 23:23:24,356.92,from_acc,131437.9505263158
52399,9934697,145.255.0.165,246.0,atm,20,5477,220498387,DEBIT,0,act,2025-01-17,2024-11-27 21:26:50,1020.09,decrease_on_acc,647876.706
52400,9621569,212.17.0.210,1330.0,atm,-1,4646,209967320,CREDIT,1,act,2025-03-04,2024-10-16 08:25:25,131.9,err_code,624296.9038461539
52401,9861543,46.0.42.120,1494.0,atm,25,8857,188380748,DEBIT,0,act,2026-06-14,2024-11-08 00:44:53,383.2,diff_cntry,854915.5959649122
52402,9737423,128.0.81.30,1290.0,atm,451,2898,970635974,CREDIT,0,active,2028-08-02,2024-09-12 00:09:42,700.91,payment,631438.0764285714
52403,9775999,128.0.80.60,432.0,atm,10,1835,527502678,CREDIT,0,active,2030-12-28,2024-11-26 11:59:44,488.93,in_acc,355871.63727272727
52404,9913822,46.0.42.120,1494.0,atm,30,4320,718487679,DEBIT,0,act,2030-11-09,2024-11-04 20:43:29,666.97,transfer,972440.8496551724
52405,9313222,128.0.80.60,432.0,atm,30,8999,553907874,CREDIT,0,active,2029-02-24,2024-11-14 15:22:43,1154.98,transfer,245441.392
52406,9716366,212.17.0.210,1330.0,atm,25,7097,346327652,DEBIT,0,act,2028-08-29,2024-11-17 02:45:24,974.11,country_transfer,762672.6858620689
52407,9913864,2.94.0.225,1472.0,atm,451,5932,679557018,CREDIT,0,active,2027-05-26,2024-11-23 12:15:52,1061.13,payment,851296.3
52408,9931763,212.13.0.75,241.0,atm,25,7975,726581709,DEBIT,0,act,2025-04-03,2024-11-09 17:11:30,492.47,diff_cntry,600587.5736363637
52409,9972544,178.44.0.90,1293.0,atm,451,9028,102589938,DEBIT,0,active,2026-10-02,2024-11-24 10:15:06,417.99,payment,131983.0994736842
52410,9822863,212.17.0.210,1330.0,atm,10,5711,817566561,CREDIT,0,act,2025-08-10,2024-11-18 16:40:48,304.06,in_acc,655723.4836363636
52411,9707402,62.76.0.135,617.0,atm,451,1362,371477862,DEBIT,0,act,2025-12-25,2024-11-28 06:43:33,1146.86,payment,228418.5639285714
52412,9928152,128.0.80.60,432.0,atm,20,6089,111858823,DEBIT,0,act,2028-04-12,2024-11-02 19:21:39,1085.92,from_acc,672372.7473076923
52413,9805752,178.44.0.90,1293.0,atm,-1,7580,584704269,CREDIT,1,active,2028-03-29,2024-11-19 10:59:56,373.19,err_code,361682.2639622642
52414,9665158,46.0.43.105,1489.0,atm,-1,7511,306273803,DEBIT,1,act,2025-02-24,2024-11-09 17:32:51,308.3,err,304680.86333333334
52415,9809336,185.1.0.120,878.0,atm,20,4989,394400803,CREDIT,0,act,2028-02-27,2024-11-27 22:29:14,288.84,decrease_on_acc,397560.9028070176
52416,9557829,128.0.81.30,1290.0,atm,10,5489,728541688,CREDIT,0,act,2029-01-12,2024-10-24 17:33:24,1056.87,in_acc,830393.2011538461
52417,9769854,62.76.0.135,617.0,atm,10,7379,479950290,CREDIT,0,active,2030-06-19,2024-11-20 18:56:44,930.01,add_on_acc,354842.24413793103
52418,9976723,188.0.162.75,494.0,atm,25,7482,841076598,CREDIT,0,active,2027-05-13,2024-08-23 18:42:14,1105.15,diff_cntry,40977.31075471698
52419,9998367,128.0.81.30,1290.0,atm,30,6764,850944455,DEBIT,0,active,2026-08-28,2024-11-09 21:21:48,1122.18,transfer,183726.90877192983
52420,9991041,31.204.0.225,932.0,atm,451,1461,524606111,CREDIT,0,act,2028-02-20,2024-11-24 09:52:11,778.25,payment,731000.57
52421,9952043,185.1.0.120,878.0,atm,-1,6011,404249033,DEBIT,1,act,2028-03-22,2024-10-09 08:07:02,294.94,err,641118.1627272727
52422,9549587,83.222.0.180,407.0,atm,30,2888,574657739,DEBIT,0,active,2025-06-28,2024-11-21 18:22:44,1089.18,transfer,949505.9325
52423,9465083,2.94.0.240,1042.0,atm,20,3594,201963321,CREDIT,0,act,2027-10-14,2024-10-21 03:56:10,1157.12,decrease_on_acc,589847.4082352942
52424,9492744,178.44.0.90,1293.0,atm,10,3163,570739912,CREDIT,0,act,2027-11-10,2024-11-09 09:58:35,483.72,in,641198.5920000001
52425,9963968,188.0.175.30,1432.0,atm,30,1677,202812510,CREDIT,0,act,2026-04-18,2024-11-22 12:36:13,288.77,transfer,879468.6878571429
52426,9941971,85.21.0.105,272.0,atm,10,6996,521934472,CREDIT,0,active,2027-07-05,2024-11-16 15:00:25,1119.93,add_on_acc,534787.2814814815
52427,9826542,62.76.0.135,617.0,atm,10,4559,763187731,CREDIT,0,act,2027-11-13,2024-11-13 16:43:38,366.02,in,861697.8829411764
52428,9989080,46.0.43.105,1489.0,atm,-1,5495,818078390,CREDIT,1,act,2028-11-24,2024-11-26 05:40:03,202.1,bad,664139.9166037736
52429,9903407,212.13.0.75,241.0,atm,451,8609,823468214,DEBIT,0,active,2027-01-31,2024-11-04 13:13:25,212.01,payment,532153.8003389831
52430,9820989,2.94.0.240,1042.0,atm,20,1352,147314088,CREDIT,0,active,2027-04-01,2024-11-23 14:42:20,122.91,from_acc,132505.83821428573
52431,9888949,128.0.80.60,432.0,atm,-1,1563,611596623,CREDIT,1,active,2028-07-25,2024-11-25 01:42:59,712.12,err,718716.0031372549
52432,9920008,145.255.0.165,246.0,atm,20,7795,197038936,CREDIT,0,active,2028-02-19,2024-09-16 10:48:46,1065.94,from_acc,685360.5734482758
52433,9899751,188.0.175.30,1432.0,atm,25,2967,243732473,DEBIT,0,act,2030-12-16,2024-11-07 00:37:11,466.86,country_transfer,403313.9696551724
52434,9947433,46.0.43.105,1489.0,atm,451,6112,366001526,DEBIT,0,active,2028-07-05,2024-11-20 19:47:09,831.52,payment,832647.4778571429
52435,9944322,145.255.0.165,246.0,atm,25,1439,280721386,CREDIT,0,active,2025-12-31,2024-11-20 23:54:36,644.83,country_transfer,784400.0990909091
52436,9836923,178.44.0.90,1293.0,atm,25,1154,903240159,CREDIT,0,act,2030-11-09,2024-10-21 13:36:45,997.83,diff_cntry,954503.0246153846
52437,9901243,188.0.175.30,1432.0,atm,451,7235,674536747,DEBIT,0,act,2028-03-01,2024-11-11 14:25:32,449.14,payment,417378.2236363637
52438,9553373,128.0.80.60,432.0,atm,30,8654,978801717,CREDIT,0,act,2025-08-31,2024-10-15 03:57:59,918.1,transfer,188331.9620689655
52439,9999636,46.0.42.120,1494.0,atm,30,3448,949492860,DEBIT,0,act,2028-10-04,2024-10-19 18:26:07,968.42,transfer,643204.6122807018
52440,9908782,83.222.0.180,407.0,atm,10,7696,674157653,CREDIT,0,act,2029-10-10,2024-11-22 23:54:42,1144.93,in_acc,893772.7527272728
52441,9818268,31.204.0.225,932.0,atm,25,3173,203482113,CREDIT,0,act,2026-05-15,2024-11-27 08:41:09,336.76,country_transfer,756183.3233962265
52442,9798398,62.76.0.135,617.0,atm,451,7949,418757019,DEBIT,0,active,2029-03-31,2024-11-27 17:50:21,645.14,payment,765344.9085714286
52443,9691649,82.200.0.195,624.0,atm,25,2615,517930210,CREDIT,0,active,2030-03-31,2024-11-17 23:52:24,379.96,diff_cntry,312205.5705263158
52444,9508453,193.0.145.45,489.0,atm,30,3064,619523584,DEBIT,0,act,2027-02-07,2024-09-18 17:03:23,1069.16,transfer,788823.2189655172
52445,9991665,188.0.175.30,1432.0,atm,451,5405,730775143,CREDIT,0,active,2030-08-07,2024-11-20 09:49:34,711.81,payment,357239.26
52446,9890641,212.17.0.210,1330.0,atm,451,7384,697084905,CREDIT,0,active,2030-02-02,2024-11-12 20:06:18,982.67,payment,275408.3954545455
52447,9957837,62.76.0.135,617.0,atm,10,8698,138322584,DEBIT,0,act,2026-01-02,2024-10-31 19:01:01,502.81,in,770078.676
52448,9589449,82.200.0.195,624.0,atm,451,1131,329445955,DEBIT,0,act,2030-06-18,2024-10-23 23:46:13,602.97,payment,227700.48379310343
52449,9518469,145.255.0.165,246.0,atm,-1,4006,485841243,CREDIT,1,active,2028-08-20,2024-11-22 04:02:33,539.1,err,609093.8845614035
52450,9966241,193.0.149.210,1158.0,atm,30,7241,281074905,DEBIT,0,active,2030-07-23,2024-11-27 02:05:59,300.03,transfer,431455.45703703706
52451,9320360,193.0.149.210,1158.0,atm,451,6418,377490942,DEBIT,0,act,2029-07-18,2024-11-26 12:20:44,914.9,payment,50569.928
52452,9934130,212.17.0.210,1330.0,atm,-1,4306,640012988,DEBIT,1,active,2027-08-27,2024-11-17 01:59:52,476.09,err,663457.2923529411
52453,9857301,46.0.42.120,1494.0,atm,10,6824,836536926,CREDIT,0,act,2024-12-13,2024-11-10 17:07:30,1150.12,in,462491.0007017544
52454,9726689,212.17.0.210,1330.0,atm,451,2305,590833996,DEBIT,0,active,2028-11-24,2024-11-28 23:43:04,1006.98,payment,106674.45363636364
52455,9663822,85.21.0.105,272.0,atm,20,3213,319177944,CREDIT,0,active,2027-06-25,2024-11-11 02:16:38,899.99,decrease_on_acc,339872.53882352944
52456,9919626,212.17.0.210,1330.0,atm,20,5493,401725586,DEBIT,0,active,2029-09-16,2024-11-23 20:15:57,482.21,decrease_on_acc,551699.466
52457,9993579,188.0.162.75,494.0,atm,30,3392,986635933,CREDIT,0,act,2025-12-31,2024-10-16 00:18:20,1188.12,transfer,205784.1382142857
52458,9629748,91.122.0.15,431.0,atm,25,9075,111722266,CREDIT,0,active,2026-01-16,2024-09-16 03:01:39,708.04,country_transfer,360121.536
52459,9860499,62.76.0.135,617.0,atm,25,5348,864850098,CREDIT,0,act,2029-04-09,2024-11-17 21:23:44,870.98,diff_cntry,788029.6885714285
52460,9677271,185.1.0.120,878.0,atm,30,3309,328916497,CREDIT,0,active,2026-02-17,2024-10-24 12:47:06,151.95,transfer,255552.42857142852
52461,9973169,91.122.0.15,431.0,atm,25,3867,676100474,CREDIT,0,active,2028-12-01,2024-10-13 16:30:19,724.82,country_transfer,336533.29000000004
52462,9807137,83.222.0.180,407.0,atm,10,3377,908893847,DEBIT,0,active,2029-08-27,2024-11-19 10:05:39,584.81,add_on_acc,99936.38263157896
52463,9770726,31.204.0.225,932.0,atm,20,5502,659781448,DEBIT,0,act,2027-09-20,2024-11-04 09:44:09,888.89,decrease_on_acc,277890.03698113206
52464,9197682,145.255.0.165,246.0,atm,30,5970,396964211,CREDIT,0,active,2025-08-10,2024-11-28 01:55:43,425.9,transfer,214982.2612280702
52465,9782385,62.76.0.135,617.0,atm,20,2085,666942287,DEBIT,0,active,2026-10-18,2024-11-15 06:56:51,883.02,decrease_on_acc,163633.09528301886
52466,9960405,46.0.43.105,1489.0,atm,30,6065,436169573,CREDIT,0,active,2029-11-29,2024-11-05 12:39:43,745.15,transfer,939693.683076923
52467,9823492,145.255.0.165,246.0,atm,451,7642,705361847,DEBIT,0,active,2029-04-04,2024-11-21 23:03:22,982.82,payment,620520.8427272727
52468,9792423,31.204.0.225,932.0,atm,451,9849,341975582,CREDIT,0,act,2029-07-29,2024-11-27 02:12:53,1040.77,payment,407535.298
52469,9568721,128.0.81.30,1290.0,atm,30,9261,989786011,DEBIT,0,act,2025-10-16,2024-10-23 08:29:59,341.97,transfer,464761.4756140351
52470,9810720,212.13.0.75,241.0,atm,10,5740,900867232,CREDIT,0,active,2030-03-18,2024-11-16 12:17:27,592.97,in,218436.83923076928
52471,9884083,145.255.0.165,246.0,atm,451,7092,542158484,DEBIT,0,active,2025-07-19,2024-11-15 07:19:05,428.93,payment,819288.3653571429
52472,9907130,2.94.0.225,1472.0,atm,20,6714,833240327,CREDIT,0,active,2030-05-09,2024-11-13 22:11:12,234.85,out,987433.188846154
52473,9935461,193.0.145.45,489.0,atm,25,8579,113952064,CREDIT,0,active,2029-07-07,2024-11-13 16:47:25,1122.82,diff_cntry,382154.8189830509
52474,9967331,82.200.0.195,624.0,atm,25,1684,767968568,CREDIT,0,act,2027-05-21,2024-11-24 07:16:25,909.77,diff_cntry,30367.72037037037
52475,9956832,31.204.0.225,932.0,atm,-1,7486,694568427,CREDIT,1,active,2029-03-31,2024-11-25 07:19:10,751.88,bad,712752.9888461538
52476,9781291,46.0.42.120,1494.0,atm,451,3853,761889942,DEBIT,0,act,2029-03-25,2024-10-20 19:33:36,981.81,payment,39598.206610169495
52477,9499581,46.0.42.120,1494.0,atm,20,8083,248884997,DEBIT,0,act,2026-08-24,2024-11-01 13:21:26,1085.97,from_acc,555165.7637037036
52478,9942436,185.1.0.120,878.0,atm,451,6397,237750619,CREDIT,0,active,2026-11-15,2024-11-26 12:39:48,1037.08,payment,209606.53642857145
52479,9951787,82.200.0.195,624.0,atm,25,3382,404719393,CREDIT,0,active,2026-09-10,2024-11-07 03:03:53,486.9,diff_cntry,382256.9221428572
52480,9949236,188.0.162.75,494.0,atm,451,8591,403539486,CREDIT,0,act,2025-04-19,2024-11-05 05:53:30,234.09,payment,314295.8824528302
52481,9964081,188.0.162.75,494.0,atm,20,4981,235846750,CREDIT,0,active,2026-04-24,2024-11-18 00:38:05,1165.77,decrease_on_acc,395680.4254545455
52482,9970866,83.222.0.180,407.0,atm,451,5511,171444948,DEBIT,0,act,2027-01-30,2024-11-21 15:50:24,224.1,payment,348175.3189655172
52483,9980982,128.0.80.60,432.0,atm,-1,5720,344425794,DEBIT,1,act,2029-07-20,2024-11-04 15:35:50,1034.82,err_code,835894.3063157895
52484,9977690,91.122.0.15,431.0,atm,30,7574,577162787,DEBIT,0,active,2030-09-14,2024-11-27 15:37:49,485.14,transfer,671016.0833962264
52485,9967745,128.0.80.60,432.0,atm,20,1229,186038039,CREDIT,0,act,2028-08-09,2024-11-21 09:33:27,882.2,out,263321.05148148147
52486,9636339,145.255.0.165,246.0,atm,30,4911,970190581,CREDIT,0,active,2026-08-25,2024-11-22 02:18:32,849.12,transfer,209916.89627450975
52487,9974951,2.94.0.225,1472.0,atm,451,1732,156494933,DEBIT,0,act,2025-11-01,2024-11-24 12:52:56,130.18,payment,76658.00924528303
52488,9866857,188.0.175.30,1432.0,atm,30,5594,283776205,DEBIT,0,act,2025-07-01,2024-11-28 01:34:56,424.86,transfer,276902.288
52489,9992753,188.0.162.75,494.0,atm,451,3865,138367808,CREDIT,0,active,2030-11-08,2024-11-01 13:12:08,1117.07,payment,735386.097586207
52490,9957441,31.204.0.225,932.0,atm,451,4271,457130353,CREDIT,0,active,2025-03-12,2024-10-31 12:20:48,570.06,payment,565756.5745454546
52491,9953709,2.94.0.240,1042.0,atm,25,4235,960497101,CREDIT,0,act,2030-10-23,2024-11-24 07:19:16,858.11,diff_cntry,444538.282745098
52492,9941432,128.0.80.60,432.0,atm,30,3506,676546369,DEBIT,0,act,2026-08-28,2024-10-23 11:49:17,308.01,transfer,855735.4496153846
52493,9887845,145.255.0.165,246.0,atm,10,6117,869103866,CREDIT,0,active,2028-02-03,2024-09-19 10:21:05,953.36,add_on_acc,396770.112
52494,9873325,62.76.0.135,617.0,atm,451,8027,967641916,DEBIT,0,active,2027-01-21,2024-11-23 10:59:21,180.62,payment,341137.1775438597
52495,9953570,178.44.0.90,1293.0,atm,-1,1171,256837934,DEBIT,1,active,2027-12-27,2024-11-11 16:19:54,1184.03,err,899472.2737931035
52496,9811664,85.21.0.105,272.0,atm,451,7064,932558963,CREDIT,0,active,2030-03-07,2024-11-19 02:19:22,824.92,payment,706078.9777358491
52497,9710903,46.0.42.120,1494.0,atm,451,8404,327350261,DEBIT,0,act,2025-02-15,2024-11-19 13:33:30,1137.33,payment,687364.8510714285
52498,9938972,82.200.0.195,624.0,atm,30,4809,821753751,DEBIT,0,act,2027-11-08,2024-11-08 05:56:56,107.02,transfer,749280.5872727273
52499,9965874,82.200.0.195,624.0,atm,30,7907,356278256,CREDIT,0,act,2026-05-31,2024-10-12 12:54:22,1086.82,transfer,546484.5311111112
52500,9635701,145.255.0.165,246.0,atm,451,2651,989476871,CREDIT,0,active,2030-09-08,2024-09-21 20:00:06,1126.16,payment,937143.2131372548
52501,9973111,82.200.0.195,624.0,atm,10,3815,466594225,CREDIT,0,active,2030-06-28,2024-11-24 04:17:35,184.3,in,559298.3513793104
52502,9579870,91.122.0.15,431.0,atm,20,3655,171969202,CREDIT,0,active,2027-01-10,2024-11-28 05:42:42,693.02,decrease_on_acc,900018.052
52503,9631924,82.200.0.195,624.0,atm,-1,8624,566813666,CREDIT,1,active,2028-05-23,2024-11-03 13:20:09,746.1,err_code,706281.7607017544
52504,9783954,82.200.0.195,624.0,atm,25,4731,684239232,DEBIT,0,active,2028-05-22,2024-11-20 11:01:19,1094.15,diff_cntry,490998.1842105263
52505,9935452,83.222.0.180,407.0,atm,25,4798,776377571,DEBIT,0,act,2028-05-03,2024-11-25 16:02:31,501.06,diff_cntry,237294.482
52506,9901631,2.94.0.240,1042.0,atm,30,1160,106476302,DEBIT,0,act,2026-12-18,2024-11-25 23:59:15,930.82,transfer,369963.7792592593
52507,9915564,83.222.0.180,407.0,atm,451,4953,412877762,CREDIT,0,active,2027-05-26,2024-10-23 12:45:12,810.12,payment,202005.92943396227
52508,9923348,2.94.0.225,1472.0,atm,30,6124,402009816,DEBIT,0,act,2028-12-21,2024-11-22 12:48:12,632.17,transfer,109844.29254901962
52509,9632591,91.122.0.15,431.0,atm,25,8544,755433519,CREDIT,0,act,2028-01-21,2024-10-27 13:28:54,607.92,country_transfer,787229.9171186441
52510,9899410,85.21.0.105,272.0,atm,30,2370,710989031,CREDIT,0,act,2029-06-15,2024-11-08 09:58:32,429.13,transfer,378797.5218181818
52511,9389887,31.204.0.225,932.0,atm,10,8975,431046314,CREDIT,0,active,2029-10-09,2024-11-17 07:38:32,287.08,in,268114.37551724137
52512,9982546,193.0.145.45,489.0,atm,10,6107,531019743,DEBIT,0,act,2029-09-03,2024-11-24 20:06:12,309.98,in,119951.76884615383
52513,9982818,212.13.0.75,241.0,atm,451,4185,420262424,DEBIT,0,active,2030-05-03,2024-11-17 00:10:37,954.03,payment,697422.2182456141
52514,9904245,145.255.0.165,246.0,atm,451,9539,179210465,CREDIT,0,act,2029-05-12,2024-10-10 10:49:34,620.86,payment,230289.2709090909
52515,9978429,185.1.0.120,878.0,atm,451,8693,741885619,DEBIT,0,active,2030-06-25,2024-10-27 09:42:39,1042.09,payment,696764.4386206897
52516,9832942,2.94.0.240,1042.0,atm,25,2276,340716316,CREDIT,0,active,2025-09-04,2024-11-20 20:57:27,1128.07,country_transfer,621978.255
52517,9973152,145.255.0.165,246.0,atm,30,7835,770678867,DEBIT,0,act,2029-01-01,2024-10-31 22:07:15,975.08,transfer,801869.8996428571
52518,9333856,193.0.149.210,1158.0,atm,20,8923,599163838,DEBIT,0,active,2030-02-23,2024-11-17 20:22:21,1064.83,from_acc,399125.5193103448
52519,9888142,128.0.81.30,1290.0,atm,10,2285,377896811,CREDIT,0,act,2026-02-15,2024-11-12 15:08:15,761.11,in_acc,470750.8971698113
52520,9990592,128.0.80.60,432.0,atm,-1,8221,918362177,CREDIT,1,active,2030-03-20,2024-11-23 01:50:17,501.18,err,389935.7343137255
52521,9739679,2.94.0.240,1042.0,atm,10,3570,749599882,DEBIT,0,active,2028-11-17,2024-10-08 14:31:52,658.96,in_acc,53672.4126923077
52522,9945421,188.0.162.75,494.0,atm,25,2165,565761454,CREDIT,0,act,2030-02-06,2024-11-15 10:33:10,164.06,country_transfer,130860.98736842106
52523,9593757,83.222.0.180,407.0,atm,-1,7719,692935008,CREDIT,1,active,2029-07-15,2024-10-14 19:37:51,681.98,bad,290211.00600000005
52524,9437192,212.17.0.210,1330.0,atm,20,6545,112657514,CREDIT,0,active,2027-05-02,2024-10-03 12:23:12,661.83,out,452888.8013559322
52525,9911203,212.13.0.75,241.0,atm,10,8541,924583506,DEBIT,0,act,2025-03-08,2024-11-16 20:39:07,282.11,in,65920.00272727272
52526,9884466,46.0.43.105,1489.0,atm,451,8792,272447412,DEBIT,0,active,2029-06-22,2024-11-23 16:12:51,1011.84,payment,265909.0510344828
52527,9978960,185.1.0.120,878.0,atm,30,7322,968766396,DEBIT,0,active,2028-03-08,2024-11-20 14:46:22,771.05,transfer,469484.61773584905
52528,9999450,46.0.43.105,1489.0,atm,451,1528,889367375,DEBIT,0,act,2028-08-05,2024-10-05 22:16:46,141.83,payment,917780.4154237288
52529,9797806,128.0.81.30,1290.0,atm,25,6172,958252617,CREDIT,0,active,2028-07-10,2024-10-25 05:13:26,1043.1,diff_cntry,121394.63392857142
52530,9960117,128.0.80.60,432.0,atm,25,6731,324080282,CREDIT,0,active,2030-08-07,2024-11-14 11:11:37,587.0,country_transfer,175783.53545454543
52531,9996826,178.44.0.90,1293.0,atm,10,3695,773274125,CREDIT,0,active,2030-04-04,2024-11-13 11:56:14,688.0,in,353346.7054545455
52532,9952019,46.0.43.105,1489.0,atm,-1,5440,347544546,DEBIT,1,active,2028-03-17,2024-11-16 00:30:39,1126.2,bad,259404.9580769231
52533,9982084,46.0.42.120,1494.0,atm,451,8864,593799844,DEBIT,0,act,2026-04-16,2024-10-08 09:58:47,847.1,payment,757185.31
52534,9849986,212.17.0.210,1330.0,atm,30,5418,247321389,DEBIT,0,act,2030-05-04,2024-08-18 03:33:21,845.01,transfer,803316.0252631579
52535,9982457,185.1.0.120,878.0,atm,10,9538,177611200,DEBIT,0,act,2028-04-04,2024-11-15 20:59:46,887.06,in_acc,285067.54142857145
52536,9895014,85.21.0.105,272.0,atm,10,1934,147285147,CREDIT,0,act,2026-04-15,2024-11-22 02:29:08,872.9,in_acc,460895.968
52537,9871041,62.76.0.135,617.0,atm,451,9096,531163525,DEBIT,0,active,2028-02-26,2024-11-06 23:53:00,670.77,payment,849494.0641379311
52538,9868042,188.0.175.30,1432.0,atm,-1,1083,829433057,CREDIT,1,active,2030-07-24,2024-11-23 06:28:32,1146.72,err,856926.433559322
52539,9943034,85.21.0.105,272.0,atm,451,2175,242499731,DEBIT,0,act,2027-07-19,2024-11-23 05:45:38,218.08,payment,359131.7607142857
52540,9950421,188.0.175.30,1432.0,atm,20,2005,341794334,DEBIT,0,active,2025-03-05,2024-10-25 20:24:40,608.33,out,289498.644
52541,9632298,82.200.0.195,624.0,atm,-1,2495,987098139,CREDIT,1,act,2025-02-10,2024-11-13 10:18:11,1165.79,bad,861763.0746428572
52542,9992352,212.13.0.75,241.0,atm,30,2672,651619074,CREDIT,0,act,2027-05-11,2024-10-29 20:22:16,750.0,transfer,310905.7048148148
52543,9999630,212.13.0.75,241.0,atm,10,3994,842361684,DEBIT,0,active,2027-04-09,2024-11-25 07:57:37,480.74,in_acc,945094.6216981132
52544,9972606,91.122.0.15,431.0,atm,25,9394,384782220,CREDIT,0,act,2029-01-27,2024-11-04 16:42:53,590.82,diff_cntry,608771.9237931035
52545,9588077,193.0.145.45,489.0,atm,-1,8806,581929313,DEBIT,1,act,2027-01-29,2024-11-12 20:06:04,899.91,err,509429.49346153846
52546,9082499,188.0.175.30,1432.0,atm,25,6988,975153253,DEBIT,0,act,2029-02-16,2024-11-16 09:32:46,231.87,country_transfer,669913.8323529412
52547,9980256,188.0.162.75,494.0,atm,451,5983,595753034,DEBIT,0,active,2030-04-19,2024-11-26 00:21:31,875.19,payment,385999.4647169812
52548,9987291,2.94.0.240,1042.0,atm,10,3288,992042996,DEBIT,0,active,2028-05-08,2024-11-26 17:15:37,764.12,in_acc,929148.0950980393
52549,9920181,185.1.0.120,878.0,atm,451,2688,483027660,CREDIT,0,act,2026-12-01,2024-10-25 19:00:25,1106.06,payment,753453.6305084745
52550,9962403,188.0.175.30,1432.0,atm,20,1145,456450627,DEBIT,0,act,2030-03-18,2024-11-04 02:58:19,607.91,decrease_on_acc,679521.498245614
52551,9999809,145.255.0.165,246.0,atm,20,5270,568684881,CREDIT,0,act,2025-06-07,2024-10-12 19:17:32,603.08,decrease_on_acc,790408.942
52552,9957593,185.1.0.120,878.0,atm,451,7435,596081835,CREDIT,0,active,2028-07-04,2024-10-21 05:31:10,569.02,payment,86543.34862745098
52553,9680627,85.21.0.105,272.0,atm,10,1628,123611684,DEBIT,0,act,2029-08-29,2024-11-22 20:47:12,1145.18,in,658545.1028301887
52554,9949872,2.94.0.225,1472.0,atm,25,2570,556760800,DEBIT,0,active,2027-03-16,2024-11-03 07:18:57,956.08,diff_cntry,46470.63035714286
52555,9976268,128.0.81.30,1290.0,atm,-1,5315,931754355,DEBIT,1,act,2030-09-06,2024-11-22 14:32:20,482.12,err_code,913825.6449019609
52556,9810712,2.94.0.225,1472.0,atm,451,6038,964243678,CREDIT,0,act,2029-04-24,2024-11-04 05:49:14,852.13,payment,823149.5481132076
52557,9987107,91.122.0.15,431.0,atm,10,4886,976393135,CREDIT,0,active,2025-11-05,2024-11-23 22:03:47,355.15,add_on_acc,103029.75538461538
52558,9759341,188.0.175.30,1432.0,atm,451,8470,508124574,DEBIT,0,active,2026-05-08,2024-11-28 16:09:52,534.94,payment,160634.4809090909
52559,9871920,91.122.0.15,431.0,atm,30,7383,637434812,CREDIT,0,act,2027-09-10,2024-10-21 10:17:14,1051.13,transfer,826988.4328571429
52560,9999708,2.94.0.225,1472.0,atm,451,1090,247822289,DEBIT,0,active,2028-03-12,2024-11-19 04:50:29,762.88,payment,273584.9045283019
52561,9721123,212.17.0.210,1330.0,atm,30,1920,230910910,DEBIT,0,act,2029-12-26,2024-11-16 05:39:05,270.25,transfer,855360.4207142857
52562,9836391,212.17.0.210,1330.0,atm,25,5563,578900606,DEBIT,0,act,2026-07-03,2024-10-30 01:48:56,994.81,country_transfer,737042.1572727272
52563,9904842,188.0.162.75,494.0,atm,30,1173,923039857,CREDIT,0,act,2029-02-25,2024-11-21 11:41:22,1067.99,transfer,761200.5863636363
52564,9913709,31.204.0.225,932.0,atm,20,8396,550404976,DEBIT,0,active,2029-10-04,2024-11-25 04:18:09,623.12,from_acc,595391.8496428572
52565,9905614,46.0.43.105,1489.0,atm,25,1097,679813296,DEBIT,0,act,2029-03-26,2024-11-20 08:54:41,1181.2,diff_cntry,921590.4631372548
52566,9163111,31.204.0.225,932.0,atm,451,7483,713494989,DEBIT,0,active,2030-11-08,2024-11-16 12:29:50,591.85,payment,668145.5715094339
52567,9983433,193.0.145.45,489.0,atm,25,7569,175836677,DEBIT,0,active,2030-11-14,2024-11-14 17:44:23,941.81,diff_cntry,329160.8553571428
52568,9983532,188.0.175.30,1432.0,atm,25,1756,853518193,CREDIT,0,active,2026-12-06,2024-09-20 03:57:40,142.98,diff_cntry,900337.7411764706
52569,9921531,212.13.0.75,241.0,atm,10,5589,567438568,CREDIT,0,act,2029-05-14,2024-11-20 17:07:49,785.16,in_acc,162512.23545454547
52570,9992019,46.0.43.105,1489.0,atm,-1,4200,291071571,DEBIT,1,active,2027-12-30,2024-11-18 07:27:51,1133.92,err,51007.26018867925
52571,9969144,2.94.0.240,1042.0,atm,451,3884,360934287,DEBIT,0,act,2025-04-03,2024-09-20 11:46:50,940.05,payment,509654.62603773584
52572,9946982,188.0.175.30,1432.0,atm,30,5754,776435697,CREDIT,0,active,2026-10-06,2024-11-13 21:43:01,1078.89,transfer,345572.19981132075
52573,9941598,82.200.0.195,624.0,atm,-1,8468,193658755,CREDIT,1,active,2028-01-18,2024-11-19 08:06:08,357.24,err_code,879898.2194915253
52574,9918338,212.17.0.210,1330.0,atm,20,7643,679234207,CREDIT,0,active,2028-01-03,2024-09-20 21:14:39,1156.93,from_acc,37681.09320754717
52575,9793060,128.0.81.30,1290.0,atm,20,9477,626057645,CREDIT,0,act,2027-09-17,2024-10-30 21:37:12,1033.05,from_acc,377498.4736363636
52576,9648958,46.0.42.120,1494.0,atm,25,4202,966746926,CREDIT,0,active,2026-04-30,2024-11-28 07:27:59,649.98,diff_cntry,304444.76509803924
52577,9690070,91.122.0.15,431.0,atm,-1,8474,400484308,DEBIT,2,active,2029-09-03,2024-11-26 01:07:29,1116.06,bad,688099.3296610169
52578,9970485,128.0.81.30,1290.0,atm,20,8280,748587402,DEBIT,0,active,2025-01-13,2024-11-24 15:04:44,268.87,from_acc,322788.0860714285
52579,9260117,212.17.0.210,1330.0,atm,10,2530,173275626,CREDIT,0,act,2028-06-04,2024-11-10 18:39:37,211.96,in,743542.2418867925
52580,9829008,2.94.0.225,1472.0,atm,-1,3129,365145700,DEBIT,1,act,2028-09-17,2024-11-06 05:52:35,413.28,err_code,98780.44111111113
52581,9957397,62.76.0.135,617.0,atm,20,5481,159878092,CREDIT,0,active,2028-10-03,2024-10-25 15:40:38,1163.13,out,504710.4381818182
52582,9528051,85.21.0.105,272.0,atm,451,9196,506341585,CREDIT,0,active,2025-11-27,2024-10-23 21:24:42,300.93,payment,316592.12384615385
52583,9969832,145.255.0.165,246.0,atm,25,5219,583657772,DEBIT,0,act,2029-12-04,2024-11-17 04:00:35,464.94,country_transfer,495945.2474074074
52584,9854146,91.122.0.15,431.0,atm,20,8031,245466948,DEBIT,0,act,2029-05-20,2024-11-27 13:06:38,355.96,from_acc,409743.2889655173
52585,9843601,128.0.81.30,1290.0,atm,10,5939,518655870,DEBIT,0,active,2027-10-29,2024-11-23 23:44:59,743.18,in_acc,418175.4218181818
52586,9970599,145.255.0.165,246.0,atm,451,2521,727185884,DEBIT,0,active,2025-04-25,2024-11-19 23:10:14,680.18,payment,919277.7916981132
52587,9783987,83.222.0.180,407.0,atm,10,9713,202802628,CREDIT,0,active,2030-06-10,2024-11-23 12:24:14,283.81,in_acc,471865.1551724138
52588,9996887,212.13.0.75,241.0,atm,451,8258,313395413,CREDIT,0,act,2028-08-11,2024-10-18 10:46:36,905.38,payment,208713.6768965517
52589,9890257,46.0.42.120,1494.0,atm,-1,6654,889412206,DEBIT,1,active,2026-03-05,2024-11-06 13:48:51,300.84,bad,580462.4009803921
52590,9778132,178.44.0.90,1293.0,atm,451,6459,426753339,CREDIT,0,active,2028-09-08,2024-11-17 05:39:34,606.99,payment,468248.0055932203
52591,9999698,128.0.81.30,1290.0,atm,451,1407,199529444,CREDIT,0,act,2025-02-10,2024-11-10 11:17:44,323.96,payment,953603.8965384616
52592,9885123,212.17.0.210,1330.0,atm,30,7167,734726720,CREDIT,0,active,2026-09-24,2024-11-28 09:49:29,710.1,transfer,853904.4916981132
52593,9664123,128.0.80.60,432.0,atm,25,3955,266837317,CREDIT,0,active,2026-06-20,2024-10-24 12:40:54,1152.18,country_transfer,152666.36411764706
52594,9985071,91.122.0.15,431.0,atm,20,4247,343352047,DEBIT,0,act,2025-10-18,2024-10-13 14:52:05,977.98,decrease_on_acc,53738.57735849057
52595,9705581,91.122.0.15,431.0,atm,10,5076,287387513,DEBIT,0,act,2028-08-18,2024-11-07 11:52:15,549.02,add_on_acc,568772.1129411765
52596,9984771,46.0.42.120,1494.0,atm,25,8095,559074906,DEBIT,0,active,2027-06-26,2024-11-28 21:44:43,1084.01,country_transfer,924764.4051851853
52597,9958725,2.94.0.225,1472.0,atm,-1,4983,919161352,DEBIT,1,active,2026-06-01,2024-11-26 09:57:45,275.19,bad,238045.25142857144
52598,9816345,91.122.0.15,431.0,atm,451,8526,457913045,CREDIT,0,act,2025-03-07,2024-10-29 20:50:41,806.14,payment,327384.0703846154
52599,9921767,2.94.0.240,1042.0,atm,30,8834,257075370,CREDIT,0,act,2028-12-11,2024-11-16 08:58:08,105.98,transfer,858386.431724138
52600,9915279,128.0.81.30,1290.0,atm,25,9056,505495095,DEBIT,0,act,2030-07-26,2024-10-21 11:07:42,892.3,diff_cntry,937767.2014285714
52601,9805783,178.44.0.90,1293.0,atm,451,7160,959013235,DEBIT,0,active,2028-12-28,2024-11-28 11:32:48,1159.93,payment,143726.06280701753
52602,9953576,62.76.0.135,617.0,atm,10,6798,564897163,DEBIT,0,active,2030-05-07,2024-11-20 13:04:59,1164.2,in_acc,396463.4268421052
52603,9969130,212.17.0.210,1330.0,atm,451,7965,324841078,CREDIT,0,act,2030-01-29,2024-11-20 07:12:14,394.09,payment,845793.6288888889
52604,9861614,128.0.81.30,1290.0,atm,451,9022,397640070,CREDIT,0,act,2029-12-12,2024-11-07 21:28:35,816.91,payment,676774.130909091
52605,9988415,188.0.175.30,1432.0,atm,10,6267,227934684,DEBIT,0,active,2028-06-12,2024-10-31 15:08:00,802.06,in,326322.13901960786
52606,9791783,82.200.0.195,624.0,atm,30,2091,295598601,DEBIT,0,act,2027-09-16,2024-11-23 10:06:08,1178.98,transfer,827192.7861403509
52607,9673318,128.0.80.60,432.0,atm,451,9287,365018790,CREDIT,0,active,2030-12-09,2024-11-22 02:16:09,507.07,payment,508417.3846153846
52608,9888721,31.204.0.225,932.0,atm,10,4096,675319524,CREDIT,0,act,2028-09-08,2024-11-15 12:17:09,220.24,in_acc,968209.6558490566
52609,9942498,31.204.0.225,932.0,atm,20,8035,363376202,DEBIT,0,active,2027-07-17,2024-11-15 18:48:20,241.98,out,474377.95019607845
52610,9694771,2.94.0.240,1042.0,atm,451,4233,489160099,CREDIT,0,active,2026-11-07,2024-10-14 14:44:44,1097.82,payment,509729.2374074074
52611,9670041,193.0.145.45,489.0,atm,30,4825,477564302,DEBIT,0,active,2025-06-11,2024-11-19 10:24:08,739.99,transfer,768240.6972881355
52612,9915637,193.0.145.45,489.0,atm,451,5077,891226415,DEBIT,0,active,2029-05-25,2024-11-08 12:41:32,778.01,payment,439669.5159649123
52613,9772712,82.200.0.195,624.0,atm,25,3115,441191378,CREDIT,0,act,2029-11-08,2024-10-10 09:54:43,208.88,diff_cntry,435148.6859649123
52614,9934362,46.0.42.120,1494.0,atm,10,3161,921374419,DEBIT,0,act,2029-12-03,2024-11-20 11:40:51,138.02,add_on_acc,434362.04
52615,9807921,185.1.0.120,878.0,atm,25,1211,295185826,CREDIT,0,act,2027-07-16,2024-11-28 23:59:06,954.8,diff_cntry,813741.7907407407
52616,9867180,2.94.0.225,1472.0,atm,451,4149,188078162,DEBIT,0,act,2029-06-30,2024-11-23 05:30:00,204.83,payment,474747.92
52617,9950647,91.122.0.15,431.0,atm,20,1802,830172112,CREDIT,0,active,2029-09-26,2024-10-30 14:24:53,613.23,from_acc,949543.4288888888
52618,9975455,46.0.43.105,1489.0,atm,10,4935,615571717,CREDIT,0,active,2028-12-09,2024-11-20 09:24:54,600.09,add_on_acc,881879.228275862
52619,9947999,31.204.0.225,932.0,atm,451,9704,882201495,CREDIT,0,act,2026-06-28,2024-11-18 10:17:42,646.98,payment,541570.15
52620,9964455,83.222.0.180,407.0,atm,451,8611,711156544,CREDIT,0,act,2028-09-07,2024-11-05 06:30:51,539.98,payment,708498.9980392157
52621,9943832,188.0.175.30,1432.0,atm,25,8549,413349313,CREDIT,0,active,2025-12-10,2024-11-16 02:45:57,1054.14,diff_cntry,40399.13561403508
52622,9879785,62.76.0.135,617.0,atm,30,5564,738565035,CREDIT,0,active,2027-10-26,2024-11-11 01:47:08,279.95,transfer,131989.8051724138
52623,9443677,31.204.0.225,932.0,atm,-1,2860,829987627,DEBIT,1,act,2028-05-12,2024-11-26 19:46:37,548.15,bad,169955.77454545454
52624,9928498,46.0.43.105,1489.0,atm,25,6567,717565716,DEBIT,0,act,2026-09-27,2024-10-06 20:49:13,1072.17,diff_cntry,471446.1015384615
52625,9880128,212.13.0.75,241.0,atm,10,5154,970026543,CREDIT,0,act,2028-12-12,2024-11-19 19:26:02,715.03,add_on_acc,676061.6444827586
52626,9876448,193.0.145.45,489.0,atm,451,2859,497681935,CREDIT,0,active,2028-09-10,2024-11-24 12:53:16,138.93,payment,800287.7871698113
52627,9903371,83.222.0.180,407.0,atm,20,4377,260369955,DEBIT,0,active,2027-06-11,2024-11-20 12:42:20,209.96,from_acc,515713.0349019608
52628,9855247,128.0.81.30,1290.0,atm,10,7042,708399354,CREDIT,0,act,2029-08-14,2024-11-11 00:40:56,551.1,in_acc,372728.0264285714
52629,9746512,46.0.42.120,1494.0,atm,-1,3229,530567562,DEBIT,1,active,2029-02-27,2024-10-31 00:14:50,479.75,bad,381789.3989473684
52630,9956860,185.1.0.120,878.0,atm,20,9174,683729410,DEBIT,0,act,2026-10-12,2024-11-28 09:12:08,973.92,out,694427.04
52631,9896465,2.94.0.240,1042.0,atm,-1,4322,282627895,DEBIT,1,active,2027-02-08,2024-11-04 20:19:16,534.02,err_code,251051.88322033896
52632,9831434,62.76.0.135,617.0,atm,10,3064,646562552,DEBIT,0,active,2029-06-26,2024-11-23 08:10:00,586.8,in,953977.3188135592
52633,9639043,46.0.42.120,1494.0,atm,-1,8751,616728081,DEBIT,2,active,2027-11-02,2024-11-06 04:36:59,850.86,err,81584.04764705882
52634,9935391,212.13.0.75,241.0,atm,30,6332,466665529,DEBIT,0,active,2027-08-28,2024-11-15 09:16:06,822.96,transfer,631913.7847368421
52635,9895669,2.94.0.240,1042.0,atm,30,6126,673985502,CREDIT,0,active,2026-11-20,2024-11-12 06:22:30,1188.83,transfer,72403.24357142857
52636,9946305,212.13.0.75,241.0,atm,10,9978,866915784,CREDIT,0,active,2028-07-16,2024-11-04 10:49:08,886.99,in_acc,242938.698
52637,9918242,46.0.42.120,1494.0,atm,25,3759,514952760,CREDIT,0,active,2028-01-14,2024-11-19 21:00:38,552.95,country_transfer,561335.0337254902
52638,9475579,193.0.145.45,489.0,atm,10,6418,837005116,DEBIT,0,active,2029-12-29,2024-11-17 19:28:20,861.04,add_on_acc,397655.9165517241
52639,9909782,193.0.145.45,489.0,atm,30,6811,309219333,DEBIT,0,act,2027-01-16,2024-11-25 01:54:45,508.13,transfer,179254.50464285715
52640,9888135,128.0.80.60,432.0,atm,30,8490,432545246,DEBIT,0,active,2028-07-15,2024-11-21 06:00:34,246.27,transfer,623358.1462264151
52641,9991257,193.0.145.45,489.0,atm,20,9891,248999712,DEBIT,0,active,2028-08-25,2024-11-16 06:37:08,357.76,decrease_on_acc,578484.6925925926
52642,9922618,85.21.0.105,272.0,atm,451,5232,427421458,DEBIT,0,act,2027-06-20,2024-10-03 01:47:17,1151.07,payment,74376.10846153846
52643,9906247,2.94.0.240,1042.0,atm,451,1124,730138880,DEBIT,0,active,2028-05-25,2024-11-15 16:14:27,581.98,payment,336337.72363636363
52644,9813622,85.21.0.105,272.0,atm,25,4867,340704103,CREDIT,0,active,2025-06-18,2024-11-26 03:10:03,1148.99,diff_cntry,802444.6013559322
52645,9861340,128.0.80.60,432.0,atm,20,9710,696404722,DEBIT,0,active,2025-01-07,2024-08-22 01:21:48,142.37,out,558117.1084313726
52646,9812926,2.94.0.225,1472.0,atm,25,1101,268836182,DEBIT,0,active,2025-07-14,2024-11-19 12:37:17,302.03,country_transfer,481521.3972727273
52647,9300745,188.0.162.75,494.0,atm,25,6300,621775423,DEBIT,0,act,2025-11-02,2024-10-11 07:40:04,400.95,country_transfer,686961.3196296296
52648,9604796,193.0.149.210,1158.0,atm,-1,5279,771218220,CREDIT,1,active,2028-10-19,2024-09-25 08:07:59,546.04,err_code,770339.5421568628
52649,9903090,83.222.0.180,407.0,atm,451,7173,362831868,DEBIT,0,act,2025-06-21,2024-11-01 09:43:10,184.18,payment,757283.5405263158
52650,9940678,188.0.162.75,494.0,atm,451,3819,327909007,DEBIT,0,active,2026-04-27,2024-11-07 22:45:13,614.94,payment,293412.90827586205
52651,9890590,83.222.0.180,407.0,atm,30,1845,148326112,CREDIT,0,act,2028-10-12,2024-11-14 23:56:20,521.9,transfer,257387.81867924528
52652,9945240,193.0.149.210,1158.0,atm,30,4932,870737401,DEBIT,0,act,2029-07-30,2024-11-06 05:54:00,482.13,transfer,862227.9933333334
52653,9817050,62.76.0.135,617.0,atm,30,9655,621252145,CREDIT,0,active,2029-09-16,2024-10-28 04:19:49,476.06,transfer,825874.3185185185
52654,9726123,85.21.0.105,272.0,atm,-1,3723,201691274,CREDIT,2,active,2025-06-15,2024-11-28 06:14:18,1035.98,bad,465662.328
52655,9602116,145.255.0.165,246.0,atm,-1,7249,901354850,DEBIT,1,active,2028-12-28,2024-11-13 01:31:34,257.87,err,941400.0351851851
52656,9864829,193.0.145.45,489.0,atm,451,3762,680564094,DEBIT,0,act,2028-05-12,2024-11-18 11:43:02,855.07,payment,192935.64857142855
52657,9998807,193.0.149.210,1158.0,atm,20,7846,405490269,DEBIT,0,act,2028-08-09,2024-11-19 21:48:23,977.0,from_acc,186106.5771428572
52658,9853032,128.0.81.30,1290.0,atm,451,9857,424717250,DEBIT,0,active,2029-03-27,2024-11-26 12:11:54,891.95,payment,123002.77172413791
52659,9976315,85.21.0.105,272.0,atm,451,8702,488949538,DEBIT,0,active,2027-01-06,2024-11-22 09:00:42,1124.84,payment,751936.2518518518
52660,9817481,188.0.175.30,1432.0,atm,451,3563,550056777,DEBIT,0,active,2025-06-22,2024-11-08 03:03:28,209.84,payment,222514.2993103448
52661,9977204,193.0.145.45,489.0,atm,30,4100,402911113,CREDIT,0,act,2029-08-20,2024-11-28 06:23:15,290.87,transfer,214604.1572413793
52662,9946790,178.44.0.90,1293.0,atm,20,6044,123100439,DEBIT,0,act,2030-09-07,2024-11-10 19:41:23,342.8,decrease_on_acc,838673.2519230769
52663,9941585,91.122.0.15,431.0,atm,451,2327,856444864,CREDIT,0,active,2027-04-04,2024-11-20 16:49:20,360.27,payment,233054.99508474572
52664,9739847,31.204.0.225,932.0,atm,-1,3710,383363365,DEBIT,1,act,2027-03-19,2024-11-06 02:49:33,964.79,err_code,348370.50357142853
52665,9918912,91.122.0.15,431.0,atm,20,7142,431847786,DEBIT,0,act,2030-01-21,2024-11-13 16:22:30,1127.91,out,773730.47
52666,9996887,46.0.42.120,1494.0,atm,-1,1965,861605364,DEBIT,1,active,2029-05-26,2024-11-11 11:45:17,1082.86,err_code,497144.1391525424
52667,9813670,145.255.0.165,246.0,atm,10,1321,670732003,DEBIT,0,act,2029-09-24,2024-11-20 23:54:28,570.32,add_on_acc,521894.60399999993
52668,9994868,188.0.162.75,494.0,atm,20,6438,764369448,CREDIT,0,act,2026-02-06,2024-09-11 10:51:20,1112.82,decrease_on_acc,402650.4746153846
52669,9983516,62.76.0.135,617.0,atm,25,4439,594578657,DEBIT,0,act,2030-03-05,2024-11-16 23:43:38,417.75,country_transfer,350241.7788888889
52670,9820707,85.21.0.105,272.0,atm,451,8176,410869150,DEBIT,0,active,2027-07-22,2024-11-11 23:47:11,206.81,payment,533732.6124137931
52671,9425533,82.200.0.195,624.0,atm,-1,8572,279387932,DEBIT,1,active,2029-04-27,2024-11-11 11:08:12,683.05,err,243334.5543137255
52672,9727422,2.94.0.240,1042.0,atm,10,8788,973142228,CREDIT,0,act,2028-10-02,2024-11-11 07:21:51,465.95,in_acc,240467.454
52673,9950810,128.0.80.60,432.0,atm,30,8350,963925436,CREDIT,0,act,2030-08-22,2024-11-16 15:35:15,401.19,transfer,864823.9062962963
52674,9948325,82.200.0.195,624.0,atm,30,3775,622626117,DEBIT,0,act,2025-09-15,2024-11-27 05:23:58,237.06,transfer,850023.7694736841
52675,9080506,128.0.81.30,1290.0,atm,-1,4666,447240663,CREDIT,2,active,2030-02-13,2024-10-02 10:25:15,560.1,err,862174.301923077
52676,9931935,128.0.80.60,432.0,atm,451,2978,305426918,CREDIT,0,active,2026-06-13,2024-11-16 10:34:13,420.89,payment,912220.1024561404
52677,9883331,212.13.0.75,241.0,atm,451,2329,119625355,CREDIT,0,active,2028-05-29,2024-11-25 00:09:20,185.18,payment,975570.1394339622
52678,9958672,193.0.149.210,1158.0,atm,20,7674,956721481,CREDIT,0,act,2026-10-13,2024-11-17 14:40:21,1025.04,from_acc,500987.2403571429
52679,9593171,188.0.175.30,1432.0,atm,10,3023,658810916,DEBIT,0,active,2030-07-16,2024-11-22 18:09:37,319.85,in_acc,259233.08035714287
52680,9861747,178.44.0.90,1293.0,atm,10,8268,201244212,CREDIT,0,active,2028-01-03,2024-11-18 18:32:59,495.82,in,943377.0201694916
52681,9946391,212.13.0.75,241.0,atm,451,4183,955496040,CREDIT,0,active,2027-06-23,2024-11-13 13:55:12,1058.08,payment,887660.155
52682,9840713,212.17.0.210,1330.0,atm,30,9871,268329228,CREDIT,0,act,2029-07-05,2024-11-02 14:20:29,1124.94,transfer,456687.8430769231
52683,9239561,46.0.43.105,1489.0,atm,30,1915,496227508,DEBIT,0,active,2026-09-16,2024-11-03 08:42:58,836.8,transfer,408443.3024528302
52684,9942557,185.1.0.120,878.0,atm,25,6337,373712246,CREDIT,0,active,2026-07-01,2024-11-07 13:54:17,1035.91,diff_cntry,824493.8592982456
52685,9947156,2.94.0.240,1042.0,atm,25,7830,691299089,DEBIT,0,act,2028-11-17,2024-11-21 02:52:10,472.81,country_transfer,954284.6145454546
52686,9973212,178.44.0.90,1293.0,atm,451,9828,852095186,CREDIT,0,act,2029-10-24,2024-11-19 15:36:34,421.02,payment,654107.3545454546
52687,9996218,82.200.0.195,624.0,atm,20,8127,540828728,CREDIT,0,act,2026-09-16,2024-10-20 16:01:20,612.88,decrease_on_acc,265584.3288679246
52688,9992808,91.122.0.15,431.0,atm,20,3565,816927907,DEBIT,0,active,2028-09-02,2024-11-23 05:46:49,503.15,out,978690.8157627118
52689,9985874,193.0.149.210,1158.0,atm,-1,4057,625068913,CREDIT,1,act,2027-10-22,2024-11-17 01:43:18,655.87,bad,107795.35076923078
52690,9999941,31.204.0.225,932.0,atm,451,3448,111449910,DEBIT,0,active,2026-06-18,2024-11-21 22:21:44,882.84,payment,75472.05135593221
52691,9902225,212.13.0.75,241.0,atm,-1,2048,792962581,CREDIT,1,active,2025-07-20,2024-11-20 20:18:45,846.03,err_code,659160.8541379311
52692,9978327,145.255.0.165,246.0,atm,-1,7780,296881602,CREDIT,1,act,2030-09-21,2024-11-19 20:55:07,479.99,err,842622.3245454546
52693,9763060,62.76.0.135,617.0,atm,30,4855,785737963,CREDIT,0,active,2029-03-07,2024-11-25 09:10:20,568.87,transfer,277952.9326923077
52694,9754768,62.76.0.135,617.0,atm,25,6355,439695388,DEBIT,0,act,2030-03-20,2024-11-16 03:24:37,1130.95,diff_cntry,427213.2748148148
52695,9827399,91.122.0.15,431.0,atm,25,7661,415496396,DEBIT,0,active,2025-11-15,2024-11-27 12:20:36,873.02,diff_cntry,785652.316779661
52696,9888467,31.204.0.225,932.0,atm,10,7655,128792772,CREDIT,0,act,2026-08-25,2024-11-15 06:33:26,935.19,add_on_acc,79591.27799999999
52697,9975288,145.255.0.165,246.0,atm,-1,9750,518191198,CREDIT,1,act,2027-12-17,2024-10-31 01:02:27,931.92,err_code,714272.0638461538
52698,9672241,128.0.81.30,1290.0,atm,451,8345,179936822,CREDIT,0,act,2025-05-12,2024-10-31 13:45:46,889.06,payment,739433.995
52699,9872487,145.255.0.165,246.0,atm,451,5128,654155968,CREDIT,0,act,2026-07-08,2024-11-26 06:42:26,542.89,payment,507105.7181818182
52700,9929778,128.0.80.60,432.0,atm,-1,3134,830509311,DEBIT,1,act,2025-05-13,2024-11-19 13:13:24,660.24,err_code,579349.3086440678
52701,9817803,145.255.0.165,246.0,atm,30,4127,255153350,DEBIT,0,active,2027-11-07,2024-11-14 14:36:55,824.72,transfer,654874.6531034482
52702,9983471,193.0.145.45,489.0,atm,30,9871,720044336,DEBIT,0,active,2025-07-07,2024-11-24 20:46:32,528.04,transfer,51237.6626923077
52703,9788953,82.200.0.195,624.0,atm,30,1485,117144351,DEBIT,0,act,2025-01-25,2024-11-24 02:19:54,536.11,transfer,191539.32389830507
52704,9459728,31.204.0.225,932.0,atm,25,6718,855309763,CREDIT,0,active,2029-12-31,2024-11-26 08:29:38,610.1,diff_cntry,343486.71862068964
52705,9962704,188.0.162.75,494.0,atm,-1,9139,372131824,CREDIT,2,act,2027-11-27,2024-11-26 16:31:02,381.38,err_code,980851.204
52706,9815742,2.94.0.225,1472.0,atm,25,6569,174664493,CREDIT,0,active,2026-03-08,2024-11-05 08:45:31,1176.73,country_transfer,479557.29525423725
52707,9981603,188.0.162.75,494.0,atm,25,6477,787931501,DEBIT,0,act,2026-11-26,2024-11-25 23:45:23,993.82,diff_cntry,850773.746101695
52708,9979903,31.204.0.225,932.0,atm,25,4655,942167558,CREDIT,0,act,2028-08-19,2024-10-25 04:24:22,267.33,diff_cntry,519759.0494117647
52709,9305828,188.0.162.75,494.0,atm,25,9634,498979888,DEBIT,0,active,2025-05-15,2024-09-12 16:57:59,1098.66,country_transfer,487589.804
52710,9637041,91.122.0.15,431.0,atm,451,2036,509382539,DEBIT,0,active,2030-12-02,2024-11-20 12:14:07,998.94,payment,130569.77084745762
52711,9957902,2.94.0.240,1042.0,atm,451,3726,607657794,CREDIT,0,act,2028-09-25,2024-11-16 03:21:59,753.08,payment,170023.25444444446
52712,9999568,188.0.175.30,1432.0,atm,-1,7534,363251813,CREDIT,1,active,2026-08-31,2024-11-16 14:02:53,210.18,bad,507085.8627118644
52713,9893988,188.0.175.30,1432.0,atm,451,4574,491507054,DEBIT,0,act,2027-10-04,2024-11-28 18:03:46,1190.9,payment,213681.6555555556
52714,9620659,46.0.43.105,1489.0,atm,451,6762,736889665,CREDIT,0,act,2027-04-03,2024-11-17 17:48:02,1112.81,payment,822610.316440678
52715,9593875,83.222.0.180,407.0,atm,25,7966,243016955,DEBIT,0,act,2029-09-01,2024-11-26 04:24:42,968.14,country_transfer,41589.506
52716,9918480,193.0.145.45,489.0,atm,10,5261,967485566,CREDIT,0,active,2026-08-05,2024-11-02 15:00:51,509.75,in_acc,240250.6182142857
52717,9916335,193.0.145.45,489.0,atm,451,6220,213012550,CREDIT,0,act,2030-10-12,2024-11-27 01:45:51,212.33,payment,896221.4960784314
52718,9534188,83.222.0.180,407.0,atm,25,9026,471492551,CREDIT,0,act,2027-11-11,2024-10-22 05:13:40,1033.08,diff_cntry,269218.52196078433
52719,9916465,193.0.145.45,489.0,atm,10,6950,951013974,DEBIT,0,active,2028-07-18,2024-11-24 02:54:21,236.65,add_on_acc,816257.64
52720,9969870,2.94.0.225,1472.0,atm,25,5889,417330613,CREDIT,0,active,2026-11-04,2024-10-23 14:48:52,1143.0,diff_cntry,547186.36
52721,9921453,2.94.0.225,1472.0,atm,30,1277,129979700,CREDIT,0,act,2027-12-29,2024-11-01 14:59:34,905.8,transfer,550262.1918518519
52722,9982400,2.94.0.225,1472.0,atm,30,1666,529758209,DEBIT,0,active,2028-04-02,2024-11-24 08:42:36,1134.12,transfer,147852.02983050846
52723,9999515,85.21.0.105,272.0,atm,451,5077,256997825,CREDIT,0,act,2025-06-23,2024-11-03 04:55:43,1095.26,payment,574412.3277777778
52724,9933525,62.76.0.135,617.0,atm,20,3430,985323970,DEBIT,0,active,2027-01-09,2024-10-30 08:01:41,602.93,out,716282.6900000001
52725,9962855,2.94.0.240,1042.0,atm,451,8846,934231474,CREDIT,0,act,2030-11-23,2024-11-04 02:56:20,578.93,payment,90265.00703703704
52726,9468141,46.0.43.105,1489.0,atm,20,1745,949035958,DEBIT,0,act,2025-07-31,2024-11-28 03:28:17,722.98,from_acc,710501.5262264151
52727,9915642,193.0.145.45,489.0,atm,10,7178,159179437,CREDIT,0,active,2028-01-08,2024-11-15 20:36:10,739.94,in,860081.6240350878
52728,9987697,91.122.0.15,431.0,atm,20,4974,204950471,CREDIT,0,act,2028-08-24,2024-11-19 16:06:06,213.76,decrease_on_acc,856833.5877192983
52729,9965487,188.0.162.75,494.0,atm,451,5008,418776351,DEBIT,0,active,2030-05-23,2024-11-18 19:24:53,127.03,payment,354453.7946428572
52730,9900236,85.21.0.105,272.0,atm,-1,8126,628239029,CREDIT,1,active,2027-06-02,2024-11-02 16:21:10,141.0,err_code,380754.894
52731,9618038,212.13.0.75,241.0,atm,-1,9762,485047679,DEBIT,1,active,2025-01-18,2024-11-15 16:20:41,1058.23,err_code,269002.8975
52732,9777336,193.0.149.210,1158.0,atm,20,5913,568822861,DEBIT,0,active,2027-07-16,2024-10-12 18:49:17,384.33,out,537389.4042857144
52733,9946150,185.1.0.120,878.0,atm,451,4783,114878881,DEBIT,0,active,2026-05-13,2024-11-23 10:22:28,301.81,payment,200726.1863636364
52734,9691091,85.21.0.105,272.0,atm,-1,1076,359855333,CREDIT,1,act,2029-04-03,2024-11-19 15:53:15,625.76,err_code,713355.4690196079
52735,9882049,91.122.0.15,431.0,atm,30,3322,661294494,CREDIT,0,active,2026-01-23,2024-11-02 18:56:39,523.14,transfer,845456.151372549
52736,9896579,185.1.0.120,878.0,atm,451,8573,217703991,DEBIT,0,act,2025-01-28,2024-11-26 22:36:49,786.86,payment,697777.7575862069
52737,9864823,193.0.145.45,489.0,atm,25,2022,233726460,CREDIT,0,act,2028-08-20,2024-11-27 15:17:14,969.9,country_transfer,850592.1669811321
52738,9748727,145.255.0.165,246.0,atm,-1,2826,357617827,CREDIT,1,active,2029-06-23,2024-11-22 18:28:20,564.07,err_code,730232.7759259259
52739,9958934,46.0.43.105,1489.0,atm,451,4660,113666551,CREDIT,0,act,2027-10-11,2024-10-10 23:55:33,1026.88,payment,546982.7312280701
52740,9920143,185.1.0.120,878.0,atm,10,5113,765571752,CREDIT,0,act,2029-02-14,2024-11-15 04:49:41,1156.92,in,165364.25636363635
52741,9982939,83.222.0.180,407.0,atm,25,2204,730611846,CREDIT,0,active,2029-09-05,2024-11-25 09:20:21,525.95,country_transfer,787396.5427272727
52742,9918922,212.13.0.75,241.0,atm,30,1612,684764952,DEBIT,0,active,2027-10-02,2024-11-07 13:34:12,928.34,transfer,769305.0407692308
52743,9996620,2.94.0.225,1472.0,atm,30,4273,459364252,CREDIT,0,act,2028-09-05,2024-11-09 08:14:02,907.95,transfer,705803.2803571429
52744,9719715,2.94.0.240,1042.0,atm,30,4290,853086289,DEBIT,0,active,2030-01-30,2024-09-15 04:05:58,908.08,transfer,410599.178
52745,9928880,46.0.42.120,1494.0,atm,30,8340,132879023,CREDIT,0,active,2027-10-26,2024-11-24 16:28:11,481.85,transfer,429218.5152631579
52746,9980416,82.200.0.195,624.0,atm,451,1690,598141203,DEBIT,0,act,2026-01-31,2024-11-25 14:52:38,628.07,payment,247401.99067796613
52747,9854260,128.0.81.30,1290.0,atm,20,4519,168141784,DEBIT,0,act,2030-11-25,2024-11-20 02:13:50,917.03,out,830900.2903846154
52748,9934022,178.44.0.90,1293.0,atm,10,7374,468316659,DEBIT,0,active,2026-07-03,2024-11-02 09:49:00,478.17,in,378756.48152542376
52749,9491122,2.94.0.240,1042.0,atm,10,9226,809031486,DEBIT,0,act,2029-03-26,2024-09-28 15:39:19,510.06,in,859358.0678431373
52750,9981354,2.94.0.240,1042.0,atm,25,8624,224623414,CREDIT,0,act,2030-10-23,2024-11-28 21:16:53,101.89,country_transfer,297386.9051724138
52751,9904473,188.0.175.30,1432.0,atm,20,8760,183026126,DEBIT,0,active,2028-06-07,2024-10-11 08:29:54,855.9,from_acc,102781.23454545454
52752,9428285,2.94.0.240,1042.0,atm,451,6394,588359116,DEBIT,0,act,2030-06-29,2024-11-13 14:52:49,398.97,payment,800360.0766666667
52753,9786784,212.17.0.210,1330.0,atm,451,6722,416701917,CREDIT,0,active,2025-08-07,2024-11-22 22:24:48,769.27,payment,494277.985
52754,9712595,188.0.162.75,494.0,atm,20,9211,649224361,DEBIT,0,active,2028-03-09,2024-11-01 02:53:53,615.85,out,796641.968275862
52755,9951495,212.13.0.75,241.0,atm,10,4104,167036221,DEBIT,0,active,2025-06-18,2024-11-14 02:04:32,554.72,add_on_acc,517447.9422222222
52756,9851670,178.44.0.90,1293.0,atm,10,8410,709279006,DEBIT,0,act,2027-01-16,2024-11-28 23:02:56,1138.27,add_on_acc,617470.734
52757,9909425,128.0.80.60,432.0,atm,20,3358,883619905,CREDIT,0,active,2026-01-06,2024-10-06 17:14:44,539.05,decrease_on_acc,486828.0554385965
52758,9807652,31.204.0.225,932.0,atm,25,9009,589801094,CREDIT,0,active,2030-11-18,2024-10-29 21:07:48,493.84,diff_cntry,130983.80508771929
52759,9809044,193.0.149.210,1158.0,atm,10,1638,397583634,DEBIT,0,active,2030-04-03,2024-11-18 05:50:24,445.19,in_acc,251295.62315789476
52760,9944426,212.13.0.75,241.0,atm,30,3580,178753471,CREDIT,0,active,2030-05-29,2024-10-07 07:29:32,964.12,transfer,391817.55653846153
52761,9838711,185.1.0.120,878.0,atm,25,5038,821697781,DEBIT,0,active,2029-10-19,2024-11-25 16:01:36,583.72,country_transfer,100520.57178571427
52762,9993179,193.0.145.45,489.0,atm,-1,8110,820320751,CREDIT,1,active,2024-12-29,2024-10-31 03:46:36,1096.26,err_code,324566.7626415094
52763,9797802,91.122.0.15,431.0,atm,10,5937,493618293,DEBIT,0,active,2029-12-11,2024-11-26 21:13:46,626.97,in_acc,432998.2107017544
52764,9961392,193.0.145.45,489.0,atm,10,9488,370075089,CREDIT,0,act,2027-10-01,2024-11-21 14:25:18,466.9,add_on_acc,516682.2718181818
52765,9965394,188.0.175.30,1432.0,atm,10,2049,810027619,CREDIT,0,active,2028-10-26,2024-11-20 03:41:55,176.11,in_acc,737336.8827272727
52766,9958872,128.0.80.60,432.0,atm,30,2508,662630695,CREDIT,0,active,2025-06-16,2024-11-28 09:24:15,388.96,transfer,459925.9647457627
52767,9867323,85.21.0.105,272.0,atm,30,4304,282565904,CREDIT,0,act,2026-06-04,2024-11-25 00:05:43,879.06,transfer,845274.9068421052
52768,9883463,82.200.0.195,624.0,atm,-1,5940,313145901,CREDIT,1,active,2029-02-10,2024-11-24 21:38:15,298.5,bad,567684.3494915254
52769,9947848,178.44.0.90,1293.0,atm,10,1803,486840620,CREDIT,0,active,2030-05-23,2024-11-12 19:51:10,872.13,in_acc,932384.153846154
52770,9945568,82.200.0.195,624.0,atm,451,3130,667781576,DEBIT,0,act,2025-08-22,2024-11-25 12:04:59,672.71,payment,882358.1918518518
52771,9960107,82.200.0.195,624.0,atm,10,2901,238851621,DEBIT,0,active,2027-01-21,2024-11-04 20:04:27,1020.92,in,630448.7776470588
52772,9967511,31.204.0.225,932.0,atm,25,1357,264530503,DEBIT,0,act,2025-09-17,2024-10-24 11:44:07,512.95,diff_cntry,137909.71482758623
52773,9978737,185.1.0.120,878.0,atm,451,5710,650214627,DEBIT,0,active,2025-11-24,2024-11-27 22:58:51,1081.03,payment,235928.52142857143
52774,9930885,178.44.0.90,1293.0,atm,25,4222,626111495,CREDIT,0,active,2025-04-23,2024-11-21 22:49:34,415.98,diff_cntry,510590.8048148148
52775,9856938,91.122.0.15,431.0,atm,20,4937,913049567,DEBIT,0,act,2030-08-02,2024-11-23 11:52:14,344.11,from_acc,529647.8192156863
52776,9874522,128.0.80.60,432.0,atm,-1,6952,733108593,DEBIT,1,active,2026-08-29,2024-11-22 19:12:02,705.86,err_code,96797.966
52777,9978110,145.255.0.165,246.0,atm,20,8701,375595021,DEBIT,0,active,2027-08-07,2024-11-17 01:46:00,516.14,decrease_on_acc,826161.2430769231
52778,9831174,46.0.42.120,1494.0,atm,25,7232,476962367,DEBIT,0,active,2027-02-14,2024-10-19 07:50:37,655.01,diff_cntry,478021.1459259259
52779,9939934,188.0.162.75,494.0,atm,-1,3331,739648982,DEBIT,2,act,2028-10-23,2024-11-27 10:12:47,236.98,bad,795559.9192592592
52780,9762535,185.1.0.120,878.0,atm,-1,1198,356110300,DEBIT,1,active,2029-09-15,2024-11-26 17:36:07,1186.06,err_code,109055.63711864408
52781,9705971,2.94.0.225,1472.0,atm,20,1074,981736567,DEBIT,0,active,2027-12-07,2024-11-18 14:15:13,688.78,out,620566.3261538462
52782,9128021,46.0.43.105,1489.0,atm,451,8578,834912187,CREDIT,0,active,2025-03-13,2024-11-22 12:07:00,226.34,payment,151194.60400000002
52783,9972755,188.0.175.30,1432.0,atm,25,1963,881992474,CREDIT,0,active,2028-01-07,2024-10-06 21:02:36,881.97,diff_cntry,513609.36620689655
52784,9909742,188.0.162.75,494.0,atm,10,2191,952794669,CREDIT,0,active,2028-03-02,2024-09-19 02:33:46,627.89,add_on_acc,279837.9635714286
52785,9920541,85.21.0.105,272.0,atm,30,4998,729050654,CREDIT,0,act,2029-07-20,2024-11-10 22:58:01,756.06,transfer,693239.2970175439
52786,9941676,128.0.80.60,432.0,atm,30,6116,638020573,CREDIT,0,act,2025-06-28,2024-11-18 03:29:06,1004.97,transfer,523908.9785964913
52787,9736305,46.0.43.105,1489.0,atm,451,1362,211001165,CREDIT,0,active,2028-08-08,2024-10-29 08:30:41,721.89,payment,786254.1319607843
52788,9808822,46.0.42.120,1494.0,atm,20,7075,736927428,CREDIT,0,active,2028-01-09,2024-11-20 18:17:14,906.99,out,726536.6675
52789,9966646,2.94.0.240,1042.0,atm,-1,9192,546844539,DEBIT,1,act,2029-07-02,2024-11-10 19:45:34,1049.9,err_code,849759.3110169491
52790,9925719,212.17.0.210,1330.0,atm,451,2477,153472984,DEBIT,0,active,2025-04-29,2024-11-24 04:57:25,317.21,payment,143765.88586206897
52791,9697229,46.0.42.120,1494.0,atm,451,6235,273880071,CREDIT,0,act,2030-01-07,2024-10-22 05:29:36,840.68,payment,572062.3087719298
52792,9759555,31.204.0.225,932.0,atm,20,9221,576552229,DEBIT,0,act,2030-07-15,2024-10-23 20:35:54,347.89,out,77410.73396226414
52793,9644372,2.94.0.225,1472.0,atm,451,8461,326420263,CREDIT,0,act,2026-04-13,2024-11-15 23:52:02,159.98,payment,175878.84344827587
52794,9978292,85.21.0.105,272.0,atm,-1,2863,168847159,CREDIT,2,act,2025-07-24,2024-10-27 11:48:18,1037.06,err,178740.09
52795,9926402,145.255.0.165,246.0,atm,25,8609,466915142,DEBIT,0,act,2028-05-28,2024-11-23 18:48:28,466.94,country_transfer,378623.31771929824
52796,9992211,145.255.0.165,246.0,atm,30,9808,745962072,DEBIT,0,active,2028-08-03,2024-11-20 06:48:22,1157.88,transfer,711794.1925
52797,9981330,2.94.0.225,1472.0,atm,20,6116,289249620,DEBIT,0,act,2028-06-19,2024-11-23 08:55:24,929.23,from_acc,308310.84777777776
52798,9837177,188.0.162.75,494.0,atm,20,4444,667131057,CREDIT,0,active,2028-01-14,2024-11-19 18:16:00,125.0,from_acc,853789.884
52799,9987076,212.17.0.210,1330.0,atm,25,3604,782852627,DEBIT,0,act,2027-06-12,2024-11-26 08:00:28,386.14,country_transfer,487299.4331578948
52800,9964964,31.204.0.225,932.0,atm,451,4057,999660534,DEBIT,0,active,2027-03-05,2024-11-25 22:54:25,713.92,payment,360293.75413793104
52801,9929758,193.0.149.210,1158.0,atm,30,1493,315864478,CREDIT,0,act,2030-10-18,2024-11-09 13:18:18,118.3,transfer,768122.2046428572
52802,9840222,85.21.0.105,272.0,atm,30,5547,180587807,CREDIT,0,active,2028-05-28,2024-11-21 01:12:45,589.95,transfer,750501.3481132075
52803,9879098,2.94.0.225,1472.0,atm,20,6421,716439202,CREDIT,0,active,2028-06-18,2024-11-24 10:29:06,946.79,decrease_on_acc,453804.2718644068
52804,9597168,46.0.43.105,1489.0,atm,10,3692,702890747,CREDIT,0,act,2030-09-19,2024-11-19 21:38:33,312.9,in,523660.0009433962
52805,9963416,188.0.175.30,1432.0,atm,-1,8495,576464614,CREDIT,1,act,2028-03-28,2024-11-18 13:44:54,306.05,err,364882.18071428576
52806,9943133,188.0.175.30,1432.0,atm,30,4652,753984993,DEBIT,0,act,2029-12-11,2024-11-16 05:49:27,805.62,transfer,646945.9426923078
52807,9467084,193.0.145.45,489.0,atm,451,7111,785612871,CREDIT,0,act,2026-11-18,2024-11-18 16:00:20,318.25,payment,823832.7010169491
52808,9978125,128.0.81.30,1290.0,atm,-1,6650,800454494,DEBIT,1,active,2027-04-19,2024-10-18 16:36:59,1012.98,err,267034.8256140351
52809,9976290,128.0.81.30,1290.0,atm,451,7625,241464203,DEBIT,0,active,2029-01-20,2024-10-30 04:35:35,672.97,payment,303391.3961538462
52810,9664977,145.255.0.165,246.0,atm,-1,8027,142776076,CREDIT,2,active,2029-08-20,2024-09-24 17:27:46,1049.08,bad,249253.4109090909
52811,9552622,31.204.0.225,932.0,atm,25,8623,731906429,DEBIT,0,active,2025-07-15,2024-11-15 13:59:05,378.01,country_transfer,540564.4824137931
52812,9973863,193.0.149.210,1158.0,atm,-1,9336,505457889,DEBIT,1,active,2030-06-06,2024-11-25 01:35:34,1038.21,err_code,637376.6606896551
52813,9726718,128.0.81.30,1290.0,atm,451,8500,569977786,CREDIT,0,active,2027-10-02,2024-09-27 09:12:46,253.05,payment,484825.85377358494
52814,9749371,212.13.0.75,241.0,atm,451,5289,296726164,CREDIT,0,active,2028-04-10,2024-10-31 07:26:28,253.77,payment,801865.5511864407
52815,9923592,2.94.0.225,1472.0,atm,30,1927,210562394,DEBIT,0,act,2027-05-15,2024-11-19 13:17:14,348.82,transfer,215456.5776923077
52816,9980573,46.0.42.120,1494.0,atm,25,3086,645614101,CREDIT,0,active,2025-06-18,2024-10-31 00:44:49,951.98,country_transfer,641131.9970588236
52817,9945908,128.0.81.30,1290.0,atm,25,5811,144633903,CREDIT,0,active,2026-06-25,2024-11-13 11:21:19,670.26,diff_cntry,833653.5074509804
52818,9764276,91.122.0.15,431.0,atm,30,4279,609997307,CREDIT,0,active,2025-05-28,2024-09-26 20:53:20,1103.97,transfer,145251.658
52819,9895506,46.0.43.105,1489.0,atm,10,7548,664765062,DEBIT,0,active,2025-03-10,2024-11-23 12:23:01,1088.0,add_on_acc,516428.3263157894
52820,9914273,193.0.145.45,489.0,atm,-1,9112,292408413,CREDIT,1,act,2026-01-01,2024-11-09 17:31:34,745.71,err,289527.6687719298
52821,9666429,185.1.0.120,878.0,atm,451,2086,439911730,DEBIT,0,act,2027-11-04,2024-11-16 22:57:01,1114.08,payment,414763.2134482759
52822,9936535,188.0.162.75,494.0,atm,20,1063,311083835,DEBIT,0,act,2030-09-27,2024-10-20 22:20:06,612.82,out,134549.178
52823,9955646,31.204.0.225,932.0,atm,30,9288,473037261,DEBIT,0,active,2030-12-12,2024-11-25 02:58:11,834.02,transfer,891755.9267924528
52824,9996620,2.94.0.225,1472.0,atm,10,6341,644904760,DEBIT,0,active,2025-08-28,2024-11-03 02:02:15,832.01,in_acc,904214.5392452832
52825,9871629,185.1.0.120,878.0,atm,10,2123,565907549,CREDIT,0,active,2025-03-02,2024-11-26 13:22:37,245.91,in,97202.80535714286
52826,9984577,212.13.0.75,241.0,atm,30,1656,743725248,CREDIT,0,active,2030-04-19,2024-11-24 02:04:02,959.76,transfer,727138.6250980393
52827,9951586,188.0.175.30,1432.0,atm,30,2056,382676735,DEBIT,0,active,2030-03-05,2024-11-16 15:19:22,1104.84,transfer,58343.02
52828,9127559,193.0.149.210,1158.0,atm,25,3601,706487512,CREDIT,0,act,2029-08-11,2024-11-25 07:35:53,980.12,country_transfer,290665.9881481481
52829,9992388,212.13.0.75,241.0,atm,25,7987,404966438,CREDIT,0,act,2030-04-27,2024-11-02 11:48:58,806.15,diff_cntry,411788.8636363637
52830,9961186,46.0.42.120,1494.0,atm,30,6814,306334557,CREDIT,0,act,2026-02-16,2024-11-27 18:10:32,181.93,transfer,785149.6627272727
52831,9840301,193.0.145.45,489.0,atm,20,3828,327391406,DEBIT,0,active,2025-06-12,2024-11-23 16:15:37,762.06,out,495434.994
52832,9518736,128.0.80.60,432.0,atm,451,4108,590693578,DEBIT,0,active,2029-04-22,2024-11-15 13:22:28,843.84,payment,920648.34
52833,9663102,46.0.43.105,1489.0,atm,25,6615,188118633,CREDIT,0,active,2029-10-29,2024-11-27 18:04:57,781.11,diff_cntry,413903.7303773585
52834,9687851,46.0.43.105,1489.0,atm,451,8127,784296256,DEBIT,0,active,2029-11-26,2024-11-27 00:43:35,326.72,payment,444333.30846153846
52835,9521603,185.1.0.120,878.0,atm,451,3338,140659914,CREDIT,0,active,2026-06-11,2024-11-17 10:22:48,1124.97,payment,586343.942
52836,9945037,185.1.0.120,878.0,atm,10,4407,499611655,DEBIT,0,act,2028-03-03,2024-11-13 14:30:24,430.8,in,819589.8472413793
52837,9953165,145.255.0.165,246.0,atm,451,1702,405121370,DEBIT,0,act,2026-12-30,2024-11-28 03:44:27,1154.1,payment,911460.510909091
52838,9261215,2.94.0.240,1042.0,atm,-1,7964,774732977,CREDIT,1,active,2026-02-11,2024-11-26 21:19:40,716.04,err,306709.02400000003
52839,9969898,178.44.0.90,1293.0,atm,30,6758,298848722,CREDIT,0,act,2030-08-03,2024-11-25 18:08:21,1096.94,transfer,787634.8760714285
52840,9931705,85.21.0.105,272.0,atm,30,4343,828055432,DEBIT,0,act,2025-07-09,2024-10-22 10:11:57,654.05,transfer,293562.7814814815
52841,9940803,83.222.0.180,407.0,atm,-1,9655,507494025,DEBIT,2,active,2024-12-12,2024-10-29 07:42:01,224.95,err_code,758305.5142307691
52842,9825346,193.0.145.45,489.0,atm,30,4131,460684713,CREDIT,0,act,2026-03-21,2024-11-12 08:17:34,500.22,transfer,274632.45473684213
52843,9867348,188.0.175.30,1432.0,atm,25,4038,909552048,CREDIT,0,active,2027-12-02,2024-11-16 20:07:20,430.06,diff_cntry,817267.0977358491
52844,9705905,185.1.0.120,878.0,atm,25,6509,866008262,DEBIT,0,active,2027-12-16,2024-11-17 09:49:16,479.04,country_transfer,264714.75528301887
52845,9923429,193.0.145.45,489.0,atm,451,2404,703136988,DEBIT,0,active,2025-07-27,2024-11-28 23:18:41,1059.99,payment,203154.72444444444
52846,9704515,46.0.43.105,1489.0,atm,451,3614,920814984,CREDIT,0,active,2029-03-20,2024-11-20 00:24:37,194.99,payment,641470.3961538462
52847,9878021,83.222.0.180,407.0,atm,-1,3624,588644472,CREDIT,1,act,2025-05-14,2024-11-18 06:19:54,235.97,bad,858787.105862069
52848,9985736,128.0.80.60,432.0,atm,10,9990,287484291,DEBIT,0,act,2029-06-12,2024-11-18 17:04:14,377.05,add_on_acc,933701.8222033898
52849,9508882,128.0.81.30,1290.0,atm,25,5189,673057255,DEBIT,0,active,2025-11-30,2024-10-16 01:46:14,606.06,diff_cntry,474618.2044444445
52850,9862072,62.76.0.135,617.0,atm,451,8835,353511595,DEBIT,0,active,2029-10-22,2024-11-18 10:10:34,480.85,payment,183095.6252542373
52851,9890808,83.222.0.180,407.0,atm,451,9976,108083730,CREDIT,0,act,2025-04-25,2024-11-04 15:33:36,128.19,payment,376381.9330508475
52852,9939874,212.17.0.210,1330.0,atm,-1,1994,888966004,CREDIT,2,act,2027-09-26,2024-11-22 23:00:20,1090.91,err,724610.4984745763
52853,9734027,128.0.81.30,1290.0,atm,20,2843,602408706,CREDIT,0,act,2028-11-03,2024-11-16 19:13:19,1173.81,decrease_on_acc,20592.97035714286
52854,9915010,82.200.0.195,624.0,atm,20,2103,483265191,DEBIT,0,act,2025-01-12,2024-11-25 22:52:01,154.86,decrease_on_acc,828862.4246153845
52855,9988484,185.1.0.120,878.0,atm,25,5479,163811167,CREDIT,0,active,2025-02-10,2024-10-25 09:54:05,1118.78,diff_cntry,369764.1992857143
52856,9851082,82.200.0.195,624.0,atm,451,7853,253533366,CREDIT,0,active,2027-10-23,2024-11-19 17:46:44,383.9,payment,702045.4676923077
52857,9601883,188.0.162.75,494.0,atm,20,2083,294921463,CREDIT,0,act,2029-04-30,2024-11-13 23:02:52,395.12,from_acc,58067.54
52858,9774491,212.13.0.75,241.0,atm,-1,4462,333026073,CREDIT,1,act,2026-01-01,2024-11-28 13:37:01,299.96,err_code,924443.9607407408
52859,9948320,2.94.0.225,1472.0,atm,30,9818,699190134,CREDIT,0,act,2025-10-27,2024-11-26 03:28:30,982.98,transfer,827027.5492982456
52860,9978888,178.44.0.90,1293.0,atm,451,6289,398288192,CREDIT,0,active,2028-05-06,2024-10-22 05:55:31,905.17,payment,186145.39470588235
52861,9980632,46.0.42.120,1494.0,atm,20,3957,680005319,DEBIT,0,active,2026-07-29,2024-11-23 01:06:03,746.82,from_acc,532551.5514285715
52862,9955157,178.44.0.90,1293.0,atm,-1,6684,505946081,DEBIT,1,active,2027-02-16,2024-11-28 06:03:07,719.91,err_code,186644.7385185185
52863,9632816,212.13.0.75,241.0,atm,20,9428,279698076,DEBIT,0,active,2028-04-16,2024-11-17 15:18:14,923.85,from_acc,843703.6322222223
52864,9538585,2.94.0.240,1042.0,atm,451,3470,711071753,DEBIT,0,active,2029-12-12,2024-11-14 15:59:22,315.98,payment,180248.5627272727
52865,9976689,62.76.0.135,617.0,atm,10,1336,235538404,CREDIT,0,act,2027-06-29,2024-11-21 04:30:22,512.18,in_acc,39515.79
52866,9753303,212.17.0.210,1330.0,atm,451,6517,365039055,CREDIT,0,active,2030-01-07,2024-11-16 05:57:16,775.93,payment,174618.0554237288
52867,9944363,212.13.0.75,241.0,atm,10,7792,142727949,CREDIT,0,act,2026-06-28,2024-11-13 20:23:50,130.88,in_acc,369062.9718518519
52868,9960608,82.200.0.195,624.0,atm,30,5487,650967804,DEBIT,0,act,2024-12-05,2024-11-16 23:24:22,253.13,transfer,690937.4151851851
52869,9909886,188.0.162.75,494.0,atm,10,1737,160991527,CREDIT,0,act,2026-07-17,2024-11-20 03:59:42,103.84,add_on_acc,992024.4401886791
52870,9892339,91.122.0.15,431.0,atm,20,6191,589825591,CREDIT,0,act,2030-03-29,2024-10-25 13:44:46,665.0,decrease_on_acc,663566.8753571429
52871,9738616,46.0.42.120,1494.0,atm,451,2430,113863171,CREDIT,0,active,2030-04-21,2024-11-25 02:35:17,798.87,payment,29331.319824561404
52872,9823678,212.17.0.210,1330.0,atm,30,9753,493866660,DEBIT,0,active,2027-10-16,2024-11-03 05:24:34,104.94,transfer,813699.0345762712
52873,9984406,83.222.0.180,407.0,atm,25,9524,751624425,DEBIT,0,act,2027-04-11,2024-11-25 10:04:21,575.11,diff_cntry,318196.7214285714
52874,9879216,83.222.0.180,407.0,atm,30,3388,853427181,DEBIT,0,active,2025-01-24,2024-11-13 01:46:15,284.29,transfer,371143.1914035088
52875,9895226,193.0.149.210,1158.0,atm,451,4480,685003976,DEBIT,0,act,2027-03-12,2024-11-19 06:11:17,870.98,payment,100642.4549056604
52876,9734200,193.0.149.210,1158.0,atm,25,3685,120653269,CREDIT,0,act,2028-08-23,2024-11-22 01:11:08,170.22,country_transfer,804495.0767924528
52877,9973011,145.255.0.165,246.0,atm,451,2693,315250952,CREDIT,0,act,2030-05-22,2024-11-24 14:07:46,742.17,payment,904569.0403448276
52878,9893667,128.0.80.60,432.0,atm,10,5845,208889256,CREDIT,0,active,2025-10-01,2024-11-27 11:14:35,1047.97,in_acc,958369.5024528302
52879,9979903,193.0.149.210,1158.0,atm,10,4301,467092648,CREDIT,0,act,2024-12-15,2024-11-28 06:39:07,348.01,add_on_acc,845115.08
52880,9940072,145.255.0.165,246.0,atm,20,8265,624970335,DEBIT,0,active,2027-04-05,2024-11-06 23:15:43,1022.85,out,349305.5362745098
52881,9970393,193.0.149.210,1158.0,atm,451,6613,298056410,CREDIT,0,act,2029-10-27,2024-10-30 08:52:55,1008.08,payment,525468.6911111111
52882,9796012,62.76.0.135,617.0,atm,451,4721,189717612,DEBIT,0,active,2026-03-08,2024-11-18 01:27:08,190.94,payment,890745.0608474576
52883,9885673,62.76.0.135,617.0,atm,25,7982,680800937,CREDIT,0,active,2028-06-02,2024-11-04 01:49:12,867.84,diff_cntry,911046.406
52884,9985484,31.204.0.225,932.0,atm,20,7143,608706088,CREDIT,0,active,2029-03-04,2024-11-15 18:38:29,466.02,decrease_on_acc,538870.9118181819
52885,9940771,85.21.0.105,272.0,atm,10,8616,655971405,CREDIT,0,act,2028-10-31,2024-10-04 09:10:23,957.12,in,572533.5350847458
52886,9967732,91.122.0.15,431.0,atm,25,6610,305375831,CREDIT,0,act,2029-01-12,2024-11-24 13:48:29,519.16,diff_cntry,345892.36559322034
52887,9968389,212.17.0.210,1330.0,atm,25,8354,186200276,DEBIT,0,active,2024-12-08,2024-11-03 10:21:05,217.06,country_transfer,741308.8989473684
52888,9710288,212.13.0.75,241.0,atm,451,2608,598568833,CREDIT,0,active,2026-12-11,2024-11-04 19:24:19,619.0,payment,867215.1164150944
52889,9887975,188.0.175.30,1432.0,atm,-1,4013,633690968,CREDIT,1,act,2028-11-02,2024-11-12 18:14:34,846.0,err_code,167289.16037037037
52890,9961911,212.13.0.75,241.0,atm,30,1204,196155834,CREDIT,0,active,2027-05-16,2024-11-07 11:41:30,921.23,transfer,726442.5280392157
52891,9987082,31.204.0.225,932.0,atm,451,8313,414035214,DEBIT,0,active,2029-06-30,2024-10-05 10:54:16,271.94,payment,783458.561923077
52892,9948046,85.21.0.105,272.0,atm,451,1389,960126463,CREDIT,0,act,2029-09-03,2024-11-02 02:53:19,941.22,payment,789931.5993103449
52893,9970046,83.222.0.180,407.0,atm,10,9251,960540992,DEBIT,0,act,2029-10-26,2024-11-19 09:10:08,666.69,in_acc,776292.4890196078
52894,9970839,82.200.0.195,624.0,atm,451,3924,373769158,DEBIT,0,act,2026-09-12,2024-11-15 12:11:02,923.1,payment,603978.6701754386
52895,9992220,91.122.0.15,431.0,atm,25,9853,963548109,CREDIT,0,act,2025-05-26,2024-10-07 04:06:56,907.03,diff_cntry,425238.4050877193
52896,9756133,128.0.81.30,1290.0,atm,-1,4227,358837932,DEBIT,2,act,2029-05-07,2024-11-13 03:28:23,777.21,err_code,219044.2932075472
52897,9987890,212.17.0.210,1330.0,atm,451,3734,615378682,DEBIT,0,act,2027-04-27,2024-11-06 10:08:10,538.83,payment,894158.0203703704
52898,9968541,85.21.0.105,272.0,atm,25,5638,875833352,CREDIT,0,act,2028-01-01,2024-11-26 07:13:44,425.12,diff_cntry,948738.4028070176
52899,9675076,46.0.42.120,1494.0,atm,10,7075,389989706,CREDIT,0,active,2026-02-06,2024-10-19 16:25:49,1034.08,in_acc,314323.1860714286
52900,9974833,185.1.0.120,878.0,atm,20,4638,897188633,CREDIT,0,active,2028-11-05,2024-11-20 00:55:57,144.98,decrease_on_acc,421025.7220689656
52901,9811968,46.0.43.105,1489.0,atm,10,8757,592340189,DEBIT,0,act,2028-08-31,2024-10-23 07:44:54,711.43,in_acc,538801.3125490196
52902,9937094,85.21.0.105,272.0,atm,25,7215,469987837,CREDIT,0,act,2027-01-27,2024-11-25 09:37:24,762.03,diff_cntry,651653.1850943397
52903,9750441,185.1.0.120,878.0,atm,30,7219,986872878,CREDIT,0,active,2028-01-26,2024-10-10 10:38:54,493.75,transfer,959858.7575471698
52904,9678061,185.1.0.120,878.0,atm,451,2492,841138163,DEBIT,0,act,2030-08-18,2024-10-18 01:36:43,940.23,payment,112016.49274509805
52905,9990210,82.200.0.195,624.0,atm,-1,5492,141742574,CREDIT,1,act,2030-12-14,2024-11-06 12:35:42,141.17,err_code,915124.5084210526
52906,9992848,62.76.0.135,617.0,atm,20,7126,891345584,DEBIT,0,active,2025-03-27,2024-11-15 03:05:12,584.06,out,79052.17566037735
52907,9992852,83.222.0.180,407.0,atm,20,6729,607670112,DEBIT,0,active,2030-06-30,2024-11-04 04:56:05,820.11,out,508092.5603703704
52908,9952330,185.1.0.120,878.0,atm,30,8537,621991980,DEBIT,0,act,2025-08-20,2024-11-04 18:35:30,835.95,transfer,684765.717037037
52909,9909123,128.0.80.60,432.0,atm,30,4055,473887976,DEBIT,0,active,2029-03-22,2024-11-27 14:24:24,738.24,transfer,144502.0690909091
52910,9861014,91.122.0.15,431.0,atm,451,4518,184285368,CREDIT,0,active,2026-01-31,2024-11-09 15:58:41,1186.11,payment,186368.812
52911,9710137,178.44.0.90,1293.0,atm,20,4456,874559244,CREDIT,0,active,2026-08-04,2024-11-27 06:32:00,870.03,from_acc,215251.65103448275
52912,9654777,212.17.0.210,1330.0,atm,30,3251,981420604,DEBIT,0,active,2025-01-06,2024-11-24 20:15:32,887.05,transfer,135558.4776923077
52913,9980135,2.94.0.225,1472.0,atm,451,2398,435579419,CREDIT,0,act,2028-05-21,2024-11-24 09:14:00,1068.8,payment,136205.2409090909
52914,9902002,62.76.0.135,617.0,atm,451,7341,114024738,DEBIT,0,active,2026-11-25,2024-11-20 20:58:05,862.94,payment,694737.5751724137
52915,9987437,193.0.145.45,489.0,atm,451,3468,762233158,DEBIT,0,act,2026-05-05,2024-10-30 20:53:13,680.02,payment,776280.7428571429
52916,9469077,83.222.0.180,407.0,atm,20,2283,381701386,DEBIT,0,active,2029-05-01,2024-11-09 21:25:57,768.28,out,639243.4988461538
52917,9721604,145.255.0.165,246.0,atm,25,8960,240574938,DEBIT,0,active,2029-08-24,2024-11-22 12:19:15,238.99,country_transfer,654418.1707142858
52918,9826278,212.17.0.210,1330.0,atm,25,9769,288824037,DEBIT,0,active,2024-12-10,2024-11-07 08:46:44,483.88,country_transfer,749199.4588888888
52919,9976444,46.0.42.120,1494.0,atm,30,7762,291763341,CREDIT,0,act,2028-04-16,2024-10-09 16:34:06,982.07,transfer,537326.0110714285
52920,9886026,188.0.175.30,1432.0,atm,-1,4330,693751966,CREDIT,1,act,2027-03-03,2024-11-18 13:45:20,748.19,err,854679.3171929825
52921,9798286,178.44.0.90,1293.0,atm,20,7731,655241852,DEBIT,0,active,2025-08-16,2024-11-08 01:38:11,184.95,from_acc,191299.00818181815
52922,9835378,128.0.80.60,432.0,atm,451,3676,151225850,CREDIT,0,active,2025-03-12,2024-10-30 22:42:38,791.77,payment,188736.88392156863
52923,9986456,178.44.0.90,1293.0,atm,10,2364,542768177,DEBIT,0,active,2026-12-18,2024-11-15 17:49:10,755.15,in,254140.53620689656
52924,9715735,82.200.0.195,624.0,atm,20,8380,866714158,DEBIT,0,active,2025-10-22,2024-11-22 01:00:25,967.86,out,540547.6016949152
52925,9807281,145.255.0.165,246.0,atm,20,9207,120119680,DEBIT,0,act,2025-08-01,2024-10-12 19:14:58,437.08,from_acc,577780.933898305
52926,9972999,83.222.0.180,407.0,atm,25,9099,522451535,CREDIT,0,act,2025-10-04,2024-10-28 15:13:46,1002.11,diff_cntry,324207.0060714286
52927,9408286,178.44.0.90,1293.0,atm,25,8739,990966140,CREDIT,0,act,2027-11-28,2024-11-28 10:40:01,628.13,diff_cntry,359261.7596226415
52928,9590417,2.94.0.240,1042.0,atm,451,8018,170042476,DEBIT,0,act,2026-07-11,2024-11-28 13:12:15,547.91,payment,56415.69526315789
52929,9950047,2.94.0.225,1472.0,atm,30,4983,736588033,DEBIT,0,active,2027-06-27,2024-11-23 21:09:26,161.89,transfer,950009.4492156864
52930,9915674,46.0.42.120,1494.0,atm,451,7120,702911350,DEBIT,0,act,2025-07-03,2024-11-12 23:55:27,376.25,payment,101755.682
52931,9917701,145.255.0.165,246.0,atm,451,3518,795904222,DEBIT,0,act,2030-02-23,2024-10-17 07:33:30,905.21,payment,284161.6960714286
52932,9949119,188.0.162.75,494.0,atm,451,7000,439821858,CREDIT,0,active,2027-11-23,2024-11-24 19:22:15,927.04,payment,667867.0106896551
52933,9690611,128.0.80.60,432.0,atm,-1,4411,816990241,DEBIT,1,act,2025-08-03,2024-11-02 16:18:47,297.03,err,204449.22
52934,9751522,188.0.175.30,1432.0,atm,25,9943,524315718,DEBIT,0,act,2025-05-19,2024-10-28 07:53:37,520.75,country_transfer,675850.0292307693
52935,9845226,31.204.0.225,932.0,atm,30,1289,910018828,CREDIT,0,act,2026-12-17,2024-10-26 19:39:11,503.8,transfer,966203.5684313726
52936,9981191,185.1.0.120,878.0,atm,20,1433,311824637,DEBIT,0,act,2025-04-26,2024-10-22 12:27:04,102.94,decrease_on_acc,596599.9337037037
52937,9938928,128.0.81.30,1290.0,atm,10,7567,337325989,CREDIT,0,act,2025-11-28,2024-10-09 04:02:01,380.78,add_on_acc,603558.5007407407
52938,9707972,83.222.0.180,407.0,atm,451,4423,632930809,DEBIT,0,act,2030-10-13,2024-11-11 05:16:36,541.96,payment,908174.8115789474
52939,9962724,178.44.0.90,1293.0,atm,451,3509,449274487,CREDIT,0,active,2027-11-14,2024-11-25 20:23:23,729.13,payment,738847.5807407408
52940,9909693,91.122.0.15,431.0,atm,451,9306,779540433,CREDIT,0,active,2026-08-17,2024-11-28 23:26:35,955.85,payment,31998.01185185185
52941,9793952,145.255.0.165,246.0,atm,-1,3737,824297491,CREDIT,1,active,2030-12-26,2024-11-22 17:05:01,1127.77,bad,331667.86607843137
52942,9921072,46.0.42.120,1494.0,atm,451,6131,175275301,DEBIT,0,act,2029-06-03,2024-11-03 00:46:28,682.1,payment,825413.1139215686
52943,9964279,46.0.42.120,1494.0,atm,10,5978,348574133,DEBIT,0,active,2029-12-19,2024-11-26 04:49:30,896.01,in_acc,347173.1122641509
52944,9892732,85.21.0.105,272.0,atm,10,8982,299343792,CREDIT,0,active,2028-06-19,2024-11-21 07:57:20,136.78,in,673297.0037931034
52945,9799412,82.200.0.195,624.0,atm,451,4774,898367812,DEBIT,0,act,2025-07-21,2024-11-27 10:59:33,843.86,payment,595733.5390909091
52946,9826672,145.255.0.165,246.0,atm,451,3353,956535833,CREDIT,0,active,2030-07-28,2024-11-12 23:22:03,759.25,payment,489474.39735849056
52947,9210300,128.0.81.30,1290.0,atm,25,1826,542584564,DEBIT,0,active,2030-01-02,2024-10-28 05:43:00,126.73,diff_cntry,516118.872
52948,9311832,83.222.0.180,407.0,atm,451,1302,489186876,DEBIT,0,act,2028-07-22,2024-11-21 15:19:17,1032.82,payment,467153.9281132076
52949,9452677,193.0.149.210,1158.0,atm,25,3279,796480505,DEBIT,0,active,2030-10-13,2024-11-25 21:21:36,1195.8,country_transfer,129792.02576923078
52950,9933468,83.222.0.180,407.0,atm,10,2961,809486661,DEBIT,0,active,2029-02-20,2024-09-27 11:34:05,142.03,in_acc,873401.9007692308
52951,9642868,128.0.80.60,432.0,atm,10,1592,458865581,CREDIT,0,act,2028-12-22,2024-09-21 16:03:12,460.13,in_acc,786726.67
52952,9918867,46.0.43.105,1489.0,atm,-1,8826,402035928,CREDIT,1,active,2028-06-16,2024-11-26 07:42:35,234.01,err_code,913123.7928070176
52953,9380191,83.222.0.180,407.0,atm,451,3550,881872889,CREDIT,0,active,2030-02-04,2024-10-15 03:19:26,423.99,payment,613086.3954545454
52954,9627541,46.0.43.105,1489.0,atm,-1,5221,248434269,CREDIT,1,act,2026-02-05,2024-10-28 16:34:14,193.16,err_code,83583.56491525425
52955,9997113,193.0.145.45,489.0,atm,451,6552,390520369,CREDIT,0,active,2028-01-30,2024-11-03 18:48:47,984.77,payment,38953.39200000001
52956,9840040,83.222.0.180,407.0,atm,451,4605,828601668,CREDIT,0,act,2028-11-11,2024-11-22 10:54:47,917.95,payment,449718.8045454545
52957,9696405,185.1.0.120,878.0,atm,20,5623,193478786,CREDIT,0,active,2030-11-03,2024-09-20 04:36:42,399.86,decrease_on_acc,510999.07172413793
52958,9952364,2.94.0.225,1472.0,atm,-1,2097,231469314,DEBIT,1,act,2030-12-19,2024-10-06 00:42:05,193.33,err,705986.6809090909
52959,9796006,85.21.0.105,272.0,atm,-1,1262,572024218,CREDIT,2,active,2026-02-27,2024-11-23 13:47:45,526.93,err,645770.4409090909
52960,9999425,212.17.0.210,1330.0,atm,-1,7724,386896706,CREDIT,2,active,2029-07-31,2024-10-19 00:03:15,904.03,err,710985.1920338983
52961,9935573,128.0.81.30,1290.0,atm,-1,8064,901573513,CREDIT,1,active,2030-05-21,2024-11-26 15:12:54,542.06,err_code,144937.38454545455
52962,9729748,2.94.0.240,1042.0,atm,25,4729,522241840,CREDIT,0,active,2025-06-07,2024-11-25 12:52:06,418.73,diff_cntry,191139.7926315789
52963,9632178,46.0.43.105,1489.0,atm,25,4650,475369946,DEBIT,0,active,2027-04-17,2024-09-12 08:09:53,515.11,country_transfer,235235.5769491525
52964,9901354,212.13.0.75,241.0,atm,451,1367,374027133,CREDIT,0,active,2027-06-23,2024-11-25 13:50:21,1078.13,payment,624883.6857692308
52965,9952201,31.204.0.225,932.0,atm,451,8290,284347475,DEBIT,0,act,2028-02-03,2024-11-23 06:03:58,657.24,payment,967576.1913793104
52966,9950686,212.13.0.75,241.0,atm,451,8864,502788332,DEBIT,0,active,2027-02-21,2024-11-23 18:25:33,688.94,payment,725718.2676923077
52967,9816040,128.0.81.30,1290.0,atm,10,1801,256161606,CREDIT,0,act,2027-09-20,2024-10-26 22:49:01,617.3,in_acc,666175.3015094339
52968,9710705,91.122.0.15,431.0,atm,451,8800,696064152,CREDIT,0,act,2026-10-17,2024-11-26 11:17:14,1182.75,payment,751244.185882353
52969,9819770,128.0.81.30,1290.0,atm,451,1982,316136270,DEBIT,0,act,2026-03-06,2024-10-09 11:55:09,383.94,payment,270102.7138983051
52970,9883321,2.94.0.225,1472.0,atm,-1,7568,475293055,CREDIT,1,active,2029-05-01,2024-11-16 01:47:30,793.24,err_code,947393.2765384616
52971,9869512,212.17.0.210,1330.0,atm,30,8672,760774347,CREDIT,0,active,2025-07-25,2024-11-18 12:06:58,893.97,transfer,636664.1327272728
52972,9975242,212.13.0.75,241.0,atm,-1,3132,668775790,CREDIT,1,active,2025-02-07,2024-10-31 12:48:50,807.44,err_code,68016.82881355932
52973,9991786,185.1.0.120,878.0,atm,30,4887,704648707,DEBIT,0,active,2027-02-06,2024-11-14 03:52:47,987.98,transfer,889349.8852941176
52974,9915466,91.122.0.15,431.0,atm,30,1845,883176016,CREDIT,0,act,2028-08-18,2024-11-01 12:17:43,121.81,transfer,673375.2236363636
52975,9816526,46.0.43.105,1489.0,atm,20,1759,981768769,CREDIT,0,active,2027-10-19,2024-11-28 00:33:51,126.04,decrease_on_acc,346564.51692307694
52976,9978659,212.17.0.210,1330.0,atm,20,2073,512331465,CREDIT,0,act,2028-05-23,2024-11-23 04:58:46,906.99,decrease_on_acc,330519.51175438595
52977,9235125,212.13.0.75,241.0,atm,10,2124,220432344,DEBIT,0,act,2029-03-29,2024-11-22 10:00:44,490.21,in,266480.7882142857
52978,9898625,188.0.162.75,494.0,atm,25,1671,682986333,DEBIT,0,act,2025-05-19,2024-09-22 17:07:04,1083.99,diff_cntry,893163.5233333333
52979,9989003,188.0.162.75,494.0,atm,20,7476,538406799,DEBIT,0,active,2030-02-12,2024-11-16 14:57:18,394.02,out,300005.23384615383
52980,9930223,212.17.0.210,1330.0,atm,451,4876,964163162,CREDIT,0,act,2030-10-02,2024-11-17 07:15:48,303.85,payment,555628.7482352941
52981,9883165,31.204.0.225,932.0,atm,30,5932,778133517,CREDIT,0,active,2030-07-20,2024-11-21 20:03:17,623.94,transfer,832343.183220339
52982,9303467,178.44.0.90,1293.0,atm,30,3761,801384543,CREDIT,0,act,2027-02-08,2024-11-20 06:11:54,1131.05,transfer,379440.0705660377
52983,9901279,128.0.81.30,1290.0,atm,-1,3850,584520677,DEBIT,1,act,2027-05-19,2024-10-28 22:04:19,861.94,err_code,626570.6820689655
52984,9870117,128.0.80.60,432.0,atm,-1,3401,400668031,CREDIT,1,act,2029-05-03,2024-10-24 19:25:07,390.19,err,670772.9965517242
52985,9901818,193.0.145.45,489.0,atm,10,4434,348889955,CREDIT,0,act,2026-03-21,2024-11-28 12:35:41,156.91,in,444866.14464285714
52986,9908768,188.0.162.75,494.0,atm,30,1697,516090826,DEBIT,0,act,2025-08-23,2024-11-20 00:54:03,1008.86,transfer,126319.23310344828
52987,9992651,91.122.0.15,431.0,atm,451,5711,265025860,CREDIT,0,act,2030-10-27,2024-11-26 08:07:53,587.71,payment,746568.5111320756
52988,9895511,185.1.0.120,878.0,atm,30,6325,724193028,DEBIT,0,active,2027-02-07,2024-11-19 07:58:53,712.94,transfer,525594.7066666667
52989,9795519,62.76.0.135,617.0,atm,-1,8756,703497824,DEBIT,1,act,2026-05-05,2024-11-27 04:08:59,809.09,err_code,98117.5125925926
52990,9989340,83.222.0.180,407.0,atm,30,3045,301324542,DEBIT,0,active,2028-09-11,2024-11-14 12:39:27,1033.89,transfer,126276.3396153846
52991,9774802,193.0.149.210,1158.0,atm,25,9869,584035289,CREDIT,0,active,2026-10-18,2024-11-24 15:58:11,1033.81,country_transfer,411181.84156862745
52992,9890609,185.1.0.120,878.0,atm,10,5089,517195670,DEBIT,0,act,2027-07-06,2024-10-29 00:47:49,846.95,in,913082.25
52993,9774391,2.94.0.240,1042.0,atm,25,9989,412833308,DEBIT,0,act,2029-10-22,2024-11-20 04:01:15,1110.11,diff_cntry,713159.9945762713
52994,9669828,185.1.0.120,878.0,atm,30,8297,253020703,DEBIT,0,active,2027-02-20,2024-10-27 06:45:59,409.07,transfer,957219.8903846154
52995,9679961,62.76.0.135,617.0,atm,20,7509,403085721,CREDIT,0,act,2027-03-02,2024-11-04 18:34:12,556.91,decrease_on_acc,962980.9714814816
52996,9923275,46.0.42.120,1494.0,atm,451,5987,212991804,CREDIT,0,act,2029-04-14,2024-11-23 05:05:25,734.91,payment,54822.16636363637
52997,9728378,46.0.42.120,1494.0,atm,-1,1565,496919397,DEBIT,1,act,2026-10-09,2024-11-25 18:12:47,371.03,err,766179.0551851852
52998,9959304,62.76.0.135,617.0,atm,20,8140,250329786,CREDIT,0,active,2028-04-11,2024-11-10 23:18:20,744.08,decrease_on_acc,537235.4075471697
52999,9924207,2.94.0.225,1472.0,atm,30,5722,388241689,DEBIT,0,active,2029-04-18,2024-11-05 13:22:53,503.15,transfer,291740.4293103448
53000,9881360,185.1.0.120,878.0,atm,30,2184,582783010,CREDIT,0,act,2028-04-22,2024-11-08 16:04:54,294.11,transfer,205561.0552542373
53001,9984649,178.44.0.90,1293.0,atm,10,7464,339231358,DEBIT,0,active,2030-03-30,2024-11-19 13:16:34,1023.79,in,521277.2766666667
53002,9956459,212.13.0.75,241.0,atm,20,2188,541574267,DEBIT,0,act,2026-11-11,2024-11-08 01:01:08,1180.15,decrease_on_acc,943137.2281355932
53003,9895723,188.0.162.75,494.0,atm,30,8793,703914321,DEBIT,0,active,2025-02-06,2024-11-21 09:51:47,1169.95,transfer,413125.2777358491
53004,9949324,82.200.0.195,624.0,atm,20,5533,841284706,CREDIT,0,active,2026-06-11,2024-11-25 16:06:20,121.82,decrease_on_acc,566211.6261403508
53005,9944818,193.0.145.45,489.0,atm,451,3868,514990118,DEBIT,0,active,2027-04-30,2024-11-17 19:48:42,660.95,payment,727234.281724138
53006,9969457,185.1.0.120,878.0,atm,451,1554,418851665,DEBIT,0,act,2030-12-15,2024-10-22 15:42:23,898.05,payment,957783.4801754386
53007,9934705,212.13.0.75,241.0,atm,-1,2110,254699086,DEBIT,1,active,2026-08-03,2024-11-21 13:55:11,1161.08,err_code,366452.95148148143
53008,9684714,188.0.175.30,1432.0,atm,451,4843,607981614,CREDIT,0,active,2025-08-08,2024-11-23 21:27:37,449.15,payment,374570.966
53009,9513156,46.0.43.105,1489.0,atm,20,6460,327114013,DEBIT,0,act,2028-06-30,2024-11-03 18:32:00,394.93,out,349280.84679245285
53010,9969988,212.17.0.210,1330.0,atm,451,1801,918561795,CREDIT,0,active,2030-05-29,2024-10-31 03:27:30,1087.99,payment,565321.9377966102
53011,9709214,193.0.149.210,1158.0,atm,25,4549,747551031,CREDIT,0,act,2025-03-12,2024-10-29 04:34:17,674.07,diff_cntry,693163.9
53012,9838783,91.122.0.15,431.0,atm,451,6697,150978640,CREDIT,0,active,2030-05-09,2024-11-26 09:10:23,678.2,payment,846321.111724138
53013,9864167,188.0.175.30,1432.0,atm,10,6537,171487032,DEBIT,0,act,2030-12-27,2024-10-15 13:29:12,1142.69,in,425827.4269230769
53014,9914493,178.44.0.90,1293.0,atm,20,2928,241679527,DEBIT,0,act,2030-06-09,2024-10-22 04:50:37,875.87,out,669897.715925926
53015,9784650,46.0.42.120,1494.0,atm,10,4258,785077432,CREDIT,0,active,2028-07-03,2024-11-27 13:28:53,433.93,in,144601.62
53016,9917379,185.1.0.120,878.0,atm,30,7189,789035154,CREDIT,0,active,2026-09-02,2024-11-21 21:44:31,675.1,transfer,83470.43607843138
53017,9933786,193.0.149.210,1158.0,atm,451,5505,970437056,CREDIT,0,active,2026-09-20,2024-11-21 18:13:32,236.07,payment,699768.0498305084
53018,9951577,82.200.0.195,624.0,atm,-1,5874,178679032,DEBIT,1,act,2027-07-14,2024-10-13 07:33:46,628.93,err,466165.4954545454
53019,9798988,193.0.145.45,489.0,atm,10,7171,983813572,DEBIT,0,active,2027-04-11,2024-10-29 06:46:46,1060.66,add_on_acc,741877.5784313725
53020,9816873,188.0.175.30,1432.0,atm,451,1992,430766543,CREDIT,0,active,2030-11-15,2024-11-28 09:45:14,755.98,payment,746810.5342857143
53021,9793583,193.0.149.210,1158.0,atm,10,1096,901505935,CREDIT,0,active,2026-09-11,2024-10-19 03:09:41,596.04,in_acc,411461.46185185184
53022,9993958,128.0.81.30,1290.0,atm,451,4933,101814879,CREDIT,0,act,2028-11-04,2024-11-22 17:01:41,385.0,payment,89117.56827586207
53023,9809155,31.204.0.225,932.0,atm,30,5075,963281221,DEBIT,0,act,2028-10-26,2024-11-05 02:01:56,839.86,transfer,217192.1037037037
53024,9913087,85.21.0.105,272.0,atm,-1,8632,807400201,DEBIT,2,active,2028-05-21,2024-10-26 10:16:09,557.84,err,880736.3375862068
53025,9641664,62.76.0.135,617.0,atm,451,2302,951062689,CREDIT,0,active,2026-01-24,2024-11-17 06:45:43,785.01,payment,417058.4466101695
53026,9985960,46.0.43.105,1489.0,atm,20,6539,581175235,DEBIT,0,act,2028-08-22,2024-11-28 08:41:22,777.78,from_acc,574699.234
53027,9880135,85.21.0.105,272.0,atm,451,1217,588156384,DEBIT,0,act,2025-07-12,2024-11-14 02:03:41,898.79,payment,845494.2447169811
53028,9959740,178.44.0.90,1293.0,atm,451,5553,521229176,CREDIT,0,active,2025-07-24,2024-11-18 22:18:15,240.15,payment,565778.5325925925
53029,9999730,31.204.0.225,932.0,atm,30,1523,400417528,CREDIT,0,active,2028-09-16,2024-11-19 22:07:26,469.93,transfer,971398.0143137254
53030,9820230,193.0.145.45,489.0,atm,30,2962,417914526,CREDIT,0,active,2026-04-29,2024-11-08 06:10:36,176.93,transfer,302831.1923076923
53031,9592769,46.0.43.105,1489.0,atm,451,6095,156921566,CREDIT,0,act,2026-07-21,2024-11-21 11:19:50,765.14,payment,270965.1696153846
53032,9745024,188.0.175.30,1432.0,atm,451,5306,320794190,DEBIT,0,act,2027-05-16,2024-09-15 01:34:59,1184.09,payment,290713.45413793105
53033,9690475,212.13.0.75,241.0,atm,10,2514,441416548,DEBIT,0,act,2025-01-03,2024-11-18 10:48:09,486.87,add_on_acc,397140.6779310345
53034,9730388,178.44.0.90,1293.0,atm,451,3693,180567478,CREDIT,0,active,2029-05-29,2024-10-26 21:29:45,325.9,payment,518658.6510714286
53035,9822534,31.204.0.225,932.0,atm,30,3292,323237454,CREDIT,0,active,2025-12-13,2024-11-17 02:15:46,420.4,transfer,719174.544117647
53036,9928839,2.94.0.225,1472.0,atm,451,9474,760910214,DEBIT,0,act,2025-10-15,2024-11-10 22:06:23,388.14,payment,513538.4631372549
53037,9078099,178.44.0.90,1293.0,atm,451,9681,728575156,DEBIT,0,act,2028-02-20,2024-11-26 14:28:23,114.15,payment,123017.760877193
53038,9713811,83.222.0.180,407.0,atm,20,3009,225348021,DEBIT,0,active,2026-11-02,2024-11-24 19:44:51,984.88,out,333640.2863636363
53039,9853658,46.0.43.105,1489.0,atm,-1,7748,556929405,DEBIT,1,active,2026-10-17,2024-11-23 05:49:40,971.01,err,636489.3078431373
53040,9733345,62.76.0.135,617.0,atm,451,4138,277371852,DEBIT,0,active,2026-06-07,2024-11-08 20:52:52,395.78,payment,125852.18518518518
53041,9945927,2.94.0.240,1042.0,atm,30,5374,242748823,DEBIT,0,active,2029-01-08,2024-11-03 22:35:33,571.27,transfer,829265.5158490565
53042,9933041,2.94.0.225,1472.0,atm,10,1343,306208038,DEBIT,0,active,2028-05-01,2024-11-21 18:08:54,248.05,in,822101.2969491525
53043,9780565,46.0.42.120,1494.0,atm,20,2874,438391984,CREDIT,0,act,2027-06-23,2024-10-23 02:57:35,458.96,from_acc,543072.7407142856
53044,9959210,188.0.175.30,1432.0,atm,-1,9515,998717557,CREDIT,1,active,2030-09-18,2024-11-20 08:42:22,613.35,err_code,840522.2141509433
53045,9975993,178.44.0.90,1293.0,atm,25,1419,410328814,DEBIT,0,active,2030-08-11,2024-11-27 00:07:13,1107.99,country_transfer,271294.186
53046,9923793,2.94.0.240,1042.0,atm,451,1327,572375593,DEBIT,0,act,2027-02-07,2024-11-28 02:22:41,1157.01,payment,125250.28894736842
53047,9154155,185.1.0.120,878.0,atm,10,6546,954571357,DEBIT,0,act,2025-12-03,2024-10-29 00:52:34,972.91,in_acc,343178.88094339625
53048,9973662,62.76.0.135,617.0,atm,30,9086,722863944,CREDIT,0,active,2028-05-21,2024-11-11 10:24:47,1037.0,transfer,952411.3137254902
53049,9873201,2.94.0.225,1472.0,atm,20,2163,113138243,DEBIT,0,active,2028-05-16,2024-11-14 07:00:58,249.74,from_acc,381831.98686274514
53050,9783199,46.0.43.105,1489.0,atm,10,4058,459383836,CREDIT,0,active,2026-06-10,2024-10-08 03:33:11,547.91,add_on_acc,316327.0977192982
53051,9753742,193.0.149.210,1158.0,atm,-1,7339,542488442,DEBIT,1,act,2028-09-24,2024-11-15 02:17:44,810.95,bad,488812.0755555555
53052,9976061,2.94.0.240,1042.0,atm,30,7019,124638020,DEBIT,0,act,2027-10-17,2024-11-20 19:56:35,743.12,transfer,703615.3021428572
53053,9809439,193.0.145.45,489.0,atm,25,4715,666044189,CREDIT,0,act,2030-06-17,2024-11-21 07:54:02,845.06,diff_cntry,223075.5781818182
53054,9547653,128.0.80.60,432.0,atm,451,8773,493853809,CREDIT,0,act,2029-01-27,2024-11-16 09:39:01,449.83,payment,99236.41090909092
53055,9505855,188.0.162.75,494.0,atm,30,3810,582752937,CREDIT,0,active,2030-11-05,2024-10-31 21:17:03,1096.13,transfer,854206.1720689655
53056,9991926,212.17.0.210,1330.0,atm,10,6148,945037981,CREDIT,0,active,2030-09-07,2024-10-23 10:35:29,819.0,add_on_acc,463047.708
53057,9940759,2.94.0.240,1042.0,atm,30,5208,880902812,DEBIT,0,active,2028-05-10,2024-09-10 05:04:33,237.02,transfer,861479.59
53058,9996237,145.255.0.165,246.0,atm,25,3536,847854782,CREDIT,0,act,2027-02-03,2024-10-22 21:37:16,1121.93,country_transfer,309452.58103448275
53059,9830704,193.0.149.210,1158.0,atm,10,7305,143660501,CREDIT,0,active,2029-09-20,2024-10-15 07:22:44,686.97,in_acc,290266.7175438597
53060,9916410,193.0.145.45,489.0,atm,-1,2255,863733647,CREDIT,1,active,2028-05-31,2024-11-28 09:55:58,696.99,bad,772751.6184615385
53061,9685753,85.21.0.105,272.0,atm,451,6828,105878057,DEBIT,0,act,2026-03-24,2024-10-27 19:35:13,1048.88,payment,430170.8323529412
53062,9338093,178.44.0.90,1293.0,atm,25,5007,147078192,CREDIT,0,active,2030-12-14,2024-11-22 15:08:51,490.04,diff_cntry,182447.884
53063,9898529,31.204.0.225,932.0,atm,-1,6809,171586193,CREDIT,1,active,2030-11-16,2024-11-16 12:24:12,378.78,bad,836832.6052830189
53064,9972784,85.21.0.105,272.0,atm,451,4925,971886936,DEBIT,0,act,2025-12-16,2024-11-13 13:52:50,1059.84,payment,34958.67600000001
53065,9847180,82.200.0.195,624.0,atm,-1,5359,394801746,DEBIT,1,act,2028-07-17,2024-11-24 02:05:37,535.04,bad,937050.8307692308
53066,9937679,82.200.0.195,624.0,atm,-1,4449,724547962,DEBIT,1,active,2025-02-03,2024-11-17 10:20:54,309.95,bad,788346.4672881356
53067,9845294,178.44.0.90,1293.0,atm,25,8744,932383991,CREDIT,0,act,2025-02-06,2024-11-01 01:05:51,909.98,diff_cntry,763551.1403846153
53068,9556885,83.222.0.180,407.0,atm,-1,5962,182676943,DEBIT,1,act,2026-01-09,2024-11-23 12:09:06,597.71,bad,849249.3007407407
53069,9935723,145.255.0.165,246.0,atm,451,6359,598582551,CREDIT,0,act,2028-12-25,2024-11-28 05:03:26,147.18,payment,362793.19322033896
53070,9957266,62.76.0.135,617.0,atm,451,1804,498719439,DEBIT,0,active,2029-09-25,2024-11-22 11:10:03,234.09,payment,680695.4079999999
53071,9975142,91.122.0.15,431.0,atm,25,8160,942296868,CREDIT,0,active,2028-04-22,2024-11-06 20:41:07,675.01,diff_cntry,100637.88321428571
53072,9970259,188.0.175.30,1432.0,atm,10,8930,961067216,DEBIT,0,act,2029-03-16,2024-11-25 19:48:58,152.07,in_acc,525221.152
53073,9883193,83.222.0.180,407.0,atm,451,4474,319941461,CREDIT,0,act,2030-06-02,2024-11-10 16:43:21,566.87,payment,612861.811923077
53074,9919604,91.122.0.15,431.0,atm,25,3193,526745565,CREDIT,0,act,2028-01-25,2024-10-28 09:38:58,521.37,country_transfer,183309.1303846154
53075,9902369,91.122.0.15,431.0,atm,10,7071,364757022,CREDIT,0,active,2028-08-16,2024-11-13 03:44:07,618.99,add_on_acc,337518.8801754386
53076,9939711,2.94.0.240,1042.0,atm,10,3686,828308371,DEBIT,0,active,2030-03-08,2024-11-04 14:41:05,956.15,in_acc,115192.93298245614
53077,9876313,188.0.162.75,494.0,atm,25,7602,191845802,CREDIT,0,act,2025-06-04,2024-11-23 22:36:43,1194.06,diff_cntry,128429.84964285714
53078,9791767,46.0.43.105,1489.0,atm,20,9729,860457500,CREDIT,0,active,2027-04-11,2024-11-28 17:40:33,496.93,from_acc,140533.32115384616
